conversation_index,turn_index,num_prefill_tokens,num_decode_tokens,num_total_tokens,pd_ratio
1,1,74,918,992,0.08061002178649238
2,1,290,905,1195,0.32044198895027626
2,2,1402,711,2113,1.9718706047819972
2,3,2497,918,3415,2.7200435729847494
3,1,41,950,991,0.0431578947368421
4,1,238,787,1025,0.30241423125794153
4,2,1045,742,1787,1.408355795148248
4,3,2053,855,2908,2.401169590643275
4,4,3026,311,3337,9.729903536977492
4,5,3455,390,3845,8.85897435897436
4,6,3901,572,4473,6.81993006993007
4,7,4500,433,4933,10.392609699769054
4,8,5346,363,5709,14.727272727272727
4,9,5733,290,6023,19.76896551724138
4,10,6139,894,7033,6.866890380313199
4,11,7104,871,7975,8.156142365097589
5,1,308,386,694,0.7979274611398963
5,2,697,430,1127,1.6209302325581396
5,3,1130,427,1557,2.6463700234192036
5,4,1560,79,1639,19.746835443037973
6,1,206,733,939,0.2810368349249659
6,2,944,476,1420,1.9831932773109244
6,3,1435,244,1679,5.881147540983607
6,4,1693,222,1915,7.626126126126126
6,5,1924,288,2212,6.680555555555555
6,6,2222,204,2426,10.892156862745098
6,7,2436,238,2674,10.235294117647058
6,8,2689,510,3199,5.272549019607843
7,1,21,368,389,0.057065217391304345
7,2,447,917,1364,0.48745910577971646
8,1,56,573,629,0.09773123909249563
8,2,639,314,953,2.035031847133758
9,1,111,641,752,0.1731669266770671
10,1,488,919,1407,0.5310119695321001
10,2,1428,841,2269,1.6979785969084424
11,1,78,788,866,0.09898477157360407
11,2,896,1089,1985,0.82277318640955
11,3,2077,1102,3179,1.8847549909255898
11,4,3189,151,3340,21.119205298013245
11,5,3388,132,3520,25.666666666666668
11,6,3534,97,3631,36.43298969072165
11,7,3681,1064,4745,3.4595864661654137
11,8,4754,387,5141,12.28423772609819
11,9,5161,475,5636,10.865263157894736
11,10,5655,540,6195,10.472222222222221
11,11,6236,587,6823,10.62350936967632
12,1,109,428,537,0.2546728971962617
12,2,588,549,1137,1.0710382513661203
12,3,1261,558,1819,2.259856630824373
13,1,40,820,860,0.04878048780487805
14,1,170,521,691,0.32629558541266795
14,2,739,364,1103,2.03021978021978
15,1,165,670,835,0.2462686567164179
16,1,299,621,920,0.48148148148148145
16,2,956,234,1190,4.085470085470085
16,3,1211,230,1441,5.265217391304348
16,4,1529,304,1833,5.029605263157895
16,5,1980,330,2310,6.0
16,6,2346,181,2527,12.96132596685083
16,7,2859,362,3221,7.897790055248619
16,8,3250,377,3627,8.620689655172415
16,9,3655,323,3978,11.31578947368421
16,10,4061,322,4383,12.611801242236025
17,1,160,431,591,0.37122969837587005
17,2,620,339,959,1.8289085545722714
17,3,1165,75,1240,15.533333333333333
18,1,79,577,656,0.1369150779896014
18,2,685,364,1049,1.8818681318681318
18,3,1061,561,1622,1.8912655971479502
18,4,2165,970,3135,2.231958762886598
18,5,3271,966,4237,3.386128364389234
19,1,86,694,780,0.1239193083573487
19,2,848,9,857,94.22222222222223
19,3,876,6,882,146.0
19,4,959,435,1394,2.2045977011494253
19,5,1413,463,1876,3.0518358531317493
19,6,1964,401,2365,4.897755610972569
19,7,2450,393,2843,6.234096692111959
19,8,2928,289,3217,10.131487889273357
19,9,3302,515,3817,6.411650485436893
19,10,3855,464,4319,8.308189655172415
19,11,4404,592,4996,7.4391891891891895
19,12,5081,406,5487,12.514778325123153
19,13,5502,326,5828,16.87730061349693
19,14,6007,670,6677,8.965671641791046
19,15,6772,771,7543,8.783398184176395
20,1,10,405,415,0.024691358024691357
20,2,426,504,930,0.8452380952380952
20,3,943,477,1420,1.9769392033542976
20,4,1431,547,1978,2.6160877513711154
20,5,5410,311,5721,17.39549839228296
21,1,50,851,901,0.05875440658049354
21,2,915,994,1909,0.920523138832998
21,3,1981,1006,2987,1.9691848906560636
21,4,3005,800,3805,3.75625
22,1,417,725,1142,0.5751724137931035
22,2,1190,819,2009,1.452991452991453
22,3,2034,917,2951,2.218102508178844
22,4,2965,860,3825,3.447674418604651
23,1,116,397,513,0.29219143576826195
23,2,515,352,867,1.4630681818181819
23,3,869,302,1171,2.877483443708609
23,4,1182,227,1409,5.20704845814978
23,5,1491,351,1842,4.247863247863248
23,6,1865,517,2382,3.607350096711799
23,7,2412,403,2815,5.9851116625310175
24,1,21,857,878,0.024504084014002333
25,1,73,952,1025,0.07668067226890757
25,2,1057,537,1594,1.968342644320298
25,3,1675,444,2119,3.7725225225225225
25,4,2133,581,2714,3.6712564543889843
25,5,2738,439,3177,6.236902050113895
25,6,3200,966,4166,3.3126293995859215
25,7,4593,894,5487,5.1375838926174495
25,8,5697,965,6662,5.9036269430051815
25,9,6703,971,7674,6.903192584963954
26,1,145,1720,1865,0.08430232558139535
27,1,40,439,479,0.09111617312072894
27,2,884,499,1383,1.7715430861723447
27,3,1708,319,2027,5.35423197492163
27,4,2132,246,2378,8.666666666666666
27,5,2411,158,2569,15.259493670886076
28,1,46,291,337,0.15807560137457044
28,2,396,730,1126,0.5424657534246575
28,3,1174,281,1455,4.177935943060498
28,4,1514,906,2420,1.6710816777041944
28,5,2428,709,3137,3.4245416078984485
29,1,40,93,133,0.43010752688172044
30,1,34,544,578,0.0625
31,1,95,566,661,0.16784452296819788
31,2,699,807,1506,0.8661710037174721
32,1,102,532,634,0.19172932330827067
33,1,18,105,123,0.17142857142857143
33,2,135,90,225,1.5
34,1,3933,701,4634,5.61055634807418
34,2,4679,344,5023,13.601744186046512
34,3,5072,464,5536,10.931034482758621
34,4,5615,544,6159,10.321691176470589
34,5,6233,685,6918,9.0992700729927
35,1,46,57,103,0.8070175438596491
35,2,156,149,305,1.0469798657718121
35,3,351,183,534,1.9180327868852458
35,4,602,174,776,3.4597701149425286
36,1,54,116,170,0.46551724137931033
36,2,188,106,294,1.7735849056603774
36,3,360,145,505,2.4827586206896552
36,4,523,153,676,3.418300653594771
36,5,696,104,800,6.6923076923076925
36,6,844,200,1044,4.22
36,7,1065,144,1209,7.395833333333333
36,8,1231,279,1510,4.412186379928316
36,9,1541,150,1691,10.273333333333333
37,1,317,1121,1438,0.28278322925958965
37,2,1496,945,2441,1.583068783068783
37,3,2568,928,3496,2.7672413793103448
37,4,3629,1112,4741,3.2634892086330933
37,5,4882,830,5712,5.881927710843374
37,6,5809,753,6562,7.714475431606906
37,7,6649,1034,7683,6.43036750483559
38,1,58,773,831,0.07503234152652005
38,2,911,664,1575,1.3719879518072289
38,3,1614,721,2335,2.2385575589459084
38,4,2419,827,3246,2.92503022974607
38,5,3271,289,3560,11.318339100346021
38,6,3571,112,3683,31.883928571428573
38,7,3709,358,4067,10.360335195530727
38,8,4079,116,4195,35.16379310344828
38,9,4209,200,4409,21.045
39,1,89,473,562,0.18816067653276955
39,2,587,408,995,1.4387254901960784
39,3,1028,49,1077,20.979591836734695
39,4,1131,37,1168,30.56756756756757
39,5,1221,812,2033,1.5036945812807883
39,6,2096,823,2919,2.5467800729040095
39,7,2964,702,3666,4.222222222222222
39,8,3772,99,3871,38.101010101010104
39,9,3966,389,4355,10.195372750642674
39,10,4373,419,4792,10.436754176610979
39,11,4810,542,5352,8.874538745387454
39,12,5481,811,6292,6.758323057953144
39,13,6374,866,7240,7.36027713625866
40,1,11,194,205,0.05670103092783505
41,1,69,583,652,0.1183533447684391
41,2,678,735,1413,0.9224489795918367
41,3,1456,643,2099,2.264385692068429
41,4,2131,807,2938,2.640644361833953
42,1,10,60,70,0.16666666666666666
42,2,80,69,149,1.1594202898550725
42,3,158,359,517,0.4401114206128134
42,4,525,125,650,4.2
42,5,664,158,822,4.2025316455696204
42,6,834,117,951,7.128205128205129
43,1,534,1252,1786,0.426517571884984
43,2,1798,918,2716,1.9586056644880174
44,1,156,928,1084,0.16810344827586207
44,2,1117,660,1777,1.6924242424242424
44,3,1964,947,2911,2.073917634635692
44,4,2964,794,3758,3.7329974811083124
44,5,3780,894,4674,4.228187919463087
44,6,4755,505,5260,9.415841584158416
44,7,5309,975,6284,5.4451282051282055
44,8,6286,227,6513,27.691629955947135
45,1,23,698,721,0.0329512893982808
45,2,734,760,1494,0.9657894736842105
45,3,1541,482,2023,3.1970954356846475
46,1,214,10,224,21.4
46,2,276,254,530,1.0866141732283465
46,3,582,159,741,3.660377358490566
46,4,794,251,1045,3.1633466135458166
46,5,1059,373,1432,2.839142091152815
46,6,1486,442,1928,3.3619909502262444
46,7,1959,290,2249,6.755172413793104
47,1,50,383,433,0.13054830287206268
48,1,51,53,104,0.9622641509433962
48,2,116,167,283,0.6946107784431138
48,3,302,286,588,1.055944055944056
48,4,690,310,1000,2.225806451612903
48,5,1013,278,1291,3.643884892086331
48,6,1323,85,1408,15.564705882352941
48,7,1456,818,2274,1.7799511002444988
48,8,2286,47,2333,48.638297872340424
48,9,2378,319,2697,7.454545454545454
48,10,2714,48,2762,56.541666666666664
48,11,2793,318,3111,8.783018867924529
48,12,3133,54,3187,58.01851851851852
48,13,3191,30,3221,106.36666666666666
49,1,36,718,754,0.05013927576601671
50,1,254,716,970,0.3547486033519553
51,1,18,900,918,0.02
51,2,971,555,1526,1.7495495495495494
51,3,1559,699,2258,2.2303290414878396
52,1,68,30,98,2.2666666666666666
52,2,102,14,116,7.285714285714286
52,3,130,37,167,3.5135135135135136
52,4,179,23,202,7.782608695652174
52,5,222,40,262,5.55
52,6,273,36,309,7.583333333333333
52,7,321,59,380,5.440677966101695
52,8,392,43,435,9.116279069767442
52,9,437,50,487,8.74
52,10,509,58,567,8.775862068965518
52,11,576,497,1073,1.158953722334004
53,1,12,968,980,0.012396694214876033
53,2,987,250,1237,3.948
53,3,1282,196,1478,6.540816326530612
53,4,1533,307,1840,4.993485342019544
53,5,1866,340,2206,5.488235294117647
54,1,732,518,1250,1.4131274131274132
54,2,1284,883,2167,1.4541336353340883
54,3,2169,865,3034,2.507514450867052
54,4,3036,812,3848,3.7389162561576357
54,5,3882,898,4780,4.32293986636971
54,6,4782,883,5665,5.4156285390713474
54,7,5667,629,6296,9.009538950715422
54,8,6298,863,7161,7.297798377752028
54,9,7195,883,8078,8.148357870894678
55,1,49,118,167,0.4152542372881356
55,2,1723,416,2139,4.141826923076923
55,3,2170,179,2349,12.12290502793296
55,4,2358,328,2686,7.189024390243903
55,5,2723,109,2832,24.98165137614679
55,6,2865,353,3218,8.11614730878187
55,7,3235,178,3413,18.174157303370787
55,8,3426,229,3655,14.960698689956331
55,9,3682,381,4063,9.664041994750656
55,10,4071,189,4260,21.53968253968254
55,11,4278,259,4537,16.517374517374517
55,12,4553,228,4781,19.969298245614034
55,13,4798,233,5031,20.59227467811159
55,14,5039,258,5297,19.531007751937985
55,15,5321,164,5485,32.44512195121951
55,16,5494,228,5722,24.096491228070175
55,17,5732,249,5981,23.02008032128514
55,18,5997,320,6317,18.740625
55,19,6358,328,6686,19.384146341463413
55,20,6701,414,7115,16.185990338164252
55,21,7148,274,7422,26.087591240875913
55,22,7435,272,7707,27.334558823529413
55,23,7741,260,8001,29.773076923076925
56,1,107,922,1029,0.11605206073752712
56,2,1093,49,1142,22.306122448979593
56,3,1254,842,2096,1.489311163895487
56,4,2142,826,2968,2.593220338983051
56,5,3012,835,3847,3.607185628742515
56,6,3876,448,4324,8.651785714285714
57,1,327,660,987,0.4954545454545455
57,2,1011,474,1485,2.132911392405063
57,3,1502,497,1999,3.022132796780684
57,4,2279,997,3276,2.2858575727181543
57,5,3321,588,3909,5.6479591836734695
57,6,3936,329,4265,11.963525835866262
57,7,4300,333,4633,12.912912912912914
57,8,4754,417,5171,11.400479616306955
57,9,5257,960,6217,5.476041666666666
58,1,27,901,928,0.029966703662597113
58,2,933,829,1762,1.1254523522316044
58,3,1791,315,2106,5.685714285714286
58,4,2138,858,2996,2.491841491841492
58,5,3007,848,3855,3.545990566037736
58,6,3890,559,4449,6.958855098389982
58,7,4466,536,5002,8.332089552238806
58,8,5019,993,6012,5.054380664652568
58,9,6035,1018,7053,5.928290766208251
58,10,7058,395,7453,17.868354430379746
59,1,56,707,763,0.07920792079207921
59,2,852,933,1785,0.9131832797427653
59,3,1905,900,2805,2.1166666666666667
59,4,2853,831,3684,3.4332129963898916
59,5,3712,613,4325,6.055464926590538
59,6,4343,878,5221,4.946469248291572
60,1,29,861,890,0.03368176538908246
60,2,897,64,961,14.015625
60,3,977,102,1079,9.57843137254902
60,4,1096,683,1779,1.6046852122986823
60,5,1800,916,2716,1.965065502183406
61,1,263,415,678,0.6337349397590362
61,2,702,364,1066,1.9285714285714286
61,3,1127,34,1161,33.14705882352941
62,1,954,602,1556,1.584717607973422
62,2,1626,703,2329,2.3129445234708395
62,3,2362,679,3041,3.4786450662739323
62,4,3092,684,3776,4.52046783625731
62,5,3851,97,3948,39.70103092783505
63,1,1898,640,2538,2.965625
63,2,2554,214,2768,11.934579439252337
63,3,2780,186,2966,14.946236559139784
63,4,2973,202,3175,14.717821782178218
63,5,3188,368,3556,8.66304347826087
63,6,4840,58,4898,83.44827586206897
63,7,6273,385,6658,16.293506493506495
64,1,349,461,810,0.7570498915401301
64,2,857,905,1762,0.9469613259668508
64,3,1765,243,2008,7.2633744855967075
64,4,2064,536,2600,3.8507462686567164
64,5,2622,54,2676,48.55555555555556
64,6,2758,87,2845,31.701149425287355
64,7,2865,52,2917,55.09615384615385
64,8,2966,71,3037,41.774647887323944
64,9,3083,74,3157,41.66216216216216
64,10,3204,80,3284,40.05
64,11,3301,85,3386,38.83529411764706
64,12,3401,117,3518,29.068376068376068
64,13,3524,82,3606,42.97560975609756
64,14,3636,90,3726,40.4
64,15,3737,474,4211,7.883966244725738
64,16,4267,125,4392,34.136
64,17,4435,149,4584,29.76510067114094
64,18,4638,170,4808,27.28235294117647
64,19,4843,103,4946,47.019417475728154
64,20,5125,417,5542,12.290167865707435
64,21,5569,239,5808,23.301255230125523
64,22,5830,142,5972,41.056338028169016
64,23,6016,173,6189,34.774566473988436
64,24,6201,119,6320,52.109243697478995
64,25,6365,121,6486,52.603305785123965
64,26,6498,401,6899,16.204488778054863
64,27,6932,208,7140,33.32692307692308
64,28,7196,110,7306,65.41818181818182
64,29,7340,354,7694,20.73446327683616
64,30,7764,123,7887,63.1219512195122
65,1,162,290,452,0.5586206896551724
65,2,459,387,846,1.186046511627907
65,3,957,876,1833,1.0924657534246576
65,4,1854,875,2729,2.1188571428571428
65,5,2749,874,3623,3.145308924485126
65,6,3694,834,4528,4.429256594724221
65,7,4570,266,4836,17.18045112781955
65,8,4918,309,5227,15.915857605177994
65,9,5279,526,5805,10.036121673003802
66,1,180,736,916,0.24456521739130435
67,1,70,1029,1099,0.06802721088435375
67,2,1130,865,1995,1.30635838150289
67,3,2012,929,2941,2.1657696447793326
68,1,17,36,53,0.4722222222222222
68,2,1209,47,1256,25.72340425531915
68,3,1285,726,2011,1.7699724517906337
69,1,96,463,559,0.20734341252699784
69,2,613,454,1067,1.3502202643171806
69,3,1093,430,1523,2.541860465116279
69,4,1594,519,2113,3.071290944123314
69,5,2191,321,2512,6.825545171339564
69,6,2546,545,3091,4.671559633027523
69,7,3141,238,3379,13.197478991596638
69,8,3416,431,3847,7.9257540603248255
69,9,3911,410,4321,9.539024390243902
69,10,4351,356,4707,12.22191011235955
69,11,4774,481,5255,9.925155925155925
69,12,5287,506,5793,10.448616600790514
69,13,5887,422,6309,13.950236966824644
70,1,59,756,815,0.07804232804232804
70,2,1010,641,1651,1.575663026521061
70,3,1806,787,2593,2.2947903430749683
70,4,2660,620,3280,4.290322580645161
70,5,3425,550,3975,6.2272727272727275
70,6,4086,812,4898,5.032019704433497
70,7,5002,727,5729,6.880330123796424
71,1,43,583,626,0.07375643224699828
71,2,640,440,1080,1.4545454545454546
71,3,1096,304,1400,3.6052631578947367
71,4,3479,76,3555,45.776315789473685
71,5,3584,496,4080,7.225806451612903
71,6,4130,651,4781,6.344086021505376
72,1,7,342,349,0.02046783625730994
72,2,360,562,922,0.6405693950177936
72,3,1011,706,1717,1.4320113314447591
72,4,1733,722,2455,2.4002770083102494
72,5,2469,536,3005,4.606343283582089
72,6,3018,942,3960,3.2038216560509554
73,1,72,422,494,0.17061611374407584
74,1,445,440,885,1.0113636363636365
74,2,940,386,1326,2.435233160621762
74,3,1408,600,2008,2.3466666666666667
74,4,2228,345,2573,6.457971014492753
74,5,2715,443,3158,6.128668171557562
74,6,3253,382,3635,8.515706806282722
74,7,3676,402,4078,9.144278606965175
74,8,4340,415,4755,10.457831325301205
74,9,4980,797,5777,6.2484316185696365
74,10,5791,1142,6933,5.07092819614711
75,1,1252,268,1520,4.6716417910447765
75,2,1532,142,1674,10.788732394366198
76,1,887,343,1230,2.58600583090379
76,2,1518,210,1728,7.228571428571429
77,1,183,636,819,0.28773584905660377
77,2,822,418,1240,1.9665071770334928
77,3,1788,618,2406,2.8932038834951457
77,4,2409,607,3016,3.9686985172981877
77,5,3019,636,3655,4.74685534591195
77,6,3658,372,4030,9.833333333333334
77,7,4033,552,4585,7.306159420289855
77,8,5136,658,5794,7.805471124620061
77,9,5797,230,6027,25.204347826086956
77,10,6065,534,6599,11.357677902621722
77,11,6662,660,7322,10.093939393939394
77,12,7380,708,8088,10.423728813559322
78,1,28,422,450,0.06635071090047394
79,1,4,840,844,0.004761904761904762
80,1,71,876,947,0.08105022831050228
80,2,963,613,1576,1.570962479608483
80,3,1615,765,2380,2.111111111111111
80,4,2413,636,3049,3.7940251572327046
80,5,3065,817,3882,3.751529987760098
80,6,3904,845,4749,4.620118343195267
80,7,4773,838,5611,5.695704057279237
80,8,5627,927,6554,6.070118662351672
80,9,6573,910,7483,7.223076923076923
80,10,7501,536,8037,13.994402985074627
81,1,42,959,1001,0.043795620437956206
82,1,38,46,84,0.8260869565217391
82,2,227,585,812,0.38803418803418804
82,3,911,5,916,182.2
82,4,1428,5,1433,285.6
82,5,3160,5,3165,632.0
82,6,4489,5,4494,897.8
82,7,6692,5,6697,1338.4
82,8,8014,5,8019,1602.8
83,1,20,291,311,0.06872852233676977
84,1,22,827,849,0.026602176541717048
85,1,105,629,734,0.1669316375198728
85,2,762,458,1220,1.6637554585152838
85,3,1234,197,1431,6.2639593908629445
85,4,1564,795,2359,1.9672955974842767
85,5,2442,947,3389,2.5786694825765575
85,6,3410,585,3995,5.829059829059829
86,1,232,285,517,0.8140350877192982
87,1,30,820,850,0.036585365853658534
87,2,852,591,1443,1.4416243654822336
87,3,1469,853,2322,1.7221570926143024
88,1,45,622,667,0.07234726688102894
88,2,757,368,1125,2.057065217391304
88,3,1206,173,1379,6.971098265895954
88,4,1396,474,1870,2.9451476793248945
89,1,283,578,861,0.48961937716262977
89,2,958,550,1508,1.7418181818181817
89,3,1864,449,2313,4.151447661469933
90,1,24,525,549,0.045714285714285714
90,2,563,451,1014,1.2483370288248337
91,1,7,509,516,0.0137524557956778
92,1,27,794,821,0.03400503778337532
92,2,831,531,1362,1.5649717514124293
92,3,1386,226,1612,6.132743362831858
92,4,3825,250,4075,15.3
92,5,4276,126,4402,33.93650793650794
92,6,4418,939,5357,4.705005324813632
92,7,5365,879,6244,6.103526734926052
92,8,6266,413,6679,15.171912832929783
92,9,6706,305,7011,21.98688524590164
92,10,7021,493,7514,14.241379310344827
92,11,7522,405,7927,18.57283950617284
93,1,95,282,377,0.33687943262411346
94,1,140,459,599,0.30501089324618735
94,2,626,930,1556,0.6731182795698925
94,3,1812,692,2504,2.6184971098265897
95,1,22,122,144,0.18032786885245902
95,2,163,514,677,0.31712062256809337
95,3,730,512,1242,1.42578125
95,4,1245,602,1847,2.068106312292359
95,5,1868,884,2752,2.1131221719457014
95,6,2780,798,3578,3.4837092731829573
96,1,89,473,562,0.18816067653276955
96,2,587,408,995,1.4387254901960784
96,3,1028,49,1077,20.979591836734695
96,4,1131,37,1168,30.56756756756757
96,5,1221,812,2033,1.5036945812807883
96,6,2096,823,2919,2.5467800729040095
96,7,2964,702,3666,4.222222222222222
96,8,3772,99,3871,38.101010101010104
96,9,3966,389,4355,10.195372750642674
96,10,4373,419,4792,10.436754176610979
96,11,4810,542,5352,8.874538745387454
96,12,5481,811,6292,6.758323057953144
96,13,6374,866,7240,7.36027713625866
97,1,17,493,510,0.034482758620689655
98,1,387,876,1263,0.4417808219178082
98,2,1351,261,1612,5.176245210727969
99,1,71,770,841,0.09220779220779221
99,2,844,549,1393,1.5373406193078325
99,3,1396,966,2362,1.445134575569358
99,4,2366,851,3217,2.780258519388954
99,5,3222,302,3524,10.668874172185431
99,6,3540,448,3988,7.901785714285714
99,7,3994,817,4811,4.8886168910648715
99,8,4821,936,5757,5.1506410256410255
99,9,5760,909,6669,6.336633663366337
100,1,66,854,920,0.07728337236533958
100,2,941,642,1583,1.4657320872274144
100,3,1604,595,2199,2.6957983193277313
100,4,2226,561,2787,3.9679144385026737
101,1,32,620,652,0.05161290322580645
101,2,675,641,1316,1.0530421216848673
102,1,26,742,768,0.03504043126684636
102,2,797,29,826,27.482758620689655
102,3,2158,566,2724,3.812720848056537
102,4,2739,914,3653,2.9967177242888403
102,5,3667,138,3805,26.57246376811594
102,6,3824,580,4404,6.593103448275862
102,7,4430,590,5020,7.508474576271187
102,8,5135,617,5752,8.322528363047002
102,9,5767,536,6303,10.759328358208956
102,10,6429,438,6867,14.678082191780822
102,11,6918,74,6992,93.48648648648648
102,12,7009,913,7922,7.676889375684556
103,1,174,75,249,2.32
103,2,390,110,500,3.5454545454545454
103,3,554,390,944,1.4205128205128206
103,4,999,439,1438,2.275626423690205
103,5,1652,458,2110,3.606986899563319
103,6,2762,635,3397,4.349606299212598
103,7,3422,735,4157,4.65578231292517
103,8,4267,600,4867,7.111666666666666
103,9,5067,282,5349,17.96808510638298
103,10,5674,418,6092,13.574162679425838
103,11,6258,327,6585,19.137614678899084
103,12,6600,699,7299,9.44206008583691
103,13,7355,703,8058,10.46230440967283
104,1,148,685,833,0.21605839416058395
104,2,870,562,1432,1.5480427046263345
104,3,1486,648,2134,2.29320987654321
104,4,2164,318,2482,6.80503144654088
105,1,117,518,635,0.22586872586872586
105,2,654,147,801,4.448979591836735
105,3,823,391,1214,2.104859335038363
105,4,1243,200,1443,6.215
105,5,1490,440,1930,3.3863636363636362
105,6,1993,353,2346,5.645892351274788
105,7,2369,239,2608,9.912133891213388
105,8,2646,323,2969,8.191950464396285
106,1,96,579,675,0.16580310880829016
106,2,694,201,895,3.4527363184079602
107,1,151,929,1080,0.16254036598493002
107,2,1086,461,1547,2.355748373101952
108,1,702,15,717,46.8
108,2,988,620,1608,1.5935483870967742
109,1,330,661,991,0.49924357034795763
109,2,1021,784,1805,1.302295918367347
109,3,1813,746,2559,2.43029490616622
109,4,2636,704,3340,3.7443181818181817
110,1,114,253,367,0.4505928853754941
110,2,380,239,619,1.5899581589958158
111,1,500,1021,1521,0.48971596474045054
111,2,1534,602,2136,2.548172757475083
111,3,2162,907,3069,2.3836824696802648
111,4,3094,929,4023,3.330462863293864
111,5,4050,750,4800,5.4
111,6,4830,761,5591,6.3469119579500655
111,7,5624,985,6609,5.7096446700507615
112,1,23,778,801,0.02956298200514139
112,2,852,934,1786,0.9122055674518201
112,3,1802,201,2003,8.965174129353233
112,4,2034,494,2528,4.117408906882591
112,5,2566,441,3007,5.81859410430839
112,6,3054,471,3525,6.484076433121019
112,7,3898,275,4173,14.174545454545454
112,8,5357,248,5605,21.600806451612904
112,9,5635,665,6300,8.473684210526315
112,10,6361,107,6468,59.44859813084112
112,11,6489,203,6692,31.96551724137931
112,12,6704,191,6895,35.09947643979058
112,13,6910,623,7533,11.091492776886035
113,1,19,117,136,0.1623931623931624
113,2,148,102,250,1.4509803921568627
113,3,272,237,509,1.1476793248945147
113,4,519,40,559,12.975
113,5,570,38,608,15.0
114,1,2899,387,3286,7.4909560723514215
114,2,3288,404,3692,8.138613861386139
114,3,3767,301,4068,12.514950166112957
114,4,4070,360,4430,11.305555555555555
114,5,4433,34,4467,130.38235294117646
115,1,58,228,286,0.2543859649122807
116,1,29,528,557,0.054924242424242424
116,2,582,577,1159,1.0086655112651646
116,3,1193,733,1926,1.6275579809004093
116,4,1953,491,2444,3.9775967413441955
116,5,2478,444,2922,5.581081081081081
116,6,2964,727,3691,4.0770288858321875
116,7,3727,659,4386,5.655538694992413
116,8,4416,683,5099,6.465592972181552
116,9,5125,549,5674,9.335154826958105
116,10,5721,367,6088,15.588555858310627
116,11,6111,628,6739,9.730891719745223
116,12,6781,756,7537,8.96957671957672
117,1,258,359,617,0.7186629526462396
117,2,630,17,647,37.05882352941177
117,3,665,104,769,6.394230769230769
117,4,798,188,986,4.24468085106383
117,5,1012,157,1169,6.445859872611465
117,6,1203,304,1507,3.9572368421052633
117,7,1559,314,1873,4.964968152866242
117,8,1881,325,2206,5.787692307692308
117,9,2230,269,2499,8.28996282527881
117,10,2523,182,2705,13.862637362637363
118,1,707,938,1645,0.753731343283582
119,1,13,357,370,0.036414565826330535
119,2,382,491,873,0.7780040733197556
119,3,901,429,1330,2.1002331002331003
119,4,1351,262,1613,5.156488549618321
119,5,1622,516,2138,3.143410852713178
119,6,2149,210,2359,10.233333333333333
119,7,2380,532,2912,4.473684210526316
119,8,2947,633,3580,4.655608214849921
119,9,3608,546,4154,6.608058608058608
119,10,4163,436,4599,9.54816513761468
119,11,4622,571,5193,8.094570928196147
119,12,5224,511,5735,10.223091976516635
119,13,5761,531,6292,10.849340866290019
119,14,6343,789,7132,8.039290240811154
119,15,7141,437,7578,16.340961098398168
120,1,37,28,65,1.3214285714285714
120,2,96,211,307,0.4549763033175355
120,3,323,52,375,6.211538461538462
120,4,403,108,511,3.7314814814814814
120,5,538,213,751,2.5258215962441315
120,6,786,271,1057,2.9003690036900367
120,7,1106,225,1331,4.915555555555556
120,8,1374,190,1564,7.231578947368421
120,9,1571,41,1612,38.31707317073171
120,10,1635,277,1912,5.902527075812275
120,11,2012,207,2219,9.719806763285025
120,12,2281,261,2542,8.739463601532567
120,13,2624,203,2827,12.926108374384237
120,14,2941,181,3122,16.248618784530386
120,15,3170,158,3328,20.063291139240505
120,16,3361,156,3517,21.544871794871796
120,17,3731,315,4046,11.844444444444445
120,18,4054,100,4154,40.54
120,19,4199,78,4277,53.833333333333336
121,1,1947,647,2594,3.009273570324575
121,2,2930,1111,4041,2.637263726372637
121,3,4049,821,4870,4.931790499390987
121,4,5552,1100,6652,5.047272727272727
121,5,6660,667,7327,9.985007496251875
122,1,52,472,524,0.11016949152542373
123,1,110,548,658,0.20072992700729927
123,2,678,569,1247,1.1915641476274166
124,1,76,85,161,0.8941176470588236
125,1,429,670,1099,0.6402985074626866
125,2,1157,596,1753,1.941275167785235
125,3,1780,493,2273,3.610547667342799
125,4,2315,446,2761,5.190582959641255
125,5,2797,938,3735,2.981876332622601
126,1,483,462,945,1.0454545454545454
126,2,960,779,1739,1.2323491655969192
127,1,3052,683,3735,4.468521229868228
127,2,3790,1037,4827,3.6547733847637414
127,3,4932,978,5910,5.042944785276074
127,4,5934,225,6159,26.373333333333335
127,5,6184,566,6750,10.925795053003533
127,6,6828,528,7356,12.931818181818182
127,7,7395,294,7689,25.153061224489797
127,8,7717,366,8083,21.084699453551913
128,1,65,23,88,2.8260869565217392
128,2,258,2,260,129.0
128,3,322,2,324,161.0
128,4,431,2,433,215.5
128,5,634,2,636,317.0
128,6,767,4,771,191.75
128,7,826,389,1215,2.1233933161953726
129,1,20,423,443,0.04728132387706856
129,2,471,816,1287,0.5772058823529411
129,3,1292,171,1463,7.555555555555555
129,4,1487,834,2321,1.7829736211031175
129,5,2326,576,2902,4.038194444444445
129,6,2933,804,3737,3.648009950248756
129,7,3751,816,4567,4.596813725490196
129,8,4572,152,4724,30.07894736842105
129,9,4775,702,5477,6.801994301994302
129,10,5501,748,6249,7.35427807486631
129,11,6301,818,7119,7.702933985330073
129,12,7142,853,7995,8.372801875732709
130,1,32,64,96,0.5
131,1,160,41,201,3.902439024390244
131,2,207,79,286,2.6202531645569622
132,1,1042,16,1058,65.125
132,2,2115,693,2808,3.051948051948052
133,1,27,202,229,0.13366336633663367
134,1,1659,915,2574,1.8131147540983608
135,1,51,100,151,0.51
135,2,154,123,277,1.2520325203252032
135,3,280,199,479,1.407035175879397
135,4,482,175,657,2.7542857142857144
135,5,660,220,880,3.0
135,6,883,261,1144,3.3831417624521074
135,7,1147,214,1361,5.359813084112149
135,8,1364,140,1504,9.742857142857142
135,9,1507,162,1669,9.302469135802468
135,10,1672,221,1893,7.5656108597285066
135,11,1896,259,2155,7.32046332046332
135,12,2158,204,2362,10.57843137254902
135,13,2365,215,2580,11.0
135,14,2583,198,2781,13.045454545454545
135,15,2784,203,2987,13.714285714285714
135,16,2990,225,3215,13.28888888888889
135,17,3218,227,3445,14.176211453744493
135,18,3448,223,3671,15.461883408071749
135,19,3674,166,3840,22.132530120481928
135,20,3843,112,3955,34.3125
135,21,3958,121,4079,32.710743801652896
135,22,4082,171,4253,23.871345029239766
135,23,4256,132,4388,32.24242424242424
135,24,4391,116,4507,37.85344827586207
135,25,4510,164,4674,27.5
135,26,4677,125,4802,37.416
135,27,4805,171,4976,28.099415204678362
135,28,4979,201,5180,24.771144278606965
135,29,5183,207,5390,25.03864734299517
135,30,5393,118,5511,45.70338983050848
135,31,5514,135,5649,40.84444444444444
135,32,5652,191,5843,29.591623036649214
135,33,5846,164,6010,35.646341463414636
135,34,6013,171,6184,35.16374269005848
135,35,6187,202,6389,30.628712871287128
135,36,6392,196,6588,32.61224489795919
135,37,6591,135,6726,48.82222222222222
135,38,6729,136,6865,49.47794117647059
135,39,6868,125,6993,54.944
135,40,6996,135,7131,51.82222222222222
135,41,7134,181,7315,39.41436464088398
135,42,7318,193,7511,37.917098445595855
135,43,7514,197,7711,38.142131979695435
136,1,18,29,47,0.6206896551724138
136,2,69,145,214,0.47586206896551725
136,3,243,178,421,1.3651685393258426
137,1,211,644,855,0.327639751552795
137,2,862,539,1401,1.5992578849721706
137,3,1422,176,1598,8.079545454545455
137,4,1606,625,2231,2.5696
137,5,2245,601,2846,3.735440931780366
137,6,2963,626,3589,4.733226837060703
137,7,3597,745,4342,4.828187919463088
137,8,4376,295,4671,14.833898305084746
137,9,4688,536,5224,8.746268656716419
137,10,5249,509,5758,10.31237721021611
138,1,137,615,752,0.22276422764227644
138,2,849,593,1442,1.4317032040472175
138,3,1650,659,2309,2.503793626707132
139,1,111,680,791,0.16323529411764706
139,2,811,289,1100,2.8062283737024223
140,1,443,96,539,4.614583333333333
141,1,2533,347,2880,7.29971181556196
141,2,2932,548,3480,5.350364963503649
142,1,23,561,584,0.040998217468805706
142,2,625,567,1192,1.1022927689594357
142,3,1232,881,2113,1.398410896708286
142,4,2153,993,3146,2.1681772406847934
142,5,3192,1029,4221,3.1020408163265305
142,6,4233,241,4474,17.564315352697097
142,7,4489,1054,5543,4.259013282732448
142,8,5560,839,6399,6.626936829558999
142,9,6448,1117,7565,5.7726051924798565
142,10,7609,453,8062,16.79690949227373
143,1,3572,367,3939,9.732970027247957
143,2,3950,362,4312,10.911602209944752
144,1,354,1234,1588,0.28687196110210694
144,2,1703,402,2105,4.236318407960199
144,3,2145,168,2313,12.767857142857142
144,4,2342,390,2732,6.005128205128205
144,5,2752,402,3154,6.845771144278607
144,6,3189,411,3600,7.759124087591241
144,7,3648,508,4156,7.181102362204724
144,8,4186,95,4281,44.06315789473684
144,10,4419,1,4420,4419.0
144,11,4469,648,5117,6.896604938271605
144,12,5168,681,5849,7.588839941262849
145,1,66,854,920,0.07728337236533958
146,1,22,634,656,0.03470031545741325
146,2,748,666,1414,1.1231231231231231
146,3,1424,641,2065,2.221528861154446
147,1,27,580,607,0.04655172413793104
147,2,616,536,1152,1.1492537313432836
147,3,1163,558,1721,2.0842293906810037
147,4,1751,570,2321,3.0719298245614035
147,5,2327,766,3093,3.037859007832898
147,6,3163,811,3974,3.900123304562269
147,7,3984,771,4755,5.167315175097277
148,1,685,862,1547,0.7946635730858469
149,1,25,42,67,0.5952380952380952
149,2,276,31,307,8.903225806451612
150,1,44,74,118,0.5945945945945946
150,2,134,66,200,2.0303030303030303
150,3,212,92,304,2.3043478260869565
151,1,23,992,1015,0.023185483870967742
151,2,1102,817,1919,1.3488372093023255
152,1,504,935,1439,0.5390374331550802
152,2,1721,385,2106,4.47012987012987
152,3,2112,406,2518,5.201970443349754
152,4,2524,254,2778,9.937007874015748
152,5,2785,452,3237,6.161504424778761
152,6,3251,411,3662,7.909975669099757
153,1,13,461,474,0.028199566160520606
153,2,509,78,587,6.5256410256410255
153,3,683,970,1653,0.7041237113402062
154,1,14,589,603,0.023769100169779286
155,1,4335,442,4777,9.807692307692308
155,2,5020,540,5560,9.296296296296296
155,3,5764,445,6209,12.952808988764044
155,4,6221,559,6780,11.128801431127012
155,5,6848,361,7209,18.969529085872576
155,6,7312,399,7711,18.325814536340854
156,1,86,386,472,0.22279792746113988
157,1,63,834,897,0.07553956834532374
157,2,910,641,1551,1.4196567862714509
158,1,15,191,206,0.07853403141361257
158,2,238,202,440,1.1782178217821782
158,3,444,175,619,2.537142857142857
158,4,650,333,983,1.951951951951952
159,1,123,653,776,0.1883614088820827
159,2,811,957,1768,0.8474399164054337
160,1,333,825,1158,0.4036363636363636
160,2,1351,455,1806,2.9692307692307693
160,3,1929,542,2471,3.559040590405904
160,4,2590,543,3133,4.769797421731123
160,5,3194,620,3814,5.151612903225806
160,6,3876,1210,5086,3.203305785123967
160,7,5095,541,5636,9.417744916820702
160,8,5685,541,6226,10.508317929759704
160,9,6424,353,6777,18.19830028328612
161,1,324,1090,1414,0.29724770642201837
161,2,1424,229,1653,6.218340611353712
161,3,1669,722,2391,2.311634349030471
161,4,2415,215,2630,11.232558139534884
161,5,2643,115,2758,22.982608695652175
162,1,628,929,1557,0.6759956942949408
162,2,1651,802,2453,2.0586034912718203
162,3,2475,610,3085,4.057377049180328
162,4,3178,612,3790,5.19281045751634
162,5,3892,867,4759,4.489042675893887
162,6,4767,836,5603,5.702153110047847
162,7,5609,891,6500,6.295173961840629
162,8,6509,920,7429,7.075
162,9,7432,356,7788,20.876404494382022
163,1,16,934,950,0.017130620985010708
164,1,4,80,84,0.05
164,2,88,608,696,0.14473684210526316
164,3,700,697,1397,1.0043041606886658
164,4,1449,409,1858,3.54278728606357
164,5,1902,171,2073,11.12280701754386
164,6,2100,245,2345,8.571428571428571
164,7,2438,380,2818,6.41578947368421
164,8,2830,228,3058,12.412280701754385
164,9,3099,65,3164,47.676923076923075
164,10,3183,599,3782,5.313856427378965
164,11,3798,625,4423,6.0768
164,12,4435,418,4853,10.610047846889952
165,1,150,571,721,0.2626970227670753
165,2,912,980,1892,0.9306122448979591
165,3,1910,682,2592,2.80058651026393
165,4,2673,507,3180,5.272189349112426
165,5,3636,741,4377,4.906882591093117
165,6,4437,563,5000,7.880994671403197
165,7,5241,705,5946,7.43404255319149
165,8,5974,400,6374,14.935
165,9,6520,723,7243,9.017980636237898
166,1,54,169,223,0.31952662721893493
166,2,254,251,505,1.0119521912350598
166,3,528,256,784,2.0625
166,4,820,985,1805,0.8324873096446701
167,1,152,65,217,2.3384615384615386
167,2,542,76,618,7.131578947368421
167,3,652,58,710,11.241379310344827
167,4,741,110,851,6.736363636363636
167,5,1242,322,1564,3.857142857142857
167,6,1574,46,1620,34.21739130434783
167,7,1629,189,1818,8.619047619047619
167,8,2194,294,2488,7.462585034013605
167,9,2713,350,3063,7.751428571428572
167,10,4115,253,4368,16.26482213438735
167,11,5638,328,5966,17.1890243902439
167,12,6166,269,6435,22.92193308550186
167,13,6844,275,7119,24.887272727272727
168,1,5,560,565,0.008928571428571428
168,2,578,469,1047,1.232409381663113
168,3,1084,728,1812,1.489010989010989
169,1,751,256,1007,2.93359375
170,1,29,559,588,0.0518783542039356
171,1,53,677,730,0.07828655834564253
171,2,746,353,1099,2.1133144475920678
171,3,1110,835,1945,1.3293413173652695
172,1,52,47,99,1.1063829787234043
172,2,128,57,185,2.245614035087719
172,3,353,154,507,2.292207792207792
172,4,571,66,637,8.651515151515152
172,5,827,252,1079,3.2817460317460316
172,6,1114,57,1171,19.54385964912281
172,7,1567,416,1983,3.766826923076923
172,8,2111,212,2323,9.95754716981132
172,9,2538,240,2778,10.575
172,10,2976,266,3242,11.18796992481203
172,11,3278,74,3352,44.2972972972973
172,12,3437,530,3967,6.4849056603773585
172,13,4190,822,5012,5.097323600973236
172,14,5014,280,5294,17.90714285714286
172,15,5428,651,6079,8.33794162826421
172,16,6334,779,7113,8.130937098844672
172,17,7210,832,8042,8.665865384615385
172,18,8069,1,8070,8069.0
173,1,30,51,81,0.5882352941176471
173,2,523,53,576,9.867924528301886
173,3,600,203,803,2.955665024630542
174,1,679,877,1556,0.774230330672748
174,2,1560,672,2232,2.3214285714285716
174,3,2266,407,2673,5.5675675675675675
174,4,2838,222,3060,12.783783783783784
174,5,3142,291,3433,10.79725085910653
174,6,3551,518,4069,6.855212355212355
174,7,4085,185,4270,22.08108108108108
174,8,4277,464,4741,9.217672413793103
175,1,42,200,242,0.21
175,2,260,611,871,0.425531914893617
175,3,909,671,1580,1.354694485842027
175,4,1623,685,2308,2.3693430656934305
175,5,2356,562,2918,4.192170818505338
175,6,2951,78,3029,37.833333333333336
175,7,3067,677,3744,4.530280649926144
175,8,3774,679,4453,5.5581737849779085
175,9,4475,592,5067,7.559121621621622
176,1,398,28,426,14.214285714285714
176,2,884,363,1247,2.435261707988981
176,3,1295,344,1639,3.76453488372093
176,4,1649,397,2046,4.153652392947103
176,5,2080,534,2614,3.8951310861423223
176,6,2652,546,3198,4.857142857142857
176,7,3229,489,3718,6.603271983640082
176,8,3749,108,3857,34.71296296296296
177,1,944,554,1498,1.703971119133574
177,2,1520,109,1629,13.944954128440367
178,1,20,380,400,0.05263157894736842
178,2,411,704,1115,0.5838068181818182
178,3,1135,638,1773,1.7789968652037618
179,1,479,401,880,1.1945137157107233
179,2,891,444,1335,2.0067567567567566
180,1,24,769,793,0.031209362808842653
180,2,802,290,1092,2.7655172413793103
181,1,11,517,528,0.02127659574468085
182,1,15,518,533,0.02895752895752896
182,2,562,800,1362,0.7025
182,3,1373,648,2021,2.118827160493827
182,4,2163,943,3106,2.2937433722163307
183,1,12,449,461,0.026726057906458798
183,2,474,481,955,0.9854469854469855
183,3,981,508,1489,1.9311023622047243
183,4,1529,204,1733,7.495098039215686
184,1,242,37,279,6.54054054054054
184,2,330,79,409,4.177215189873418
184,3,470,107,577,4.392523364485982
185,1,488,647,1135,0.7542503863987635
185,2,4726,318,5044,14.861635220125786
185,3,5052,42,5094,120.28571428571429
186,1,178,353,531,0.5042492917847026
186,2,597,276,873,2.1630434782608696
186,3,1088,338,1426,3.2189349112426036
186,4,2477,895,3372,2.7675977653631283
187,1,449,380,829,1.181578947368421
187,2,856,319,1175,2.683385579937304
187,3,1187,177,1364,6.706214689265536
187,4,1381,322,1703,4.288819875776397
187,5,1760,264,2024,6.666666666666667
187,6,2078,242,2320,8.586776859504132
188,1,191,545,736,0.3504587155963303
188,2,829,980,1809,0.8459183673469388
188,3,1813,982,2795,1.8462321792260692
188,4,2799,538,3337,5.202602230483271
188,5,3871,987,4858,3.921985815602837
188,6,4862,966,5828,5.033126293995859
188,7,5832,534,6366,10.92134831460674
189,1,24,312,336,0.07692307692307693
189,2,344,237,581,1.4514767932489452
189,3,610,330,940,1.8484848484848484
190,1,2763,87,2850,31.75862068965517
191,1,1415,398,1813,3.5552763819095476
191,2,2189,468,2657,4.677350427350428
192,1,7,599,606,0.011686143572621035
192,2,668,672,1340,0.9940476190476191
192,3,1363,388,1751,3.5128865979381443
192,4,1781,536,2317,3.3227611940298507
192,5,2329,633,2962,3.679304897314376
192,6,2975,319,3294,9.32601880877743
192,7,3302,601,3903,5.494176372712146
193,1,111,641,752,0.1731669266770671
193,2,780,765,1545,1.0196078431372548
194,1,420,944,1364,0.4449152542372881
194,2,1366,485,1851,2.816494845360825
195,1,176,697,873,0.25251076040172166
195,2,927,697,1624,1.3299856527977045
196,1,11,796,807,0.013819095477386936
197,1,1249,824,2073,1.5157766990291262
198,1,1450,931,2381,1.5574650912996777
199,1,42,216,258,0.19444444444444445
199,2,295,431,726,0.6844547563805105
200,1,202,948,1150,0.21308016877637131
201,1,50,98,148,0.5102040816326531
201,2,161,81,242,1.9876543209876543
201,3,299,56,355,5.339285714285714
201,4,407,89,496,4.573033707865169
201,5,526,292,818,1.8013698630136987
201,6,823,54,877,15.24074074074074
201,7,915,406,1321,2.2536945812807883
201,8,1341,711,2052,1.8860759493670887
201,9,2068,162,2230,12.765432098765432
201,10,2239,70,2309,31.985714285714284
201,11,2343,188,2531,12.462765957446809
201,12,2560,31,2591,82.58064516129032
201,13,4650,130,4780,35.76923076923077
201,14,4896,327,5223,14.972477064220184
201,15,5236,269,5505,19.46468401486989
201,16,7572,221,7793,34.262443438914026
202,1,74,107,181,0.6915887850467289
202,2,230,764,994,0.3010471204188482
202,3,1033,521,1554,1.982725527831094
202,4,1568,595,2163,2.635294117647059
203,1,16,508,524,0.031496062992125984
203,2,540,268,808,2.014925373134328
203,3,817,483,1300,1.691511387163561
203,4,1316,347,1663,3.792507204610951
203,5,1685,547,2232,3.080438756855576
203,6,2242,757,2999,2.961690885072655
203,7,3041,664,3705,4.579819277108434
204,1,38,2,40,19.0
204,2,165,500,665,0.33
204,3,674,618,1292,1.0906148867313916
204,4,1309,316,1625,4.1424050632911396
204,5,1639,616,2255,2.6607142857142856
204,6,2268,553,2821,4.10126582278481
204,7,2833,617,3450,4.591572123176661
204,8,3462,405,3867,8.548148148148147
204,9,3877,680,4557,5.701470588235294
204,10,4578,508,5086,9.011811023622048
204,11,5106,915,6021,5.580327868852459
204,12,6038,1021,7059,5.913809990205681
204,13,7079,735,7814,9.631292517006802
205,1,12,921,933,0.013029315960912053
205,2,941,589,1530,1.5976230899830222
205,3,1541,671,2212,2.2965722801788377
205,4,2225,394,2619,5.647208121827411
205,5,2638,719,3357,3.6689847009735743
205,6,3375,149,3524,22.651006711409394
205,7,3537,75,3612,47.16
205,8,3623,139,3762,26.06474820143885
205,9,3797,110,3907,34.518181818181816
205,10,3933,143,4076,27.503496503496503
205,11,4089,148,4237,27.62837837837838
206,1,160,538,698,0.29739776951672864
207,1,414,333,747,1.2432432432432432
208,1,234,962,1196,0.24324324324324326
208,2,1198,891,2089,1.3445566778900113
208,3,2091,978,3069,2.138036809815951
208,4,3071,714,3785,4.3011204481792715
208,5,3787,446,4233,8.491031390134529
208,6,4235,570,4805,7.4298245614035086
208,7,4807,612,5419,7.854575163398692
209,1,11,503,514,0.02186878727634195
209,2,532,669,1201,0.7952167414050823
209,3,1215,714,1929,1.7016806722689075
209,4,1939,568,2507,3.413732394366197
209,5,2520,568,3088,4.436619718309859
209,6,3128,617,3745,5.069692058346839
209,7,3799,631,4430,6.020602218700476
209,8,4473,596,5069,7.50503355704698
209,9,5081,649,5730,7.8289676425269645
210,1,672,334,1006,2.0119760479041915
210,2,1036,355,1391,2.9183098591549297
210,3,1652,263,1915,6.281368821292776
211,1,17,36,53,0.4722222222222222
211,2,1209,47,1256,25.72340425531915
211,3,1285,726,2011,1.7699724517906337
212,1,55,108,163,0.5092592592592593
212,2,208,271,479,0.7675276752767528
212,3,483,37,520,13.054054054054054
213,1,60,778,838,0.07712082262210797
214,1,186,594,780,0.31313131313131315
214,2,922,886,1808,1.0406320541760723
214,3,1810,314,2124,5.764331210191083
215,1,57,964,1021,0.05912863070539419
215,2,1045,571,1616,1.8301225919439579
215,3,1625,557,2182,2.9174147217235187
215,4,2207,1017,3224,2.1701081612586037
215,5,3230,427,3657,7.56440281030445
215,6,3724,554,4278,6.722021660649819
215,7,4287,885,5172,4.84406779661017
215,8,5190,629,5819,8.251192368839428
215,9,5837,98,5935,59.56122448979592
215,10,5966,265,6231,22.513207547169813
215,11,6370,572,6942,11.136363636363637
215,12,6948,61,7009,113.90163934426229
215,13,7047,503,7550,14.009940357852882
215,14,7560,473,8033,15.9830866807611
216,1,24,309,333,0.07766990291262135
216,2,429,968,1397,0.4431818181818182
216,3,1399,336,1735,4.163690476190476
216,4,1744,854,2598,2.0421545667447307
216,5,2649,482,3131,5.495850622406639
216,6,3137,764,3901,4.106020942408377
216,7,3929,882,4811,4.454648526077097
216,8,4828,1007,5835,4.794438927507448
216,9,5841,76,5917,76.85526315789474
216,10,5949,525,6474,11.331428571428571
216,11,6540,952,7492,6.869747899159663
217,1,442,88,530,5.0227272727272725
217,2,550,94,644,5.851063829787234
217,3,656,108,764,6.074074074074074
217,4,781,163,944,4.791411042944786
217,5,964,229,1193,4.209606986899563
217,6,1204,256,1460,4.703125
218,1,307,454,761,0.6762114537444934
218,2,777,593,1370,1.3102866779089377
219,1,141,535,676,0.2635514018691589
219,2,746,1028,1774,0.72568093385214
219,3,1825,1163,2988,1.5692175408426483
219,4,3055,1087,4142,2.81048758049678
219,5,4189,1223,5412,3.4251839738348324
219,6,5484,1183,6667,4.635672020287405
219,7,6687,766,7453,8.72976501305483
220,1,280,1021,1301,0.2742409402546523
220,2,1358,54,1412,25.14814814814815
221,1,987,275,1262,3.589090909090909
221,2,1288,606,1894,2.1254125412541254
222,1,15,488,503,0.030737704918032786
223,1,118,518,636,0.2277992277992278
223,2,668,500,1168,1.336
223,3,1220,510,1730,2.392156862745098
223,4,1786,565,2351,3.161061946902655
223,5,2457,372,2829,6.604838709677419
223,6,2841,382,3223,7.43717277486911
223,7,3253,447,3700,7.2774049217002235
223,8,3731,455,4186,8.2
223,9,4204,552,4756,7.615942028985507
223,10,4775,653,5428,7.312404287901991
223,11,5443,324,5767,16.799382716049383
223,12,5784,914,6698,6.328227571115974
224,1,163,954,1117,0.1708595387840671
224,2,1153,1007,2160,1.1449851042701091
224,3,2202,997,3199,2.208625877632899
224,4,3236,1042,4278,3.105566218809981
224,5,4312,892,5204,4.834080717488789
224,6,5239,939,6178,5.579339723109691
224,7,6215,836,7051,7.434210526315789
224,8,7083,792,7875,8.943181818181818
225,1,212,625,837,0.3392
225,2,852,633,1485,1.3459715639810426
225,3,1520,608,2128,2.5
225,4,2174,624,2798,3.483974358974359
225,5,2863,571,3434,5.0140105078809105
225,6,3455,612,4067,5.645424836601308
225,7,4111,1016,5127,4.046259842519685
226,1,136,155,291,0.8774193548387097
226,2,386,420,806,0.919047619047619
226,3,840,555,1395,1.5135135135135136
227,1,39,374,413,0.10427807486631016
227,2,616,246,862,2.5040650406504064
227,3,1381,747,2128,1.8487282463186077
227,4,2148,469,2617,4.5799573560767595
227,5,2640,225,2865,11.733333333333333
227,6,2885,563,3448,5.124333925399645
227,7,3527,342,3869,10.312865497076023
227,8,3984,603,4587,6.606965174129353
227,9,4640,599,5239,7.746243739565943
227,10,5260,609,5869,8.637110016420362
227,11,5893,377,6270,15.63129973474801
227,12,6417,286,6703,22.437062937062937
227,13,6938,365,7303,19.008219178082193
227,14,7452,315,7767,23.65714285714286
228,1,207,607,814,0.34102141680395387
228,2,833,129,962,6.457364341085271
228,3,1049,1075,2124,0.9758139534883721
228,4,2202,438,2640,5.027397260273973
229,1,90,781,871,0.11523687580025609
229,2,882,485,1367,1.8185567010309278
229,3,2752,840,3592,3.276190476190476
229,4,3613,567,4180,6.372134038800706
229,5,4206,464,4670,9.064655172413794
229,6,4695,496,5191,9.465725806451612
230,1,35,682,717,0.051319648093841645
230,2,728,834,1562,0.8729016786570744
230,3,1573,560,2133,2.8089285714285714
231,1,24,42,66,0.5714285714285714
231,2,86,89,175,0.9662921348314607
231,3,213,268,481,0.7947761194029851
231,4,585,545,1130,1.073394495412844
231,5,1219,564,1783,2.1613475177304964
231,6,2037,417,2454,4.884892086330935
231,7,2554,568,3122,4.496478873239437
231,8,3266,583,3849,5.602058319039451
231,9,4025,848,4873,4.746462264150943
231,10,4946,736,5682,6.720108695652174
231,11,5734,859,6593,6.675203725261932
231,12,6651,756,7407,8.797619047619047
232,1,13,3,16,4.333333333333333
233,1,1195,494,1689,2.419028340080972
233,2,1737,602,2339,2.8853820598006643
233,3,2400,439,2839,5.466970387243736
234,1,151,786,937,0.1921119592875318
234,2,958,812,1770,1.1798029556650247
234,3,1795,891,2686,2.014590347923681
234,4,2698,297,2995,9.084175084175085
234,5,3008,244,3252,12.327868852459016
235,1,2,24,26,0.08333333333333333
235,2,95,3,98,31.666666666666668
236,1,317,1170,1487,0.2709401709401709
236,2,3206,1042,4248,3.076775431861804
236,3,4758,716,5474,6.645251396648045
236,4,5642,11,5653,512.9090909090909
236,5,5661,960,6621,5.896875
237,1,1022,785,1807,1.3019108280254776
237,2,2160,811,2971,2.6633785450061653
237,3,3136,669,3805,4.687593423019432
237,4,3900,858,4758,4.545454545454546
237,5,4760,422,5182,11.27962085308057
238,1,23,124,147,0.18548387096774194
238,2,187,136,323,1.375
238,3,383,143,526,2.6783216783216783
238,4,544,164,708,3.317073170731707
239,1,111,598,709,0.18561872909698995
239,2,729,287,1016,2.5400696864111496
240,1,187,110,297,1.7
240,2,311,79,390,3.9367088607594938
240,3,399,53,452,7.528301886792453
240,4,468,79,547,5.924050632911392
240,5,564,68,632,8.294117647058824
240,6,656,74,730,8.864864864864865
240,7,753,92,845,8.184782608695652
240,8,860,79,939,10.886075949367088
240,9,1127,108,1235,10.435185185185185
240,10,1277,340,1617,3.7558823529411764
240,11,1620,46,1666,35.21739130434783
241,1,20,414,434,0.04830917874396135
241,2,495,649,1144,0.7627118644067796
241,3,1221,721,1942,1.6934812760055478
241,4,1960,465,2425,4.21505376344086
241,5,2440,503,2943,4.850894632206759
241,6,2961,546,3507,5.423076923076923
241,7,3520,539,4059,6.530612244897959
241,8,4125,573,4698,7.198952879581152
242,1,51,1023,1074,0.04985337243401759
243,1,214,887,1101,0.24126268320180383
243,2,1155,276,1431,4.184782608695652
243,3,1539,942,2481,1.6337579617834395
243,4,2568,882,3450,2.9115646258503403
243,5,3476,614,4090,5.6612377850162865
243,6,4131,102,4233,40.5
243,7,4294,660,4954,6.506060606060606
243,8,4987,698,5685,7.144699140401146
243,9,5714,312,6026,18.314102564102566
243,10,6076,296,6372,20.527027027027028
243,11,6418,418,6836,15.354066985645932
243,12,6858,296,7154,23.16891891891892
243,13,7194,212,7406,33.93396226415094
244,1,36,1022,1058,0.03522504892367906
244,2,1069,340,1409,3.1441176470588235
244,3,1427,1026,2453,1.3908382066276803
244,4,4197,427,4624,9.82903981264637
244,5,5176,232,5408,22.310344827586206
244,6,6891,274,7165,25.14963503649635
244,7,7457,164,7621,45.46951219512195
245,1,76,557,633,0.13644524236983843
245,2,644,11,655,58.54545454545455
246,1,143,616,759,0.23214285714285715
246,2,781,334,1115,2.338323353293413
246,3,1130,446,1576,2.5336322869955157
246,4,1584,646,2230,2.4520123839009287
246,5,2268,129,2397,17.58139534883721
246,6,2414,73,2487,33.06849315068493
247,1,34,60,94,0.5666666666666667
247,2,1092,629,1721,1.7360890302066774
247,3,1741,148,1889,11.763513513513514
247,4,1960,151,2111,12.980132450331126
247,5,2144,50,2194,42.88
247,6,2226,426,2652,5.225352112676056
247,7,2670,169,2839,15.798816568047338
247,8,2860,164,3024,17.4390243902439
247,9,3052,250,3302,12.208
247,10,3311,421,3732,7.864608076009501
247,11,3762,592,4354,6.35472972972973
247,12,4520,494,5014,9.149797570850202
247,13,5024,602,5626,8.345514950166113
247,14,5767,618,6385,9.331715210355988
248,1,208,712,920,0.29213483146067415
249,1,20,947,967,0.021119324181626188
250,1,8,225,233,0.035555555555555556
250,2,265,450,715,0.5888888888888889
250,3,723,223,946,3.242152466367713
250,4,978,478,1456,2.0460251046025104
250,5,1464,268,1732,5.462686567164179
250,6,1764,474,2238,3.721518987341772
250,7,2246,477,2723,4.7085953878406706
250,8,2755,490,3245,5.622448979591836
250,9,3253,420,3673,7.745238095238095
250,10,3705,504,4209,7.351190476190476
250,11,4217,418,4635,10.088516746411484
250,12,4642,309,4951,15.022653721682849
250,13,4961,579,5540,8.568221070811745
250,14,5556,498,6054,11.156626506024097
251,1,11,93,104,0.11827956989247312
251,2,112,129,241,0.8682170542635659
251,3,257,168,425,1.5297619047619047
251,4,453,392,845,1.155612244897959
251,5,863,431,1294,2.0023201856148494
251,6,1343,765,2108,1.7555555555555555
251,7,2145,802,2947,2.674563591022444
252,1,456,873,1329,0.5223367697594502
252,2,1334,907,2241,1.4707828004410144
252,3,2246,890,3136,2.5235955056179775
252,4,3141,940,4081,3.3414893617021275
252,5,4086,872,4958,4.685779816513762
252,6,4963,535,5498,9.276635514018691
253,1,72,367,439,0.19618528610354224
253,2,441,302,743,1.4602649006622517
254,1,415,373,788,1.1126005361930296
254,2,793,379,1172,2.0923482849604222
255,1,77,549,626,0.14025500910746813
256,1,21,531,552,0.03954802259887006
257,1,1001,1138,2139,0.8796133567662566
257,2,2148,966,3114,2.2236024844720497
257,3,3197,1229,4426,2.6013018714401954
257,4,4435,1123,5558,3.9492430988423863
257,5,5571,953,6524,5.845750262329486
257,6,6583,1166,7749,5.645797598627787
258,1,24,948,972,0.02531645569620253
259,1,140,459,599,0.30501089324618735
260,1,231,535,766,0.43177570093457945
260,2,1119,666,1785,1.6801801801801801
260,3,1831,769,2600,2.3810143042912872
260,4,2892,473,3365,6.114164904862579
260,5,3394,111,3505,30.576576576576578
260,6,3547,941,4488,3.769394261424017
260,7,4531,945,5476,4.794708994708995
260,8,5490,372,5862,14.758064516129032
260,9,5896,925,6821,6.374054054054054
260,10,6900,934,7834,7.387580299785867
261,1,167,55,222,3.036363636363636
261,2,229,86,315,2.6627906976744184
261,3,331,99,430,3.3434343434343434
262,1,13,465,478,0.02795698924731183
262,2,528,632,1160,0.8354430379746836
262,3,1205,558,1763,2.1594982078853047
262,4,1826,1056,2882,1.7291666666666667
262,5,2900,1046,3946,2.7724665391969405
262,6,3954,156,4110,25.346153846153847
263,1,353,238,591,1.4831932773109244
263,2,610,392,1002,1.5561224489795917
264,1,366,31,397,11.806451612903226
264,2,406,59,465,6.88135593220339
264,3,476,66,542,7.212121212121212
265,1,31,279,310,0.1111111111111111
265,2,329,352,681,0.9346590909090909
265,3,713,442,1155,1.6131221719457014
265,4,1226,477,1703,2.570230607966457
265,5,1747,376,2123,4.6462765957446805
266,1,53,622,675,0.08520900321543408
266,2,719,567,1286,1.2680776014109347
266,3,1345,823,2168,1.6342648845686514
266,4,2259,829,3088,2.7249698431845597
266,5,3163,545,3708,5.803669724770642
267,1,1140,1025,2165,1.1121951219512196
267,2,2168,468,2636,4.632478632478633
267,3,2660,834,3494,3.1894484412470026
267,4,3528,584,4112,6.041095890410959
267,5,4136,446,4582,9.27354260089686
267,6,4646,1011,5657,4.595450049455984
267,7,5659,203,5862,27.876847290640395
267,8,5887,975,6862,6.037948717948718
267,9,6864,203,7067,33.8128078817734
267,10,7076,557,7633,12.703770197486534
268,1,54,167,221,0.32335329341317365
268,2,382,523,905,0.7304015296367112
268,3,938,594,1532,1.5791245791245792
268,4,1574,640,2214,2.459375
268,5,2244,651,2895,3.447004608294931
268,6,3057,671,3728,4.555886736214605
269,1,42,479,521,0.08768267223382047
269,2,558,572,1130,0.9755244755244755
270,1,18,75,93,0.24
270,2,130,1215,1345,0.10699588477366255
270,3,1384,1170,2554,1.182905982905983
270,4,2671,1051,3722,2.5413891531874406
270,5,3851,828,4679,4.650966183574879
270,6,4781,1178,5959,4.058573853989813
270,7,6019,750,6769,8.025333333333334
270,8,6893,851,7744,8.09988249118684
271,1,343,11,354,31.181818181818183
271,2,371,152,523,2.4407894736842106
271,3,694,723,1417,0.9598893499308437
271,4,1470,568,2038,2.5880281690140845
271,5,2085,404,2489,5.160891089108911
271,6,2585,551,3136,4.691470054446461
271,7,3154,775,3929,4.069677419354838
272,1,1519,230,1749,6.604347826086957
272,2,1790,554,2344,3.2310469314079424
272,3,2356,912,3268,2.5833333333333335
272,4,3284,1048,4332,3.133587786259542
272,5,4348,992,5340,4.383064516129032
273,1,15,172,187,0.0872093023255814
273,2,557,401,958,1.3890274314214464
273,3,972,591,1563,1.6446700507614214
273,4,1583,160,1743,9.89375
273,5,1839,531,2370,3.463276836158192
273,6,2463,821,3284,3.0
273,7,3872,156,4028,24.82051282051282
274,1,370,880,1250,0.42045454545454547
274,2,1284,526,1810,2.44106463878327
275,1,82,445,527,0.1842696629213483
275,2,542,339,881,1.59882005899705
275,3,900,766,1666,1.174934725848564
275,4,1686,464,2150,3.6336206896551726
275,5,2163,663,2826,3.262443438914027
275,6,2841,793,3634,3.5825977301387137
275,7,3651,871,4522,4.191733639494833
275,8,4549,488,5037,9.32172131147541
276,1,535,62,597,8.629032258064516
277,1,196,573,769,0.34205933682373474
278,1,80,617,697,0.12965964343598055
278,2,708,425,1133,1.6658823529411764
278,3,1162,461,1623,2.5206073752711498
278,4,1646,270,1916,6.0962962962962965
278,5,1947,316,2263,6.1613924050632916
278,6,2286,249,2535,9.180722891566266
278,7,2553,456,3009,5.598684210526316
278,8,3087,777,3864,3.972972972972973
278,9,3942,651,4593,6.055299539170507
278,10,4713,112,4825,42.080357142857146
278,11,4992,626,5618,7.97444089456869
279,1,55,730,785,0.07534246575342465
279,2,824,748,1572,1.1016042780748663
279,3,1606,484,2090,3.3181818181818183
279,4,2098,511,2609,4.105675146771037
279,5,2617,480,3097,5.452083333333333
279,6,3105,387,3492,8.023255813953488
280,1,16,372,388,0.043010752688172046
281,1,19,487,506,0.039014373716632446
281,2,516,565,1081,0.9132743362831859
281,3,1098,590,1688,1.8610169491525423
282,1,28,247,275,0.11336032388663968
283,1,136,706,842,0.19263456090651557
283,2,904,786,1690,1.1501272264631044
283,3,1701,794,2495,2.1423173803526447
283,4,2523,700,3223,3.604285714285714
283,5,3247,629,3876,5.162162162162162
283,6,3983,776,4759,5.132731958762887
283,7,4805,537,5342,8.947858472998139
283,8,5385,498,5883,10.813253012048193
283,9,5906,644,6550,9.170807453416149
283,10,6589,661,7250,9.968229954614221
284,1,60,579,639,0.10362694300518134
284,2,686,645,1331,1.0635658914728683
284,3,1350,363,1713,3.71900826446281
284,4,1729,542,2271,3.190036900369004
284,5,2296,431,2727,5.327146171693736
284,6,2747,524,3271,5.24236641221374
285,1,19,355,374,0.05352112676056338
286,1,47,88,135,0.5340909090909091
286,2,148,38,186,3.8947368421052633
286,3,215,23,238,9.347826086956522
286,4,264,46,310,5.739130434782608
286,5,350,76,426,4.605263157894737
286,6,543,67,610,8.104477611940299
286,7,645,81,726,7.962962962962963
286,8,734,129,863,5.689922480620155
286,9,868,111,979,7.81981981981982
286,10,1013,133,1146,7.616541353383458
286,11,1176,140,1316,8.4
286,12,1338,273,1611,4.9010989010989015
286,13,1651,108,1759,15.287037037037036
286,14,1793,100,1893,17.93
286,15,1895,70,1965,27.071428571428573
286,16,1970,42,2012,46.904761904761905
286,17,2032,68,2100,29.88235294117647
286,18,2111,77,2188,27.415584415584416
286,19,2194,43,2237,51.02325581395349
286,20,2263,34,2297,66.55882352941177
286,21,2326,59,2385,39.42372881355932
286,22,2391,46,2437,51.97826086956522
286,23,2453,70,2523,35.042857142857144
286,24,2536,59,2595,42.983050847457626
286,25,2601,79,2680,32.924050632911396
286,26,2711,67,2778,40.46268656716418
286,27,2804,52,2856,53.92307692307692
286,28,2884,54,2938,53.407407407407405
286,29,2945,59,3004,49.91525423728814
286,30,3020,53,3073,56.9811320754717
286,31,3092,86,3178,35.95348837209303
286,32,3187,87,3274,36.632183908045974
286,33,3288,288,3576,11.416666666666666
287,1,98,790,888,0.1240506329113924
287,2,929,694,1623,1.3386167146974064
287,3,1700,802,2502,2.119700748129676
287,4,2648,871,3519,3.040183696900115
287,5,3613,844,4457,4.280805687203792
287,6,4483,747,5230,6.001338688085676
288,1,28,618,646,0.045307443365695796
288,2,655,463,1118,1.4146868250539957
289,1,53,441,494,0.12018140589569161
290,1,17,1040,1057,0.016346153846153847
290,2,1153,1305,2458,0.8835249042145594
291,1,76,283,359,0.26855123674911663
292,1,574,251,825,2.2868525896414345
292,2,887,521,1408,1.7024952015355086
292,3,1542,935,2477,1.6491978609625668
293,1,107,922,1029,0.11605206073752712
293,2,1093,49,1142,22.306122448979593
293,3,1254,842,2096,1.489311163895487
293,4,2142,826,2968,2.593220338983051
293,5,3012,835,3847,3.607185628742515
293,6,3876,448,4324,8.651785714285714
293,7,4386,883,5269,4.967157417893545
293,8,5293,589,5882,8.986417657045841
293,9,5919,271,6190,21.84132841328413
294,1,107,364,471,0.29395604395604397
294,2,479,430,909,1.113953488372093
294,3,975,385,1360,2.5324675324675323
295,1,51,158,209,0.3227848101265823
295,2,843,733,1576,1.150068212824011
295,3,1844,727,2571,2.5364511691884455
295,4,2598,718,3316,3.618384401114206
296,1,100,669,769,0.14947683109118087
296,2,887,557,1444,1.59245960502693
296,3,1522,526,2048,2.893536121673004
297,1,232,285,517,0.8140350877192982
298,1,56,417,473,0.1342925659472422
298,2,485,398,883,1.2185929648241205
298,3,899,703,1602,1.2788051209103841
298,4,1621,783,2404,2.070242656449553
298,5,2420,420,2840,5.761904761904762
298,6,2857,585,3442,4.883760683760684
298,7,3460,495,3955,6.98989898989899
298,8,3980,487,4467,8.172484599589323
298,9,4490,609,5099,7.372742200328407
298,10,5119,733,5852,6.98362892223738
298,11,5864,843,6707,6.956109134045077
298,12,6709,872,7581,7.693807339449541
298,13,7597,388,7985,19.579896907216494
299,1,280,405,685,0.691358024691358
299,2,703,425,1128,1.6541176470588235
299,3,1140,432,1572,2.638888888888889
299,4,1627,443,2070,3.672686230248307
299,5,2109,463,2572,4.555075593952484
299,6,2658,424,3082,6.268867924528302
300,1,43,817,860,0.05263157894736842
301,1,13,461,474,0.028199566160520606
301,2,509,78,587,6.5256410256410255
301,3,683,970,1653,0.7041237113402062
301,4,1661,671,2332,2.4754098360655736
302,1,21,327,348,0.06422018348623854
302,2,351,338,689,1.0384615384615385
303,1,153,929,1082,0.16469321851453175
303,2,1088,461,1549,2.3600867678958783
304,1,42,92,134,0.45652173913043476
304,2,157,320,477,0.490625
304,3,509,212,721,2.400943396226415
305,1,39,520,559,0.075
305,2,620,284,904,2.183098591549296
306,1,10,810,820,0.012345679012345678
307,1,38,593,631,0.06408094435075885
307,2,654,351,1005,1.8632478632478633
307,3,1072,928,2000,1.1551724137931034
307,4,2108,496,2604,4.25
307,5,2630,363,2993,7.245179063360881
307,6,3004,286,3290,10.503496503496503
307,7,3344,415,3759,8.057831325301205
307,8,4015,740,4755,5.425675675675675
307,9,4883,634,5517,7.701892744479495
307,10,5540,784,6324,7.066326530612245
307,11,6444,755,7199,8.535099337748344
307,12,7214,535,7749,13.48411214953271
307,13,7761,334,8095,23.236526946107784
308,1,5,96,101,0.052083333333333336
309,1,42,354,396,0.11864406779661017
309,2,422,240,662,1.7583333333333333
310,1,1538,382,1920,4.026178010471204
310,2,2018,554,2572,3.642599277978339
311,1,535,290,825,1.8448275862068966
311,2,1360,308,1668,4.415584415584416
312,1,85,669,754,0.12705530642750373
313,1,389,224,613,1.7366071428571428
313,2,629,209,838,3.0095693779904304
313,3,845,168,1013,5.029761904761905
313,4,1027,196,1223,5.239795918367347
313,5,1230,132,1362,9.318181818181818
313,6,1376,205,1581,6.712195121951219
313,7,1588,193,1781,8.2279792746114
313,8,1997,277,2274,7.209386281588448
313,9,2293,242,2535,9.475206611570249
314,1,52,660,712,0.07878787878787878
314,2,752,950,1702,0.791578947368421
314,3,1734,494,2228,3.5101214574898787
314,4,2240,690,2930,3.246376811594203
315,1,232,227,459,1.0220264317180616
315,2,537,282,819,1.9042553191489362
315,3,847,337,1184,2.513353115727003
315,4,1266,356,1622,3.556179775280899
315,5,1667,389,2056,4.285347043701799
315,6,2081,421,2502,4.9429928741092635
315,7,2516,383,2899,6.569190600522194
315,8,2965,285,3250,10.403508771929825
315,9,3311,317,3628,10.444794952681388
315,10,3702,300,4002,12.34
315,11,4088,292,4380,14.0
315,12,4410,321,4731,13.738317757009346
315,13,4797,287,5084,16.714285714285715
315,14,5107,341,5448,14.976539589442815
315,15,5466,299,5765,18.2809364548495
315,16,5799,283,6082,20.491166077738516
315,17,6181,344,6525,17.968023255813954
315,18,6559,316,6875,20.75632911392405
315,19,7001,349,7350,20.060171919770774
315,20,7379,329,7708,22.428571428571427
316,1,81,920,1001,0.08804347826086957
316,2,1008,438,1446,2.3013698630136985
316,3,1513,667,2180,2.2683658170914542
316,4,2308,904,3212,2.5530973451327434
316,5,3421,934,4355,3.6627408993576016
316,6,4362,938,5300,4.650319829424307
316,7,5307,513,5820,10.345029239766081
316,8,5907,875,6782,6.750857142857143
316,9,6789,465,7254,14.6
316,10,7313,722,8035,10.128808864265928
317,1,91,243,334,0.37448559670781895
317,2,534,620,1154,0.8612903225806452
318,1,410,74,484,5.54054054054054
318,2,517,564,1081,0.9166666666666666
318,3,1098,767,1865,1.4315514993481095
319,1,1646,600,2246,2.743333333333333
320,1,12,690,702,0.017391304347826087
321,1,131,427,558,0.30679156908665106
321,2,561,398,959,1.4095477386934674
321,3,962,391,1353,2.4603580562659846
321,4,1376,622,1998,2.212218649517685
321,5,2024,329,2353,6.151975683890577
321,6,2416,344,2760,7.023255813953488
321,7,2801,504,3305,5.557539682539683
321,8,3355,456,3811,7.357456140350878
321,9,3843,429,4272,8.958041958041958
321,10,4284,418,4702,10.248803827751196
321,11,4755,390,5145,12.192307692307692
321,12,5168,304,5472,17.0
321,13,5490,336,5826,16.339285714285715
321,14,6043,761,6804,7.940867279894875
321,15,6854,391,7245,17.529411764705884
321,16,7265,388,7653,18.72422680412371
322,1,2463,781,3244,3.1536491677336747
322,2,3273,833,4106,3.929171668667467
323,1,103,585,688,0.17606837606837608
324,1,3564,2,3566,1782.0
324,2,3581,551,4132,6.499092558983666
324,3,4159,699,4858,5.949928469241774
325,1,160,72,232,2.2222222222222223
325,2,255,104,359,2.451923076923077
325,3,373,99,472,3.7676767676767677
325,4,493,111,604,4.441441441441442
325,5,610,248,858,2.4596774193548385
325,6,864,246,1110,3.5121951219512195
325,7,1113,185,1298,6.0162162162162165
325,8,1312,125,1437,10.496
325,9,1443,96,1539,15.03125
325,10,1546,105,1651,14.723809523809523
325,11,1659,81,1740,20.48148148148148
325,12,1764,196,1960,9.0
325,13,2010,205,2215,9.804878048780488
326,1,10,313,323,0.03194888178913738
326,2,333,161,494,2.0683229813664594
326,3,504,334,838,1.5089820359281436
326,4,870,342,1212,2.543859649122807
327,1,21,411,432,0.051094890510948905
327,2,513,462,975,1.1103896103896105
327,3,999,735,1734,1.3591836734693878
327,4,1763,450,2213,3.917777777777778
327,5,2258,319,2577,7.078369905956113
327,6,2601,412,3013,6.313106796116505
327,7,3034,361,3395,8.404432132963988
327,8,3416,137,3553,24.934306569343065
328,1,114,855,969,0.13333333333333333
328,2,999,793,1792,1.2597730138713745
328,3,1818,768,2586,2.3671875
328,4,2607,1023,3630,2.5483870967741935
329,1,18,246,264,0.07317073170731707
330,1,777,16,793,48.5625
330,2,977,298,1275,3.278523489932886
331,1,702,15,717,46.8
331,2,988,620,1608,1.5935483870967742
332,1,30,962,992,0.031185031185031187
332,2,997,619,1616,1.6106623586429725
332,3,1620,303,1923,5.346534653465347
332,4,1939,797,2736,2.4328732747804267
332,5,2749,634,3383,4.33596214511041
333,1,21,496,517,0.04233870967741935
334,1,49,435,484,0.11264367816091954
334,2,523,61,584,8.573770491803279
334,3,633,488,1121,1.2971311475409837
334,4,1680,57,1737,29.473684210526315
334,5,1783,465,2248,3.8344086021505377
334,6,2524,240,2764,10.516666666666667
334,7,2773,47,2820,59.0
335,1,113,898,1011,0.12583518930957685
335,2,1051,749,1800,1.4032042723631508
336,1,802,748,1550,1.072192513368984
336,2,1562,919,2481,1.6996735582154516
336,3,2483,181,2664,13.718232044198896
337,1,30,323,353,0.09287925696594428
337,2,355,309,664,1.1488673139158576
337,3,666,107,773,6.224299065420561
338,1,45,92,137,0.4891304347826087
338,2,194,756,950,0.2566137566137566
338,3,965,794,1759,1.2153652392947103
338,4,1783,720,2503,2.4763888888888888
338,5,2511,734,3245,3.4209809264305178
338,6,3294,880,4174,3.743181818181818
338,7,4181,295,4476,14.172881355932203
338,8,4534,740,5274,6.127027027027027
338,9,5320,552,5872,9.63768115942029
338,10,5893,805,6698,7.320496894409938
338,11,6719,660,7379,10.18030303030303
339,1,29,606,635,0.04785478547854786
340,1,85,346,431,0.24566473988439305
340,2,444,373,817,1.1903485254691688
340,3,819,350,1169,2.34
340,4,1171,177,1348,6.6158192090395485
340,5,1370,377,1747,3.6339522546419096
340,6,1749,317,2066,5.517350157728707
341,1,101,794,895,0.12720403022670027
341,2,915,771,1686,1.1867704280155642
341,3,1706,754,2460,2.2625994694960214
341,4,2585,782,3367,3.3056265984654734
342,1,3307,426,3733,7.762910798122066
342,2,3843,398,4241,9.655778894472363
342,3,4258,582,4840,7.316151202749141
343,1,125,806,931,0.15508684863523572
343,2,978,1126,2104,0.8685612788632326
343,3,2112,641,2753,3.294851794071763
344,1,33,393,426,0.08396946564885496
344,2,453,450,903,1.0066666666666666
344,3,952,502,1454,1.8964143426294822
345,1,34,682,716,0.04985337243401759
345,2,805,985,1790,0.817258883248731
345,3,1878,1006,2884,1.8667992047713717
345,4,2902,945,3847,3.070899470899471
345,5,3886,922,4808,4.214750542299349
345,6,4841,924,5765,5.239177489177489
345,7,5810,975,6785,5.958974358974359
346,1,29,823,852,0.03523693803159174
346,2,863,848,1711,1.017688679245283
346,3,1731,736,2467,2.3519021739130435
346,4,2534,814,3348,3.113022113022113
346,5,3359,717,4076,4.684797768479777
346,6,4114,242,4356,17.0
346,7,4398,176,4574,24.988636363636363
346,8,4621,642,5263,7.197819314641745
347,1,21,247,268,0.08502024291497975
348,1,44,858,902,0.05128205128205128
348,2,932,680,1612,1.3705882352941177
348,3,1635,530,2165,3.0849056603773586
348,4,2202,785,2987,2.8050955414012737
349,1,1874,639,2513,2.9327073552425666
350,1,46,577,623,0.07972270363951472
351,1,23,428,451,0.053738317757009345
352,1,256,756,1012,0.3386243386243386
352,2,1140,456,1596,2.5
352,3,1646,105,1751,15.676190476190476
352,4,1781,241,2022,7.390041493775934
353,1,150,195,345,0.7692307692307693
353,2,441,187,628,2.358288770053476
354,1,69,563,632,0.12255772646536411
354,2,652,426,1078,1.5305164319248827
354,3,1097,412,1509,2.662621359223301
355,1,45,467,512,0.09635974304068523
355,2,893,883,1776,1.0113250283125708
356,1,58,657,715,0.0882800608828006
357,1,108,85,193,1.2705882352941176
358,1,24,342,366,0.07017543859649122
358,2,380,321,701,1.1838006230529594
359,1,230,953,1183,0.24134312696747115
360,1,51,947,998,0.05385427666314678
360,2,1263,618,1881,2.0436893203883497
360,3,2018,519,2537,3.888246628131021
360,4,2667,484,3151,5.510330578512397
360,5,3199,457,3656,7.0
360,6,3731,458,4189,8.146288209606986
360,7,4568,827,5395,5.523579201934703
360,8,5474,764,6238,7.164921465968586
360,9,6294,449,6743,14.017817371937639
360,10,6859,411,7270,16.688564476885645
360,11,7343,419,7762,17.525059665871122
361,1,12,267,279,0.0449438202247191
361,2,306,413,719,0.7409200968523002
361,3,774,439,1213,1.7630979498861048
361,4,1255,557,1812,2.253141831238779
361,5,1874,422,2296,4.440758293838862
361,6,2320,780,3100,2.9743589743589745
361,7,3143,596,3739,5.273489932885906
361,8,3801,545,4346,6.9743119266055045
361,9,4370,109,4479,40.091743119266056
362,1,17,262,279,0.0648854961832061
362,2,316,861,1177,0.3670150987224158
362,3,1192,681,1873,1.750367107195301
362,4,1918,733,2651,2.616643929058663
362,5,2676,308,2984,8.688311688311689
363,1,884,84,968,10.523809523809524
364,1,67,478,545,0.1401673640167364
364,2,560,456,1016,1.2280701754385965
365,1,44,504,548,0.0873015873015873
365,2,559,426,985,1.312206572769953
365,3,996,243,1239,4.098765432098766
365,4,1268,820,2088,1.5463414634146342
366,1,16,892,908,0.017937219730941704
366,2,974,974,1948,1.0
366,3,2836,1637,4473,1.7324373854612096
367,1,22,312,334,0.07051282051282051
367,2,342,830,1172,0.41204819277108434
367,3,1324,861,2185,1.537746806039489
367,4,2229,918,3147,2.4281045751633985
367,5,3218,858,4076,3.7505827505827507
367,6,4218,822,5040,5.131386861313868
367,7,5102,982,6084,5.1955193482688395
367,8,6092,823,6915,7.402187120291616
368,1,209,813,1022,0.2570725707257073
368,2,1028,604,1632,1.7019867549668874
368,3,1724,800,2524,2.155
369,1,203,908,1111,0.22356828193832598
369,2,1119,609,1728,1.8374384236453203
369,3,2511,912,3423,2.7532894736842106
369,4,3431,884,4315,3.8812217194570136
369,5,4321,855,5176,5.053801169590643
369,6,5392,909,6301,5.931793179317932
369,7,6309,958,7267,6.585594989561587
370,1,1973,677,2650,2.914327917282127
370,2,7320,414,7734,17.681159420289855
371,1,62,303,365,0.20462046204620463
371,2,393,200,593,1.965
371,3,605,332,937,1.822289156626506
371,4,1005,443,1448,2.2686230248306996
371,5,1469,721,2190,2.0374479889042996
371,6,2219,467,2686,4.751605995717345
372,1,56,809,865,0.069221260815822
372,2,906,520,1426,1.7423076923076923
373,1,39,371,410,0.10512129380053908
373,2,432,351,783,1.2307692307692308
374,1,1478,292,1770,5.061643835616438
374,2,1779,341,2120,5.217008797653959
374,3,2411,788,3199,3.0596446700507616
374,4,3233,872,4105,3.7075688073394497
374,5,4160,796,4956,5.226130653266332
374,6,4968,907,5875,5.477398015435502
374,7,5887,972,6859,6.056584362139918
374,8,6885,1003,7888,6.864406779661017
375,1,105,863,968,0.12166859791425261
375,2,998,39,1037,25.58974358974359
375,3,1049,202,1251,5.193069306930693
375,4,1336,917,2253,1.4569247546346784
375,5,2261,364,2625,6.211538461538462
375,6,2691,746,3437,3.6072386058981234
375,7,6434,851,7285,7.560517038777908
375,8,7324,245,7569,29.89387755102041
375,9,7613,81,7694,93.98765432098766
376,1,781,590,1371,1.323728813559322
376,2,1747,202,1949,8.648514851485148
376,3,3207,475,3682,6.751578947368421
377,1,9,57,66,0.15789473684210525
377,2,71,137,208,0.5182481751824818
377,3,215,1030,1245,0.2087378640776699
377,4,1248,1008,2256,1.2380952380952381
377,5,2259,220,2479,10.268181818181818
377,6,2483,131,2614,18.954198473282442
377,7,2630,503,3133,5.2286282306163026
378,1,769,30,799,25.633333333333333
379,1,14,191,205,0.07329842931937172
380,1,3769,339,4108,11.117994100294986
380,2,4130,268,4398,15.41044776119403
380,3,4413,552,4965,7.994565217391305
380,4,4974,503,5477,9.888667992047713
380,5,5522,60,5582,92.03333333333333
380,6,6156,918,7074,6.705882352941177
380,7,7101,262,7363,27.103053435114504
381,1,486,779,1265,0.6238767650834403
382,1,35,452,487,0.07743362831858407
382,2,495,410,905,1.2073170731707317
383,1,216,300,516,0.72
383,2,521,289,810,1.8027681660899655
383,3,1139,253,1392,4.5019762845849804
383,4,1397,264,1661,5.291666666666667
383,5,1667,330,1997,5.051515151515152
383,6,2002,198,2200,10.11111111111111
383,7,2420,281,2701,8.612099644128113
383,8,2707,258,2965,10.492248062015504
383,9,2970,207,3177,14.347826086956522
383,10,3182,138,3320,23.057971014492754
384,1,99,350,449,0.28285714285714286
384,2,452,335,787,1.3492537313432835
384,3,790,336,1126,2.3511904761904763
385,1,45,329,374,0.13677811550151975
385,2,385,435,820,0.8850574712643678
385,3,836,600,1436,1.3933333333333333
385,4,1455,394,1849,3.6928934010152283
385,5,1891,632,2523,2.992088607594937
385,6,2536,631,3167,4.019017432646593
386,1,53,479,532,0.11064718162839249
387,1,47,731,778,0.06429548563611491
388,1,21,1002,1023,0.020958083832335328
389,1,442,584,1026,0.7568493150684932
389,2,1045,529,1574,1.9754253308128544
389,3,1676,490,2166,3.4204081632653063
389,4,2177,526,2703,4.138783269961977
389,5,2716,513,3229,5.294346978557505
389,6,3284,519,3803,6.327552986512524
389,7,3843,394,4237,9.753807106598984
389,8,4250,86,4336,49.41860465116279
389,9,4391,654,5045,6.7140672782874615
389,10,5070,340,5410,14.911764705882353
389,11,5458,974,6432,5.6036960985626285
389,12,6435,397,6832,16.209068010075566
389,13,6845,145,6990,47.206896551724135
389,14,7013,127,7140,55.22047244094488
389,15,7157,141,7298,50.758865248226954
389,16,7608,189,7797,40.25396825396825
390,1,76,533,609,0.1425891181988743
390,2,1130,615,1745,1.8373983739837398
391,1,12,353,365,0.0339943342776204
391,2,367,259,626,1.416988416988417
392,1,73,70,143,1.042857142857143
392,2,159,89,248,1.7865168539325842
393,1,14,871,885,0.016073478760045924
393,2,898,837,1735,1.0728793309438471
393,3,1743,1038,2781,1.6791907514450868
393,4,2789,477,3266,5.846960167714885
394,1,1064,1040,2104,1.023076923076923
394,2,2106,598,2704,3.5217391304347827
394,3,3108,6,3114,518.0
394,4,3538,1060,4598,3.3377358490566036
394,5,4600,810,5410,5.679012345679013
395,1,353,249,602,1.4176706827309238
395,2,616,300,916,2.0533333333333332
396,1,237,74,311,3.2027027027027026
396,2,331,110,441,3.0090909090909093
396,3,562,231,793,2.432900432900433
396,4,840,122,962,6.885245901639344
396,5,976,93,1069,10.494623655913978
396,6,1165,123,1288,9.471544715447154
396,7,1359,229,1588,5.934497816593886
396,8,1615,136,1751,11.875
396,9,1816,136,1952,13.352941176470589
396,10,1962,115,2077,17.06086956521739
396,11,2092,245,2337,8.538775510204081
396,12,2349,140,2489,16.77857142857143
397,1,7,151,158,0.046357615894039736
397,2,194,566,760,0.34275618374558303
397,3,874,455,1329,1.920879120879121
397,4,1470,341,1811,4.310850439882698
397,5,1998,394,2392,5.071065989847716
397,6,2563,826,3389,3.1029055690072638
397,7,3447,330,3777,10.445454545454545
397,8,3807,82,3889,46.426829268292686
397,9,4048,365,4413,11.09041095890411
397,10,4625,437,5062,10.583524027459955
397,11,5188,265,5453,19.577358490566038
397,12,5744,574,6318,10.006968641114982
397,13,6470,240,6710,26.958333333333332
397,14,6866,671,7537,10.232488822652757
397,15,7622,236,7858,32.29661016949152
398,1,55,69,124,0.7971014492753623
398,2,448,554,1002,0.8086642599277978
398,3,1055,796,1851,1.3253768844221105
398,4,2165,452,2617,4.789823008849558
398,5,2827,262,3089,10.790076335877863
399,1,22,480,502,0.04583333333333333
400,1,26,836,862,0.03110047846889952
401,1,2041,1003,3044,2.0348953140578265
401,2,3049,465,3514,6.556989247311828
401,3,3573,911,4484,3.9220636663007684
401,4,4543,960,5503,4.732291666666667
401,5,5562,905,6467,6.14585635359116
401,6,6539,723,7262,9.044260027662517
401,7,7349,704,8053,10.438920454545455
402,1,43,595,638,0.07226890756302522
403,1,22,112,134,0.19642857142857142
404,1,361,455,816,0.7934065934065934
405,1,73,486,559,0.15020576131687244
406,1,39,395,434,0.09873417721518987
407,1,49,636,685,0.0770440251572327
408,1,25,497,522,0.05030181086519115
408,2,541,438,979,1.235159817351598
408,3,1013,706,1719,1.434844192634561
408,4,1738,763,2501,2.2778505897771955
408,5,2516,379,2895,6.638522427440633
408,6,2907,579,3486,5.020725388601036
409,1,193,631,824,0.3058637083993661
409,2,832,538,1370,1.546468401486989
409,3,1471,78,1549,18.858974358974358
409,4,2163,735,2898,2.942857142857143
409,5,3136,85,3221,36.89411764705882
409,6,3351,95,3446,35.27368421052632
409,7,3528,303,3831,11.643564356435643
409,8,4309,312,4621,13.810897435897436
409,9,4629,396,5025,11.68939393939394
409,10,5114,264,5378,19.37121212121212
409,11,5386,329,5715,16.37082066869301
409,12,5723,166,5889,34.475903614457835
409,13,5923,496,6419,11.941532258064516
410,1,13,454,467,0.028634361233480177
410,2,473,62,535,7.629032258064516
410,3,544,346,890,1.5722543352601157
410,4,900,525,1425,1.7142857142857142
411,1,32,17,49,1.8823529411764706
412,1,1086,648,1734,1.6759259259259258
413,1,51,20,71,2.55
413,2,73,20,93,3.65
413,3,108,36,144,3.0
413,4,180,44,224,4.090909090909091
413,5,231,29,260,7.9655172413793105
413,6,281,33,314,8.515151515151516
413,7,354,70,424,5.057142857142857
413,8,437,39,476,11.205128205128204
413,9,515,90,605,5.722222222222222
413,10,633,441,1074,1.435374149659864
414,1,38,557,595,0.06822262118491922
414,2,660,423,1083,1.5602836879432624
414,3,1655,732,2387,2.260928961748634
415,1,29,589,618,0.04923599320882852
416,1,96,76,172,1.263157894736842
416,2,289,59,348,4.898305084745763
416,3,766,308,1074,2.487012987012987
416,4,1080,306,1386,3.5294117647058822
416,5,1392,192,1584,7.25
416,6,1689,293,1982,5.764505119453925
416,7,2100,297,2397,7.070707070707071
416,8,2403,222,2625,10.824324324324325
417,1,62,601,663,0.10316139767054909
417,2,732,764,1496,0.9581151832460733
417,3,1511,68,1579,22.220588235294116
417,4,1619,523,2142,3.095602294455067
417,5,2210,650,2860,3.4
417,6,2938,676,3614,4.346153846153846
417,7,3650,536,4186,6.809701492537314
417,8,4197,418,4615,10.04066985645933
417,9,4618,367,4985,12.583106267029972
417,10,5000,95,5095,52.63157894736842
417,11,5135,390,5525,13.166666666666666
417,12,5528,309,5837,17.889967637540455
417,13,5841,76,5917,76.85526315789474
417,14,5922,136,6058,43.544117647058826
418,1,14,543,557,0.02578268876611418
419,1,1681,504,2185,3.3353174603174605
419,2,2188,524,2712,4.175572519083969
419,3,2715,523,3238,5.191204588910134
420,1,109,1001,1110,0.1088911088911089
420,2,1200,997,2197,1.2036108324974926
421,1,183,636,819,0.28773584905660377
421,2,822,418,1240,1.9665071770334928
421,3,1788,618,2406,2.8932038834951457
421,4,2409,607,3016,3.9686985172981877
421,5,3019,636,3655,4.74685534591195
421,6,3658,372,4030,9.833333333333334
421,7,4033,552,4585,7.306159420289855
422,1,136,706,842,0.19263456090651557
422,2,904,786,1690,1.1501272264631044
422,3,1701,794,2495,2.1423173803526447
422,4,2523,700,3223,3.604285714285714
422,5,3247,629,3876,5.162162162162162
422,6,3983,776,4759,5.132731958762887
422,7,4805,537,5342,8.947858472998139
422,8,5385,498,5883,10.813253012048193
422,9,5906,644,6550,9.170807453416149
422,10,6589,661,7250,9.968229954614221
423,1,35,116,151,0.3017241379310345
423,2,193,113,306,1.7079646017699115
423,3,315,119,434,2.6470588235294117
424,1,226,406,632,0.5566502463054187
424,2,640,408,1048,1.5686274509803921
424,3,1056,417,1473,2.5323741007194243
424,4,1481,209,1690,7.086124401913875
424,5,1715,424,2139,4.044811320754717
424,6,2147,420,2567,5.1119047619047615
424,7,2575,389,2964,6.619537275064268
424,8,2972,453,3425,6.560706401766004
424,9,3433,220,3653,15.604545454545455
425,1,41,533,574,0.07692307692307693
425,2,594,652,1246,0.911042944785276
425,3,1281,605,1886,2.1173553719008265
426,1,684,673,1357,1.0163447251114412
426,2,1505,662,2167,2.273413897280967
426,3,2243,654,2897,3.429663608562691
426,4,2973,588,3561,5.0561224489795915
426,5,3637,643,4280,5.656298600311042
426,6,4356,654,5010,6.660550458715596
426,7,5130,578,5708,8.875432525951558
426,8,5828,718,6546,8.116991643454039
426,9,6666,716,7382,9.310055865921788
427,1,8,41,49,0.1951219512195122
427,2,446,592,1038,0.7533783783783784
427,3,1067,600,1667,1.7783333333333333
428,1,245,999,1244,0.24524524524524524
428,2,1269,414,1683,3.0652173913043477
428,3,1717,811,2528,2.1171393341553637
428,4,2579,364,2943,7.085164835164835
428,5,3038,492,3530,6.17479674796748
428,6,3549,590,4139,6.0152542372881355
428,7,4899,581,5480,8.432013769363166
428,8,5494,579,6073,9.488773747841105
429,1,64,796,860,0.08040201005025126
430,1,62,665,727,0.09323308270676692
430,2,740,789,1529,0.9378960709759189
430,3,1643,464,2107,3.540948275862069
430,4,2122,649,2771,3.2696456086286596
430,5,2903,766,3669,3.789817232375979
430,6,3718,491,4209,7.572301425661914
430,7,4251,143,4394,29.727272727272727
430,8,4481,14,4495,320.07142857142856
430,9,4582,164,4746,27.9390243902439
430,10,4757,7,4764,679.5714285714286
430,11,4773,676,5449,7.060650887573964
430,12,5469,396,5865,13.81060606060606
430,13,5915,213,6128,27.769953051643192
430,14,6144,316,6460,19.443037974683545
430,15,6472,245,6717,26.416326530612245
430,16,6730,435,7165,15.471264367816092
430,17,7192,498,7690,14.441767068273093
430,18,7784,257,8041,30.28793774319066
431,1,84,350,434,0.24
431,2,551,355,906,1.552112676056338
431,3,908,373,1281,2.4343163538873993
431,4,1330,378,1708,3.5185185185185186
431,5,1710,405,2115,4.222222222222222
432,1,84,517,601,0.16247582205029013
432,2,609,248,857,2.4556451612903225
432,3,863,323,1186,2.671826625386997
433,1,106,134,240,0.7910447761194029
434,1,41,142,183,0.2887323943661972
434,2,208,702,910,0.2962962962962963
434,3,934,954,1888,0.9790356394129979
434,4,1917,957,2874,2.0031347962382444
434,5,2913,863,3776,3.3754345307068365
434,6,3823,812,4635,4.708128078817734
434,7,4672,671,5343,6.96274217585693
434,8,5380,627,6007,8.580542264752792
434,9,6045,816,6861,7.408088235294118
434,10,6915,760,7675,9.098684210526315
435,1,147,493,640,0.29817444219066935
435,2,737,491,1228,1.5010183299389002
435,3,1304,352,1656,3.7045454545454546
436,1,9,236,245,0.038135593220338986
436,2,252,34,286,7.411764705882353
436,3,308,38,346,8.105263157894736
436,4,359,40,399,8.975
436,5,418,43,461,9.720930232558139
436,6,505,60,565,8.416666666666666
436,7,575,61,636,9.426229508196721
436,8,652,63,715,10.34920634920635
436,9,724,107,831,6.766355140186916
436,10,856,115,971,7.443478260869565
436,11,976,334,1310,2.9221556886227544
436,12,1327,495,1822,2.680808080808081
436,13,1837,510,2347,3.6019607843137256
436,14,2365,978,3343,2.418200408997955
436,15,3363,563,3926,5.9733570159857905
436,16,3946,816,4762,4.83578431372549
436,17,4765,703,5468,6.778093883357041
436,18,5471,535,6006,10.226168224299066
436,19,6014,474,6488,12.68776371308017
436,20,6491,466,6957,13.929184549356224
436,21,6968,274,7242,25.43065693430657
437,1,37,582,619,0.06357388316151202
438,1,76,1140,1216,0.06666666666666667
438,2,1233,634,1867,1.944794952681388
438,3,1885,149,2034,12.651006711409396
438,4,2048,449,2497,4.5612472160356345
438,5,2613,24,2637,108.875
438,6,2752,628,3380,4.382165605095541
438,7,3391,973,4364,3.4850976361767727
438,8,4380,268,4648,16.34328358208955
438,9,4673,953,5626,4.903462749213012
438,10,5639,188,5827,29.99468085106383
438,11,5853,184,6037,31.809782608695652
438,12,6060,260,6320,23.307692307692307
438,13,6332,589,6921,10.750424448217318
439,1,89,838,927,0.10620525059665871
439,2,1307,1068,2375,1.2237827715355805
439,3,2549,697,3246,3.6571018651362985
439,4,3594,1160,4754,3.0982758620689657
439,5,4756,159,4915,29.91194968553459
439,6,4988,584,5572,8.54109589041096
439,7,5902,1168,7070,5.053082191780822
440,1,622,624,1246,0.9967948717948718
440,2,1282,310,1592,4.135483870967742
440,3,1679,136,1815,12.345588235294118
440,4,1928,188,2116,10.25531914893617
441,1,12,382,394,0.031413612565445025
441,2,404,733,1137,0.5511596180081856
442,1,54,167,221,0.32335329341317365
442,2,382,523,905,0.7304015296367112
442,3,938,594,1532,1.5791245791245792
442,4,1574,640,2214,2.459375
442,5,2244,651,2895,3.447004608294931
442,6,3057,671,3728,4.555886736214605
443,1,645,491,1136,1.3136456211812628
443,2,1639,399,2038,4.1077694235588975
443,3,2442,369,2811,6.617886178861789
443,4,3264,368,3632,8.869565217391305
443,5,3957,327,4284,12.100917431192661
443,6,4566,309,4875,14.776699029126213
443,7,5053,331,5384,15.265861027190333
443,8,5581,346,5927,16.13005780346821
444,1,2305,898,3203,2.566815144766147
444,2,3205,521,3726,6.151631477927063
444,3,3744,301,4045,12.438538205980066
444,4,4052,399,4451,10.155388471177945
444,5,4472,463,4935,9.658747300215984
444,6,4964,316,5280,15.708860759493671
444,7,5287,324,5611,16.317901234567902
444,8,6758,480,7238,14.079166666666667
444,9,7293,503,7796,14.499005964214712
445,1,368,56,424,6.571428571428571
445,2,3702,491,4193,7.539714867617108
445,3,4208,531,4739,7.9246704331450095
445,4,4742,519,5261,9.136801541425818
445,5,5336,246,5582,21.691056910569106
445,6,5750,438,6188,13.127853881278538
445,7,6205,398,6603,15.590452261306533
445,8,6619,867,7486,7.6343713956170705
446,1,28,576,604,0.04861111111111111
447,1,2442,1048,3490,2.3301526717557253
447,2,3542,541,4083,6.547134935304991
448,1,723,947,1670,0.7634635691657867
448,2,1678,3,1681,559.3333333333334
449,1,12,454,466,0.02643171806167401
449,2,483,515,998,0.9378640776699029
449,3,1025,341,1366,3.005865102639296
449,4,1394,431,1825,3.234338747099768
449,5,1853,432,2285,4.289351851851852
449,6,2313,278,2591,8.320143884892087
449,7,2612,480,3092,5.441666666666666
450,1,95,766,861,0.12402088772845953
451,1,45,937,982,0.048025613660619
451,2,988,427,1415,2.3138173302107727
451,3,1428,458,1886,3.1179039301310043
451,4,1895,508,2403,3.7303149606299213
452,1,24,656,680,0.036585365853658534
452,2,706,847,1553,0.833530106257379
452,3,1575,1065,2640,1.4788732394366197
452,4,2688,1039,3727,2.5871029836381134
452,5,3731,272,4003,13.716911764705882
452,6,4017,1075,5092,3.736744186046512
452,7,5096,598,5694,8.521739130434783
452,8,5743,915,6658,6.276502732240437
452,9,6692,455,7147,14.707692307692307
452,10,7170,734,7904,9.768392370572206
452,11,7919,40,7959,197.975
453,1,51,384,435,0.1328125
453,2,457,251,708,1.8207171314741035
453,3,728,431,1159,1.6890951276102089
454,1,64,385,449,0.16623376623376623
454,2,492,309,801,1.5922330097087378
454,3,826,264,1090,3.128787878787879
454,4,1107,291,1398,3.804123711340206
454,5,1408,243,1651,5.794238683127572
454,6,1668,55,1723,30.327272727272728
455,1,117,158,275,0.740506329113924
455,2,292,426,718,0.6854460093896714
455,3,771,584,1355,1.3202054794520548
455,4,1415,849,2264,1.6666666666666667
456,1,24,523,547,0.045889101338432124
457,1,114,254,368,0.44881889763779526
458,1,241,185,426,1.3027027027027027
459,1,102,68,170,1.5
459,2,272,54,326,5.037037037037037
459,3,461,119,580,3.8739495798319328
459,4,623,367,990,1.6975476839237058
459,5,1201,376,1577,3.1941489361702127
459,6,1611,358,1969,4.5
459,7,1987,257,2244,7.7315175097276265
459,8,2288,102,2390,22.431372549019606
459,9,2530,174,2704,14.540229885057471
459,10,2726,68,2794,40.088235294117645
459,11,2979,272,3251,10.952205882352942
460,1,22,928,950,0.023706896551724137
461,1,38,633,671,0.06003159557661927
462,1,1093,301,1394,3.6312292358803986
462,2,1406,307,1713,4.579804560260587
462,3,1717,69,1786,24.884057971014492
463,1,27,1072,1099,0.025186567164179104
463,2,1107,795,1902,1.3924528301886792
464,1,16,41,57,0.3902439024390244
465,1,15,277,292,0.05415162454873646
466,1,76,760,836,0.1
467,1,368,56,424,6.571428571428571
467,2,3702,491,4193,7.539714867617108
467,3,4208,531,4739,7.9246704331450095
467,4,4742,519,5261,9.136801541425818
467,5,5336,246,5582,21.691056910569106
467,6,5750,438,6188,13.127853881278538
467,7,6205,398,6603,15.590452261306533
467,8,6619,867,7486,7.6343713956170705
468,1,1475,605,2080,2.43801652892562
468,2,4965,326,5291,15.230061349693251
469,1,17,606,623,0.028052805280528052
469,2,637,819,1456,0.7777777777777778
470,1,3910,888,4798,4.403153153153153
470,2,4800,868,5668,5.529953917050691
470,3,5681,12,5693,473.4166666666667
470,4,5716,478,6194,11.9581589958159
470,5,6196,431,6627,14.375870069605568
470,6,6638,335,6973,19.81492537313433
471,1,136,544,680,0.25
471,2,760,500,1260,1.52
471,3,1288,334,1622,3.856287425149701
471,4,1634,253,1887,6.458498023715415
472,1,9,57,66,0.15789473684210525
472,2,71,137,208,0.5182481751824818
472,3,215,1030,1245,0.2087378640776699
472,4,1248,1008,2256,1.2380952380952381
472,5,2259,220,2479,10.268181818181818
472,6,2483,131,2614,18.954198473282442
472,7,2630,503,3133,5.2286282306163026
472,8,3179,201,3380,15.81592039800995
472,9,3399,57,3456,59.63157894736842
472,10,3506,851,4357,4.119858989424207
472,11,4410,249,4659,17.710843373493976
472,12,4679,687,5366,6.810771470160116
472,13,5385,223,5608,24.14798206278027
472,14,5632,288,5920,19.555555555555557
472,15,5949,853,6802,6.974208675263775
472,16,6804,859,7663,7.920838183934808
473,1,699,994,1693,0.7032193158953722
473,2,1710,1041,2751,1.6426512968299711
473,3,2834,952,3786,2.976890756302521
473,4,3794,986,4780,3.847870182555781
473,5,4788,597,5385,8.020100502512562
474,1,721,447,1168,1.6129753914988814
474,2,1519,523,2042,2.904397705544933
474,3,2111,7,2118,301.57142857142856
474,4,2841,464,3305,6.122844827586207
474,5,3656,542,4198,6.745387453874539
474,6,4267,7,4274,609.5714285714286
475,1,27,1151,1178,0.023457862728062554
475,2,1227,1739,2966,0.7055779183438758
476,1,210,312,522,0.6730769230769231
476,2,821,488,1309,1.6823770491803278
477,1,193,874,1067,0.2208237986270023
478,1,93,1198,1291,0.07762938230383973
478,2,1296,611,1907,2.121112929623568
479,1,120,98,218,1.2244897959183674
479,2,235,308,543,0.762987012987013
479,3,569,454,1023,1.2533039647577093
479,4,1046,419,1465,2.496420047732697
479,5,1480,355,1835,4.169014084507042
479,6,1846,437,2283,4.224256292906179
479,7,2314,489,2803,4.732106339468302
479,8,2871,579,3450,4.958549222797927
479,9,3474,489,3963,7.104294478527607
479,10,3976,386,4362,10.300518134715025
479,11,4375,379,4754,11.54353562005277
479,12,4939,653,5592,7.563552833078101
479,13,5690,456,6146,12.478070175438596
479,14,6335,487,6822,13.008213552361397
479,15,6883,334,7217,20.607784431137723
479,16,7245,277,7522,26.15523465703971
479,17,7701,225,7926,34.22666666666667
480,1,61,105,166,0.580952380952381
480,2,171,96,267,1.78125
480,3,275,168,443,1.6369047619047619
481,1,1773,956,2729,1.854602510460251
481,2,2732,433,3165,6.309468822170901
481,3,3238,966,4204,3.351966873706004
481,4,4207,553,4760,7.6075949367088604
481,5,4772,883,5655,5.404303510758777
481,6,5657,489,6146,11.568507157464213
481,7,6155,883,7038,6.970554926387316
481,8,7048,507,7555,13.90138067061144
482,1,61,1245,1306,0.04899598393574297
482,2,1329,446,1775,2.9798206278026904
483,1,50,81,131,0.6172839506172839
484,1,49,118,167,0.4152542372881356
484,2,1723,416,2139,4.141826923076923
484,3,2170,179,2349,12.12290502793296
484,4,2358,328,2686,7.189024390243903
484,5,2723,109,2832,24.98165137614679
484,6,2865,353,3218,8.11614730878187
484,7,3235,178,3413,18.174157303370787
484,8,3426,229,3655,14.960698689956331
484,9,3682,381,4063,9.664041994750656
484,10,4071,189,4260,21.53968253968254
484,11,4278,259,4537,16.517374517374517
484,12,4553,228,4781,19.969298245614034
484,13,4798,233,5031,20.59227467811159
484,14,5039,258,5297,19.531007751937985
484,15,5321,164,5485,32.44512195121951
484,16,5494,228,5722,24.096491228070175
484,17,5732,249,5981,23.02008032128514
484,18,5997,320,6317,18.740625
484,19,6358,328,6686,19.384146341463413
484,20,6701,414,7115,16.185990338164252
484,21,7148,274,7422,26.087591240875913
484,22,7435,272,7707,27.334558823529413
484,23,7741,260,8001,29.773076923076925
485,1,202,966,1168,0.20910973084886128
485,2,1220,963,2183,1.2668743509865006
485,3,2291,903,3194,2.5370985603543743
486,1,46,690,736,0.06666666666666667
487,1,74,369,443,0.2005420054200542
488,1,209,1059,1268,0.19735599622285174
488,2,1453,1072,2525,1.3554104477611941
489,1,105,9,114,11.666666666666666
489,2,1980,367,2347,5.395095367847412
489,3,2349,111,2460,21.16216216216216
489,4,5284,287,5571,18.411149825783973
489,5,5574,37,5611,150.64864864864865
490,1,39,86,125,0.45348837209302323
491,1,199,251,450,0.7928286852589641
491,2,468,215,683,2.1767441860465118
491,3,942,356,1298,2.646067415730337
491,4,1439,340,1779,4.232352941176471
492,1,830,71,901,11.690140845070422
492,2,2127,86,2213,24.732558139534884
492,3,2307,86,2393,26.825581395348838
492,4,2413,425,2838,5.6776470588235295
492,5,2898,622,3520,4.659163987138264
492,6,3590,660,4250,5.4393939393939394
492,7,4636,703,5339,6.594594594594595
492,8,5786,150,5936,38.57333333333333
492,9,6419,166,6585,38.66867469879518
492,10,6996,153,7149,45.72549019607843
492,11,7217,889,8106,8.118110236220472
493,1,159,964,1123,0.16493775933609958
493,2,1130,990,2120,1.1414141414141414
493,3,2127,990,3117,2.1484848484848484
493,4,3125,415,3540,7.530120481927711
494,1,35,147,182,0.23809523809523808
495,1,38,715,753,0.05314685314685315
496,1,115,952,1067,0.1207983193277311
496,2,1891,849,2740,2.227326266195524
496,3,2796,947,3743,2.9524815205913413
496,4,3755,102,3857,36.81372549019608
496,5,3952,694,4646,5.694524495677234
496,6,4700,725,5425,6.482758620689655
496,7,5446,34,5480,160.1764705882353
497,1,22,634,656,0.03470031545741325
497,2,667,413,1080,1.6150121065375302
497,3,1095,693,1788,1.58008658008658
497,4,1826,988,2814,1.8481781376518218
497,5,2820,444,3264,6.351351351351352
497,6,3293,345,3638,9.544927536231883
497,7,3668,604,4272,6.072847682119205
497,8,4317,462,4779,9.344155844155845
497,9,4832,248,5080,19.483870967741936
497,10,5099,681,5780,7.487518355359765
497,11,5794,212,6006,27.330188679245282
497,12,6026,127,6153,47.44881889763779
498,1,14,382,396,0.03664921465968586
499,1,249,443,692,0.5620767494356659
499,2,694,365,1059,1.9013698630136986
499,3,1086,452,1538,2.4026548672566372
499,4,1563,154,1717,10.14935064935065
499,5,1769,369,2138,4.794037940379404
499,6,2167,622,2789,3.4839228295819935
499,7,2816,465,3281,6.055913978494623
499,8,3302,470,3772,7.025531914893617
499,9,3774,394,4168,9.578680203045685
499,10,4266,626,4892,6.814696485623003
499,11,4951,457,5408,10.833698030634574
499,12,5410,366,5776,14.781420765027322
500,1,461,946,1407,0.48731501057082455
500,2,1410,182,1592,7.747252747252747
501,1,75,679,754,0.11045655375552282
501,2,828,760,1588,1.0894736842105264
501,3,1646,773,2419,2.129366106080207
501,4,2438,596,3034,4.090604026845638
501,5,3061,105,3166,29.152380952380952
501,6,3207,926,4133,3.463282937365011
501,7,4156,567,4723,7.329805996472663
501,8,4742,385,5127,12.316883116883117
501,9,5140,306,5446,16.797385620915033
501,10,5466,318,5784,17.18867924528302
502,1,36,377,413,0.09549071618037135
503,1,15,456,471,0.03289473684210526
504,1,116,397,513,0.29219143576826195
504,2,515,352,867,1.4630681818181819
504,3,869,302,1171,2.877483443708609
504,4,1182,227,1409,5.20704845814978
504,5,1491,351,1842,4.247863247863248
504,6,1865,517,2382,3.607350096711799
504,7,2412,403,2815,5.9851116625310175
505,1,146,688,834,0.21220930232558138
505,2,1029,1220,2249,0.8434426229508196
506,1,107,331,438,0.32326283987915405
506,2,453,293,746,1.546075085324232
507,1,31,849,880,0.03651354534746761
507,2,894,411,1305,2.1751824817518246
507,3,1320,403,1723,3.2754342431761785
507,4,1735,398,2133,4.35929648241206
507,5,2147,394,2541,5.449238578680203
507,6,2550,979,3529,2.6046986721144023
507,7,3560,551,4111,6.460980036297641
507,8,4125,723,4848,5.7053941908713695
507,9,6688,278,6966,24.057553956834532
508,1,75,983,1058,0.0762970498474059
509,1,75,1015,1090,0.07389162561576355
509,2,1124,439,1563,2.560364464692483
510,1,28,52,80,0.5384615384615384
510,2,386,498,884,0.7751004016064257
510,3,956,572,1528,1.6713286713286712
510,4,1554,125,1679,12.432
510,5,1686,62,1748,27.193548387096776
511,1,11,430,441,0.02558139534883721
512,1,1794,1204,2998,1.4900332225913622
512,2,3000,685,3685,4.37956204379562
512,3,5501,1217,6718,4.520131470829909
513,1,69,290,359,0.23793103448275862
513,2,392,330,722,1.187878787878788
513,3,830,355,1185,2.3380281690140845
513,4,1191,416,1607,2.862980769230769
514,1,105,505,610,0.2079207920792079
514,2,692,125,817,5.536
514,3,879,615,1494,1.4292682926829268
515,1,31,322,353,0.09627329192546584
516,1,708,556,1264,1.2733812949640289
517,1,4282,9,4291,475.77777777777777
517,2,7691,9,7700,854.5555555555555
518,1,22,909,931,0.0242024202420242
519,1,22,673,695,0.03268945022288262
519,2,744,900,1644,0.8266666666666667
519,3,1662,937,2599,1.7737459978655283
519,4,2619,784,3403,3.3405612244897958
519,5,3423,945,4368,3.6222222222222222
520,1,90,125,215,0.72
520,2,225,125,350,1.8
520,3,365,347,712,1.0518731988472623
520,4,726,286,1012,2.5384615384615383
521,1,11,151,162,0.0728476821192053
521,2,172,207,379,0.8309178743961353
521,3,408,526,934,0.7756653992395437
521,4,947,214,1161,4.425233644859813
521,5,1175,481,1656,2.442827442827443
521,6,1679,531,2210,3.1619585687382297
521,7,2249,249,2498,9.032128514056225
521,8,2517,227,2744,11.088105726872246
521,9,2785,363,3148,7.672176308539945
522,1,485,3,488,161.66666666666666
522,2,1835,3,1838,611.6666666666666
522,3,3024,2,3026,1512.0
522,4,5655,243,5898,23.271604938271604
522,5,5950,288,6238,20.65972222222222
522,6,6240,91,6331,68.57142857142857
523,1,3010,648,3658,4.645061728395062
523,2,4239,730,4969,5.806849315068493
523,3,5036,401,5437,12.558603491271821
524,1,191,440,631,0.4340909090909091
524,2,652,193,845,3.378238341968912
524,3,899,505,1404,1.7801980198019802
524,4,1430,454,1884,3.149779735682819
524,5,1964,518,2482,3.7915057915057915
524,6,2711,720,3431,3.765277777777778
524,7,3461,464,3925,7.459051724137931
524,8,3985,527,4512,7.561669829222011
524,9,4585,382,4967,12.002617801047121
524,10,4976,209,5185,23.80861244019139
524,11,5201,288,5489,18.05902777777778
524,12,5504,557,6061,9.881508078994614
524,13,6107,539,6646,11.330241187384045
524,14,6656,598,7254,11.130434782608695
524,15,7375,623,7998,11.837881219903691
525,1,44,74,118,0.5945945945945946
525,2,134,66,200,2.0303030303030303
525,3,212,92,304,2.3043478260869565
525,4,328,324,652,1.0123456790123457
525,5,667,494,1161,1.3502024291497976
526,1,10,415,425,0.024096385542168676
527,1,48,38,86,1.263157894736842
528,1,85,682,767,0.12463343108504399
528,2,787,751,1538,1.047936085219707
528,3,1552,487,2039,3.186858316221766
529,1,217,395,612,0.549367088607595
529,2,646,475,1121,1.36
529,3,2059,704,2763,2.924715909090909
529,4,4660,161,4821,28.944099378881987
530,1,21,386,407,0.054404145077720206
531,1,93,928,1021,0.10021551724137931
531,2,1030,875,1905,1.177142857142857
532,1,22,477,499,0.04612159329140461
533,1,19,265,284,0.07169811320754717
533,2,313,287,600,1.0905923344947734
533,3,618,425,1043,1.4541176470588235
534,1,51,500,551,0.102
534,2,716,329,1045,2.17629179331307
534,3,1175,706,1881,1.6643059490084986
534,4,1891,982,2873,1.9256619144602851
534,5,3289,922,4211,3.567245119305857
534,6,4248,318,4566,13.358490566037736
534,7,4571,417,4988,10.961630695443645
534,8,5098,621,5719,8.209339774557165
534,9,5729,1052,6781,5.445817490494297
534,10,6792,44,6836,154.36363636363637
535,1,4090,578,4668,7.076124567474048
536,1,13,365,378,0.03561643835616438
536,2,384,46,430,8.347826086956522
537,1,53,867,920,0.06113033448673587
538,1,33,40,73,0.825
538,2,523,88,611,5.943181818181818
538,3,1395,83,1478,16.80722891566265
538,4,2034,95,2129,21.410526315789475
538,5,2445,67,2512,36.492537313432834
538,6,2537,49,2586,51.775510204081634
538,7,3398,125,3523,27.184
538,8,3544,55,3599,64.43636363636364
538,9,4098,127,4225,32.267716535433074
538,10,6253,188,6441,33.26063829787234
538,11,6529,355,6884,18.39154929577465
538,12,6904,324,7228,21.308641975308642
538,13,7239,394,7633,18.373096446700508
538,14,7648,403,8051,18.977667493796528
539,1,22,418,440,0.05263157894736842
539,2,461,748,1209,0.6163101604278075
540,1,96,700,796,0.13714285714285715
540,2,864,852,1716,1.0140845070422535
541,1,72,696,768,0.10344827586206896
541,2,804,849,1653,0.9469964664310954
542,1,55,942,997,0.058386411889596604
543,1,25,407,432,0.06142506142506143
544,1,54,948,1002,0.056962025316455694
544,2,1044,947,1991,1.102428722280887
545,1,90,871,961,0.10332950631458095
545,2,963,221,1184,4.357466063348416
546,1,78,406,484,0.1921182266009852
546,2,506,280,786,1.8071428571428572
546,3,803,174,977,4.614942528735632
547,1,45,167,212,0.2694610778443114
547,2,214,239,453,0.895397489539749
547,3,455,289,744,1.57439446366782
547,4,746,224,970,3.330357142857143
547,5,972,257,1229,3.782101167315175
547,6,1231,224,1455,5.495535714285714
547,7,1457,231,1688,6.307359307359308
547,8,1690,260,1950,6.5
547,9,1952,252,2204,7.746031746031746
547,10,2206,280,2486,7.878571428571429
547,11,2488,262,2750,9.49618320610687
547,12,2752,271,3023,10.154981549815497
547,13,3025,255,3280,11.862745098039216
547,14,3282,234,3516,14.025641025641026
547,15,3518,250,3768,14.072
548,1,49,436,485,0.11238532110091744
548,2,573,731,1304,0.7838577291381669
548,3,1355,1037,2392,1.3066538090646094
548,4,2407,571,2978,4.215411558669002
548,5,2988,350,3338,8.537142857142857
548,6,4501,259,4760,17.37837837837838
548,7,4795,834,5629,5.749400479616307
548,8,5684,703,6387,8.085348506401138
548,9,6434,1076,7510,5.979553903345725
548,10,7537,54,7591,139.57407407407408
549,1,99,79,178,1.2531645569620253
549,2,188,73,261,2.5753424657534247
549,3,322,74,396,4.351351351351352
549,4,412,78,490,5.282051282051282
550,1,55,571,626,0.09632224168126094
550,2,650,924,1574,0.7034632034632035
550,3,1612,791,2403,2.0379266750948166
550,4,2410,154,2564,15.64935064935065
550,5,2573,160,2733,16.08125
550,6,2745,256,3001,10.72265625
550,7,3026,271,3297,11.166051660516604
551,1,170,500,670,0.34
551,2,859,465,1324,1.8473118279569893
552,1,35,394,429,0.08883248730964467
552,2,469,484,953,0.96900826446281
553,1,271,208,479,1.3028846153846154
553,2,509,257,766,1.9805447470817121
553,3,837,250,1087,3.348
553,4,1135,247,1382,4.5951417004048585
553,5,1409,254,1663,5.547244094488189
553,6,1770,305,2075,5.80327868852459
553,7,2182,276,2458,7.905797101449275
553,8,2472,201,2673,12.298507462686567
553,9,2727,270,2997,10.1
553,10,3030,240,3270,12.625
554,1,279,140,419,1.9928571428571429
554,2,466,883,1349,0.5277463193657984
554,3,1356,676,2032,2.0059171597633134
555,1,832,418,1250,1.9904306220095693
555,2,1310,553,1863,2.368896925858951
555,3,1904,784,2688,2.4285714285714284
556,1,37,954,991,0.03878406708595388
556,2,1002,411,1413,2.437956204379562
556,3,1437,337,1774,4.264094955489615
556,4,1787,365,2152,4.895890410958904
556,5,2280,235,2515,9.702127659574469
556,6,2600,247,2847,10.526315789473685
556,7,2865,270,3135,10.61111111111111
556,8,3154,523,3677,6.030592734225621
556,9,3686,396,4082,9.308080808080808
556,10,4112,681,4793,6.038179148311307
556,11,4832,12,4844,402.6666666666667
556,12,4907,439,5346,11.177676537585421
556,13,5419,382,5801,14.18586387434555
556,14,5841,251,6092,23.270916334661354
556,15,6267,172,6439,36.43604651162791
556,16,6646,406,7052,16.36945812807882
556,17,7310,416,7726,17.572115384615383
556,18,7753,282,8035,27.49290780141844
557,1,643,491,1134,1.309572301425662
558,1,110,496,606,0.2217741935483871
558,2,614,275,889,2.232727272727273
558,3,1222,298,1520,4.100671140939597
558,4,1574,221,1795,7.122171945701357
559,1,3973,9,3982,441.44444444444446
559,2,4066,529,4595,7.686200378071834
560,1,9,241,250,0.03734439834024896
560,2,258,270,528,0.9555555555555556
560,3,536,419,955,1.279236276849642
560,4,966,525,1491,1.84
560,5,1505,606,2111,2.4834983498349836
560,6,2130,128,2258,16.640625
560,7,2290,270,2560,8.481481481481481
560,8,2571,364,2935,7.063186813186813
560,9,2997,481,3478,6.230769230769231
560,10,3589,434,4023,8.26958525345622
560,11,4071,395,4466,10.30632911392405
560,12,4519,454,4973,9.95374449339207
560,13,5037,67,5104,75.17910447761194
560,14,5182,340,5522,15.241176470588234
560,15,5580,353,5933,15.807365439093484
560,16,5966,248,6214,24.056451612903224
560,17,6287,490,6777,12.83061224489796
560,18,6861,58,6919,118.29310344827586
560,19,6954,376,7330,18.49468085106383
560,20,7388,459,7847,16.095860566448803
561,1,21,914,935,0.022975929978118162
561,2,987,118,1105,8.364406779661017
561,3,1117,363,1480,3.077134986225895
561,4,1489,435,1924,3.4229885057471265
562,1,210,262,472,0.8015267175572519
562,2,493,677,1170,0.7282127031019202
562,3,1193,178,1371,6.702247191011236
562,4,1385,368,1753,3.7635869565217392
562,5,1763,154,1917,11.448051948051948
562,6,1926,154,2080,12.506493506493506
562,7,2100,157,2257,13.375796178343949
562,8,2275,195,2470,11.666666666666666
562,9,2481,318,2799,7.80188679245283
562,10,2806,199,3005,14.100502512562814
562,11,3032,304,3336,9.973684210526315
563,1,28,194,222,0.14432989690721648
564,1,757,600,1357,1.2616666666666667
564,2,1498,544,2042,2.7536764705882355
564,3,2127,902,3029,2.358093126385809
564,4,3034,496,3530,6.116935483870968
564,5,3586,729,4315,4.919067215363512
564,6,4344,397,4741,10.942065491183879
564,7,4758,497,5255,9.57344064386318
564,8,5263,111,5374,47.414414414414416
564,9,5381,556,5937,9.678057553956835
564,10,5957,571,6528,10.432574430823117
564,11,6542,507,7049,12.903353057199212
564,12,7102,500,7602,14.204
565,1,41,544,585,0.07536764705882353
565,2,942,594,1536,1.5858585858585859
565,3,1790,488,2278,3.668032786885246
565,4,2481,544,3025,4.560661764705882
565,5,3220,595,3815,5.411764705882353
565,6,4019,475,4494,8.461052631578948
565,7,4672,471,5143,9.91932059447983
565,8,5267,511,5778,10.307240704500979
565,9,6039,475,6514,12.713684210526315
565,10,6776,456,7232,14.859649122807017
565,11,7513,538,8051,13.964684014869889
566,1,103,417,520,0.24700239808153476
567,1,27,22,49,1.2272727272727273
567,2,199,550,749,0.3618181818181818
567,3,795,35,830,22.714285714285715
567,4,1718,658,2376,2.6109422492401215
567,5,3294,701,3995,4.699001426533523
567,6,4005,31,4036,129.19354838709677
567,7,4997,720,5717,6.940277777777778
567,8,5784,643,6427,8.995334370139968
567,9,6473,350,6823,18.494285714285713
567,10,6852,649,7501,10.557781201848998
567,11,7556,503,8059,15.021868787276341
568,1,246,843,1089,0.2918149466192171
568,2,1136,810,1946,1.4024691358024692
569,1,142,379,521,0.37467018469656993
569,2,523,364,887,1.4368131868131868
569,3,946,632,1578,1.4968354430379747
570,1,13,509,522,0.025540275049115914
571,1,51,427,478,0.11943793911007025
571,2,3245,479,3724,6.774530271398747
572,1,131,399,530,0.3283208020050125
572,2,770,353,1123,2.181303116147309
573,1,38,978,1016,0.03885480572597137
573,2,1064,300,1364,3.546666666666667
573,3,1443,685,2128,2.1065693430656935
573,4,2130,734,2864,2.9019073569482288
573,5,2994,796,3790,3.7613065326633164
573,6,3792,949,4741,3.9957850368809273
573,7,4812,1168,5980,4.11986301369863
573,8,5982,1011,6993,5.916913946587537
573,9,7044,14,7058,503.14285714285717
573,10,7133,452,7585,15.780973451327434
574,1,201,1856,2057,0.10829741379310345
575,1,68,548,616,0.12408759124087591
576,1,548,783,1331,0.6998722860791826
577,1,16,566,582,0.028268551236749116
578,1,218,453,671,0.48123620309050774
578,2,724,479,1203,1.511482254697286
578,3,1228,206,1434,5.961165048543689
578,4,5953,283,6236,21.035335689045937
578,5,7464,184,7648,40.56521739130435
579,1,54,988,1042,0.05465587044534413
579,2,1044,521,1565,2.0038387715930903
579,3,1597,542,2139,2.9464944649446494
579,4,2152,714,2866,3.0140056022408963
579,5,2942,613,3555,4.799347471451876
579,6,3581,355,3936,10.087323943661971
579,7,3968,508,4476,7.811023622047244
579,8,4521,671,5192,6.737704918032787
579,9,5218,848,6066,6.153301886792453
579,10,6081,283,6364,21.487632508833922
580,1,17,655,672,0.025954198473282442
580,2,691,555,1246,1.245045045045045
580,3,1277,629,1906,2.0302066772655007
581,1,708,402,1110,1.7611940298507462
581,2,1112,120,1232,9.266666666666667
581,3,1248,398,1646,3.135678391959799
581,4,1648,438,2086,3.7625570776255706
581,5,2088,474,2562,4.405063291139241
581,6,2564,322,2886,7.962732919254658
582,1,15,299,314,0.05016722408026756
582,2,377,327,704,1.1529051987767585
582,3,730,469,1199,1.556503198294243
582,4,1264,672,1936,1.880952380952381
582,5,1948,177,2125,11.005649717514125
582,6,2144,100,2244,21.44
582,7,2258,170,2428,13.282352941176471
582,8,2455,176,2631,13.948863636363637
583,1,142,460,602,0.30869565217391304
583,2,628,109,737,5.761467889908257
583,3,772,495,1267,1.5595959595959596
583,4,1313,503,1816,2.610337972166998
583,5,1873,524,2397,3.5744274809160306
583,6,2463,531,2994,4.638418079096045
584,1,48,779,827,0.06161745827984596
585,1,46,762,808,0.06036745406824147
585,2,843,124,967,6.798387096774194
585,3,1012,126,1138,8.031746031746032
585,4,1184,134,1318,8.835820895522389
586,1,20,501,521,0.03992015968063872
587,1,20,715,735,0.027972027972027972
587,2,746,426,1172,1.7511737089201878
588,1,31,893,924,0.03471444568868981
588,2,987,1031,2018,0.9573229873908826
588,3,2086,1008,3094,2.0694444444444446
588,4,3107,1004,4111,3.0946215139442232
588,5,4120,1044,5164,3.946360153256705
589,1,26,228,254,0.11403508771929824
589,2,269,275,544,0.9781818181818182
589,3,614,42,656,14.619047619047619
589,4,713,261,974,2.731800766283525
589,5,1005,288,1293,3.4895833333333335
589,6,1332,330,1662,4.036363636363636
589,7,1742,454,2196,3.8370044052863435
589,8,2225,588,2813,3.7840136054421767
589,9,2878,362,3240,7.9502762430939224
589,10,3285,606,3891,5.420792079207921
589,11,4034,9,4043,448.22222222222223
589,12,4128,505,4633,8.174257425742574
589,13,4672,553,5225,8.448462929475587
589,14,5274,430,5704,12.265116279069767
589,15,5759,497,6256,11.587525150905433
589,16,6306,430,6736,14.665116279069768
589,17,6805,155,6960,43.903225806451616
589,18,7035,443,7478,15.880361173814899
589,19,7567,370,7937,20.451351351351352
590,1,262,278,540,0.9424460431654677
591,1,139,929,1068,0.1496232508073197
591,2,1156,614,1770,1.8827361563517915
591,3,1910,619,2529,3.08562197092084
592,1,3359,979,4338,3.431052093973442
592,2,4357,981,5338,4.44138634046891
592,3,5342,967,6309,5.524301964839711
593,1,315,820,1135,0.38414634146341464
593,2,1241,842,2083,1.4738717339667458
593,3,2092,836,2928,2.5023923444976077
593,4,2936,822,3758,3.5717761557177616
593,5,3765,478,4243,7.876569037656904
594,1,32,302,334,0.10596026490066225
594,2,348,366,714,0.9508196721311475
594,3,758,326,1084,2.3251533742331287
594,4,1089,304,1393,3.5822368421052633
594,5,1398,245,1643,5.706122448979592
594,6,1656,104,1760,15.923076923076923
594,7,1788,374,2162,4.780748663101604
594,8,2167,257,2424,8.431906614785992
594,9,2452,296,2748,8.283783783783784
594,10,2762,299,3061,9.237458193979933
595,1,375,563,938,0.6660746003552398
595,2,1479,561,2040,2.6363636363636362
595,3,2050,45,2095,45.55555555555556
595,4,3782,495,4277,7.64040404040404
595,5,4345,387,4732,11.227390180878553
595,6,4738,388,5126,12.211340206185566
595,7,5133,443,5576,11.586907449209932
595,8,5611,430,6041,13.048837209302325
596,1,51,343,394,0.14868804664723032
596,2,417,389,806,1.0719794344473008
596,3,884,356,1240,2.4831460674157304
596,4,1264,382,1646,3.3089005235602094
596,5,1655,400,2055,4.1375
596,6,2077,458,2535,4.534934497816594
596,7,2557,452,3009,5.657079646017699
596,8,3027,418,3445,7.241626794258373
596,9,3462,368,3830,9.407608695652174
596,10,3843,409,4252,9.396088019559903
597,1,81,751,832,0.10785619174434088
598,1,38,381,419,0.09973753280839895
598,2,435,328,763,1.326219512195122
599,1,100,193,293,0.5181347150259067
599,2,333,149,482,2.2348993288590604
599,3,497,216,713,2.300925925925926
599,4,733,90,823,8.144444444444444
599,5,827,236,1063,3.5042372881355934
599,6,1083,103,1186,10.514563106796116
599,7,1226,560,1786,2.1892857142857145
600,1,134,401,535,0.3341645885286783
601,1,134,169,303,0.7928994082840237
602,1,645,491,1136,1.3136456211812628
602,2,1639,399,2038,4.1077694235588975
602,3,2442,369,2811,6.617886178861789
602,4,3264,368,3632,8.869565217391305
602,5,3957,327,4284,12.100917431192661
602,6,4566,309,4875,14.776699029126213
602,7,5053,331,5384,15.265861027190333
602,8,5581,346,5927,16.13005780346821
602,9,5946,403,6349,14.754342431761787
602,10,6407,615,7022,10.417886178861789
602,11,7042,517,7559,13.620889748549324
602,12,7643,380,8023,20.11315789473684
603,1,49,860,909,0.056976744186046514
603,2,933,859,1792,1.0861466821885915
603,3,1902,872,2774,2.1811926605504586
603,4,2800,560,3360,5.0
603,5,3392,742,4134,4.571428571428571
603,6,4157,363,4520,11.451790633608816
603,7,4610,999,5609,4.614614614614615
603,8,5637,605,6242,9.317355371900826
603,9,6264,401,6665,15.620947630922693
603,10,6692,398,7090,16.814070351758794
604,1,49,138,187,0.35507246376811596
604,2,228,163,391,1.3987730061349692
604,3,406,487,893,0.8336755646817249
604,4,906,489,1395,1.852760736196319
604,5,1490,530,2020,2.811320754716981
604,6,2065,661,2726,3.124054462934947
605,1,21,436,457,0.0481651376146789
605,2,471,413,884,1.1404358353510895
605,3,892,251,1143,3.553784860557769
605,4,1159,160,1319,7.24375
605,5,1430,208,1638,6.875
605,6,1705,558,2263,3.0555555555555554
605,7,2271,211,2482,10.763033175355451
605,8,2508,318,2826,7.886792452830188
605,9,2851,387,3238,7.366925064599483
605,10,3739,301,4040,12.421926910299003
606,1,27,935,962,0.028877005347593583
606,2,981,976,1957,1.0051229508196722
606,3,1969,657,2626,2.9969558599695585
606,4,2642,904,3546,2.922566371681416
607,1,2401,350,2751,6.86
607,2,2773,305,3078,9.091803278688525
608,1,13,32,45,0.40625
608,2,84,1016,1100,0.08267716535433071
608,3,1235,957,2192,1.290491118077325
608,4,2223,757,2980,2.9365918097754293
608,5,3021,686,3707,4.403790087463557
609,1,1086,648,1734,1.6759259259259258
610,1,533,626,1159,0.8514376996805112
610,2,1279,702,1981,1.8219373219373218
610,3,2035,441,2476,4.6145124716553285
610,4,2723,807,3530,3.3742255266418835
610,5,3603,652,4255,5.526073619631902
611,1,2041,1003,3044,2.0348953140578265
611,2,3049,465,3514,6.556989247311828
611,3,3573,911,4484,3.9220636663007684
611,4,4543,960,5503,4.732291666666667
611,5,5562,905,6467,6.14585635359116
612,1,160,598,758,0.26755852842809363
613,1,88,9,97,9.777777777777779
613,2,104,144,248,0.7222222222222222
613,3,280,165,445,1.696969696969697
613,4,451,170,621,2.652941176470588
613,5,625,170,795,3.676470588235294
613,6,805,161,966,5.0
613,7,980,174,1154,5.632183908045977
613,8,1160,153,1313,7.5816993464052285
614,1,201,68,269,2.9558823529411766
614,2,318,49,367,6.489795918367347
614,3,389,68,457,5.720588235294118
614,4,498,69,567,7.217391304347826
614,5,577,79,656,7.30379746835443
614,6,727,72,799,10.097222222222221
614,7,881,199,1080,4.42713567839196
614,8,1143,109,1252,10.486238532110091
614,9,1294,84,1378,15.404761904761905
614,10,1444,86,1530,16.790697674418606
614,11,1628,93,1721,17.50537634408602
614,12,1741,88,1829,19.78409090909091
614,13,1887,69,1956,27.347826086956523
615,1,238,256,494,0.9296875
615,2,511,339,850,1.5073746312684366
615,3,902,317,1219,2.8454258675078865
615,4,1241,322,1563,3.8540372670807455
615,5,1589,323,1912,4.919504643962848
616,1,15,857,872,0.01750291715285881
617,1,105,683,788,0.15373352855051245
617,2,820,965,1785,0.8497409326424871
617,3,1823,1009,2832,1.806739345887017
617,4,2928,984,3912,2.975609756097561
617,5,3941,590,4531,6.679661016949153
618,1,664,654,1318,1.0152905198776758
618,2,1385,461,1846,3.004338394793926
618,3,1858,474,2332,3.919831223628692
618,4,2360,535,2895,4.411214953271028
618,5,2919,267,3186,10.932584269662922
619,1,237,890,1127,0.2662921348314607
619,2,1130,233,1363,4.849785407725322
620,1,19,326,345,0.05828220858895705
620,2,371,81,452,4.580246913580247
620,3,474,113,587,4.1946902654867255
621,1,44,347,391,0.12680115273775217
621,2,423,232,655,1.8232758620689655
621,3,667,310,977,2.1516129032258067
621,4,1007,225,1232,4.475555555555555
621,5,1268,333,1601,3.8078078078078077
622,1,802,295,1097,2.7186440677966104
622,2,1110,422,1532,2.6303317535545023
622,3,1549,280,1829,5.5321428571428575
622,4,1916,731,2647,2.621067031463748
622,5,2699,956,3655,2.823221757322176
622,6,3663,651,4314,5.626728110599078
622,7,4328,618,4946,7.003236245954692
622,8,4953,594,5547,8.33838383838384
622,9,5591,934,6525,5.9860813704496785
622,10,6529,1012,7541,6.451581027667984
623,1,539,420,959,1.2833333333333334
623,2,989,200,1189,4.945
623,3,1224,259,1483,4.725868725868726
623,4,1502,236,1738,6.364406779661017
623,5,1784,201,1985,8.875621890547263
623,6,2035,190,2225,10.710526315789474
623,7,2247,302,2549,7.440397350993377
624,1,591,736,1327,0.8029891304347826
625,1,26,408,434,0.06372549019607843
626,1,43,507,550,0.08481262327416174
626,2,574,529,1103,1.0850661625708884
626,3,1122,488,1610,2.2991803278688523
626,4,1645,871,2516,1.8886337543053962
626,5,2526,754,3280,3.350132625994695
626,6,3297,690,3987,4.778260869565218
626,7,4004,587,4591,6.821124361158433
626,8,4608,775,5383,5.945806451612904
626,9,5400,909,6309,5.9405940594059405
626,10,6326,515,6841,12.283495145631068
626,11,6847,606,7453,11.298679867986799
627,1,6,698,704,0.008595988538681949
628,1,325,952,1277,0.34138655462184875
628,2,1402,284,1686,4.936619718309859
629,1,33,388,421,0.08505154639175258
629,2,455,971,1426,0.4685890834191555
630,1,148,471,619,0.31422505307855625
631,1,21,399,420,0.05263157894736842
631,2,480,307,787,1.5635179153094463
632,1,777,16,793,48.5625
632,2,977,298,1275,3.278523489932886
633,1,9,269,278,0.03345724907063197
633,2,289,278,567,1.039568345323741
634,1,35,2353,2388,0.014874628134296642
634,2,2442,2676,5118,0.9125560538116592
635,1,34,603,637,0.05638474295190713
635,2,716,569,1285,1.258347978910369
635,3,1384,528,1912,2.621212121212121
635,4,1948,441,2389,4.417233560090703
635,5,2414,445,2859,5.424719101123595
635,6,2899,451,3350,6.427937915742794
635,7,3429,568,3997,6.036971830985915
635,8,4014,344,4358,11.668604651162791
635,9,4398,392,4790,11.21938775510204
635,10,4812,477,5289,10.08805031446541
635,11,5345,432,5777,12.372685185185185
635,12,5808,333,6141,17.44144144144144
635,13,6168,392,6560,15.73469387755102
635,14,6629,357,6986,18.568627450980394
635,15,7009,361,7370,19.41551246537396
635,16,7430,373,7803,19.919571045576408
636,1,6326,1051,7377,6.019029495718364
636,2,7398,587,7985,12.603066439522998
637,1,32,747,779,0.0428380187416332
638,1,301,409,710,0.7359413202933985
638,2,712,391,1103,1.8209718670076727
638,3,1105,246,1351,4.491869918699187
638,4,1926,388,2314,4.963917525773196
638,5,2693,321,3014,8.389408099688474
638,6,3041,400,3441,7.6025
638,7,4216,374,4590,11.272727272727273
638,8,4615,256,4871,18.02734375
638,9,5711,362,6073,15.776243093922652
638,10,6075,361,6436,16.82825484764543
638,11,6438,294,6732,21.897959183673468
639,1,97,681,778,0.14243759177679882
639,2,802,368,1170,2.1793478260869565
640,1,1680,763,2443,2.2018348623853212
640,2,2470,768,3238,3.2161458333333335
641,1,188,88,276,2.1363636363636362
641,2,2613,567,3180,4.608465608465608
641,3,3182,621,3803,5.123993558776167
641,4,3841,687,4528,5.590975254730713
641,5,4622,84,4706,55.023809523809526
641,6,6573,841,7414,7.815695600475625
641,7,7416,273,7689,27.164835164835164
641,8,7722,127,7849,60.803149606299215
642,1,457,32,489,14.28125
642,2,491,182,673,2.697802197802198
642,3,698,369,1067,1.89159891598916
642,4,1077,254,1331,4.24015748031496
642,5,1349,309,1658,4.365695792880259
642,6,1666,227,1893,7.3392070484581495
642,7,1896,301,2197,6.299003322259137
642,8,2213,258,2471,8.577519379844961
643,1,301,629,930,0.4785373608903021
643,2,1045,531,1576,1.9679849340866291
643,3,1656,396,2052,4.181818181818182
643,4,2069,280,2349,7.389285714285714
643,5,2369,467,2836,5.072805139186295
643,6,2863,353,3216,8.110481586402265
643,7,3317,536,3853,6.188432835820896
643,8,3893,501,4394,7.770459081836328
643,9,4505,165,4670,27.303030303030305
643,10,4724,238,4962,19.84873949579832
643,11,4980,611,5591,8.150572831423895
643,12,5602,263,5865,21.30038022813688
643,13,5918,295,6213,20.061016949152542
643,14,6231,416,6647,14.978365384615385
643,15,6692,304,6996,22.013157894736842
643,16,7024,567,7591,12.388007054673722
644,1,109,1018,1127,0.10707269155206287
644,2,1162,641,1803,1.812792511700468
644,3,1838,449,2287,4.093541202672606
644,4,2310,508,2818,4.547244094488189
644,5,2843,526,3369,5.404942965779468
644,6,3392,12,3404,282.6666666666667
644,7,3417,15,3432,227.8
644,8,3443,304,3747,11.325657894736842
644,9,3763,377,4140,9.981432360742705
644,10,4159,566,4725,7.348056537102473
644,11,4752,929,5681,5.115177610333692
644,12,5714,510,6224,11.20392156862745
644,13,6234,543,6777,11.480662983425415
644,14,6796,317,7113,21.438485804416406
644,15,7135,354,7489,20.15536723163842
644,16,7504,517,8021,14.51450676982592
645,1,41,737,778,0.05563093622795115
646,1,26,298,324,0.087248322147651
646,2,340,116,456,2.9310344827586206
646,3,476,116,592,4.103448275862069
646,4,605,234,839,2.5854700854700856
646,5,857,194,1051,4.417525773195877
646,6,1062,302,1364,3.5165562913907285
646,7,1373,376,1749,3.651595744680851
646,8,1769,419,2188,4.221957040572792
646,9,2201,543,2744,4.05340699815838
646,10,2768,462,3230,5.991341991341991
646,11,3241,30,3271,108.03333333333333
646,12,3286,135,3421,24.340740740740742
646,13,3435,136,3571,25.25735294117647
646,14,3588,155,3743,23.148387096774194
646,15,3760,88,3848,42.72727272727273
647,1,85,60,145,1.4166666666666667
647,2,154,90,244,1.711111111111111
648,1,126,410,536,0.3073170731707317
648,2,553,347,900,1.5936599423631124
648,3,1099,698,1797,1.5744985673352436
648,4,1833,92,1925,19.92391304347826
648,5,1950,110,2060,17.727272727272727
649,1,180,37,217,4.864864864864865
649,2,227,90,317,2.522222222222222
649,3,354,56,410,6.321428571428571
649,4,436,86,522,5.069767441860465
649,5,584,83,667,7.036144578313253
649,6,723,90,813,8.033333333333333
649,7,840,83,923,10.120481927710843
649,8,964,133,1097,7.2481203007518795
649,9,1115,162,1277,6.882716049382716
650,1,596,1063,1659,0.5606773283160865
651,1,262,61,323,4.295081967213115
651,2,327,20,347,16.35
651,3,350,21,371,16.666666666666668
651,4,377,18,395,20.944444444444443
651,5,401,19,420,21.105263157894736
651,6,425,21,446,20.238095238095237
651,7,453,89,542,5.089887640449438
651,8,551,47,598,11.72340425531915
651,9,610,39,649,15.64102564102564
651,10,655,81,736,8.08641975308642
651,11,752,29,781,25.93103448275862
651,12,802,28,830,28.642857142857142
652,1,131,230,361,0.5695652173913044
652,2,807,264,1071,3.0568181818181817
652,3,1085,568,1653,1.9102112676056338
652,4,1668,355,2023,4.698591549295775
652,5,2043,3,2046,681.0
653,1,41,939,980,0.043663471778487756
653,2,997,391,1388,2.549872122762148
654,1,1230,468,1698,2.628205128205128
655,1,1636,626,2262,2.6134185303514377
655,2,2285,461,2746,4.956616052060737
655,3,2757,519,3276,5.312138728323699
656,1,417,189,606,2.2063492063492065
656,2,761,388,1149,1.961340206185567
656,3,1324,386,1710,3.430051813471503
656,4,1749,950,2699,1.8410526315789473
656,5,2701,156,2857,17.314102564102566
657,1,398,28,426,14.214285714285714
657,2,884,363,1247,2.435261707988981
657,3,1295,344,1639,3.76453488372093
657,4,1649,397,2046,4.153652392947103
657,5,2080,534,2614,3.8951310861423223
657,6,2652,546,3198,4.857142857142857
657,7,3229,489,3718,6.603271983640082
657,8,3749,108,3857,34.71296296296296
657,9,4182,417,4599,10.028776978417266
657,10,4623,392,5015,11.793367346938776
657,11,5043,340,5383,14.83235294117647
657,12,5447,414,5861,13.157004830917874
657,13,5870,372,6242,15.779569892473118
657,14,6772,680,7452,9.958823529411765
657,15,7488,591,8079,12.67005076142132
658,1,70,491,561,0.1425661914460285
658,2,579,262,841,2.2099236641221376
658,3,879,284,1163,3.0950704225352115
658,4,1191,367,1558,3.2452316076294276
658,5,1672,440,2112,3.8
659,1,12,460,472,0.02608695652173913
659,2,494,455,949,1.0857142857142856
659,3,964,290,1254,3.3241379310344827
659,4,1265,407,1672,3.108108108108108
660,1,378,945,1323,0.4
660,2,1339,912,2251,1.468201754385965
660,3,2267,714,2981,3.1750700280112043
661,1,1496,763,2259,1.9606815203145478
661,2,2338,913,3251,2.56078860898138
662,1,767,178,945,4.308988764044944
662,2,1112,345,1457,3.2231884057971016
662,3,2144,199,2343,10.773869346733669
662,4,2432,748,3180,3.251336898395722
662,5,3216,643,3859,5.001555209953343
662,6,3912,22,3934,177.8181818181818
662,7,6109,188,6297,32.494680851063826
662,8,6803,461,7264,14.757049891540131
662,9,7282,574,7856,12.686411149825783
663,1,13,332,345,0.0391566265060241
664,1,31,148,179,0.20945945945945946
664,2,228,461,689,0.4945770065075922
665,1,254,1154,1408,0.22010398613518198
665,2,1438,1289,2727,1.1155934833204033
665,3,2740,803,3543,3.412204234122042
665,4,3672,964,4636,3.809128630705394
665,5,4781,885,5666,5.402259887005649
665,6,5697,915,6612,6.226229508196721
666,1,83,625,708,0.1328
667,1,86,283,369,0.303886925795053
667,2,384,598,982,0.6421404682274248
667,3,994,999,1993,0.994994994994995
667,4,2018,733,2751,2.753069577080491
668,1,26,432,458,0.06018518518518518
668,2,472,430,902,1.0976744186046512
668,3,915,411,1326,2.2262773722627736
668,4,1329,390,1719,3.4076923076923076
669,1,718,328,1046,2.1890243902439024
670,1,34,418,452,0.08133971291866028
671,1,33,445,478,0.07415730337078652
671,2,497,537,1034,0.925512104283054
671,3,1052,473,1525,2.2241014799154333
671,4,1549,576,2125,2.689236111111111
671,5,2145,341,2486,6.290322580645161
671,6,2524,533,3057,4.735459662288931
671,7,3075,1013,4088,3.035538005923001
672,1,337,824,1161,0.40898058252427183
672,2,1165,264,1429,4.412878787878788
673,1,46,534,580,0.08614232209737828
673,2,602,434,1036,1.3870967741935485
674,1,926,836,1762,1.1076555023923444
674,2,1770,567,2337,3.121693121693122
675,1,46,263,309,0.17490494296577946
675,2,1840,989,2829,1.8604651162790697
675,3,2843,961,3804,2.9583766909469302
675,4,3818,371,4189,10.2911051212938
675,5,4246,876,5122,4.84703196347032
675,6,5134,657,5791,7.814307458143075
675,7,5848,541,6389,10.809611829944547
675,8,6427,631,7058,10.185419968304279
676,1,23,791,814,0.029077117572692796
676,2,865,326,1191,2.6533742331288344
676,3,1217,384,1601,3.1692708333333335
676,4,1956,417,2373,4.690647482014389
676,5,2469,126,2595,19.595238095238095
676,6,2828,969,3797,2.918472652218782
676,7,4065,448,4513,9.073660714285714
676,8,4529,147,4676,30.80952380952381
676,9,4754,303,5057,15.689768976897689
676,10,5535,427,5962,12.962529274004684
676,11,6868,550,7418,12.487272727272726
677,1,11,163,174,0.06748466257668712
677,2,185,128,313,1.4453125
677,3,341,994,1335,0.34305835010060365
677,4,1356,224,1580,6.053571428571429
678,1,15,448,463,0.033482142857142856
678,2,474,396,870,1.196969696969697
678,3,885,591,1476,1.49746192893401
678,4,1489,706,2195,2.1090651558073654
679,1,26,684,710,0.038011695906432746
679,2,719,715,1434,1.0055944055944055
680,1,51,188,239,0.2712765957446808
680,2,248,18,266,13.777777777777779
680,3,277,112,389,2.4732142857142856
680,4,469,631,1100,0.7432646592709984
680,5,1115,29,1144,38.44827586206897
680,6,1148,17,1165,67.52941176470588
680,7,1191,23,1214,51.78260869565217
680,8,1223,111,1334,11.018018018018019
681,1,61,352,413,0.17329545454545456
681,2,415,293,708,1.416382252559727
682,1,19,503,522,0.03777335984095427
683,1,13,586,599,0.02218430034129693
683,2,611,581,1192,1.0516351118760758
683,3,1197,440,1637,2.7204545454545452
684,1,36,660,696,0.05454545454545454
684,2,730,443,1173,1.6478555304740405
684,3,1213,741,1954,1.6369770580296896
684,4,2021,583,2604,3.4665523156089195
684,5,2632,244,2876,10.78688524590164
684,6,2892,219,3111,13.205479452054794
684,7,3122,291,3413,10.728522336769759
684,8,3417,28,3445,122.03571428571429
684,9,3470,128,3598,27.109375
684,10,3611,144,3755,25.07638888888889
684,11,3802,369,4171,10.303523035230352
684,12,4206,474,4680,8.873417721518987
685,1,14,485,499,0.0288659793814433
686,1,293,363,656,0.8071625344352618
686,2,658,411,1069,1.6009732360097324
686,3,1071,202,1273,5.301980198019802
686,4,2478,396,2874,6.257575757575758
686,5,2876,440,3316,6.536363636363636
686,6,3323,397,3720,8.370277078085643
686,7,3727,443,4170,8.413092550790068
686,8,4177,116,4293,36.008620689655174
686,9,4308,402,4710,10.716417910447761
687,1,275,484,759,0.5681818181818182
688,1,74,244,318,0.30327868852459017
688,2,363,71,434,5.112676056338028
688,3,496,1157,1653,0.428694900605013
688,4,1680,778,2458,2.159383033419023
688,5,2510,102,2612,24.607843137254903
688,6,2689,175,2864,15.365714285714287
688,7,2941,1158,4099,2.5397236614853194
688,8,4109,134,4243,30.66417910447761
688,9,4298,80,4378,53.725
688,10,4866,399,5265,12.19548872180451
688,11,5336,155,5491,34.42580645161291
688,12,5518,288,5806,19.15972222222222
688,13,5861,847,6708,6.919716646989374
689,1,11,575,586,0.019130434782608695
690,1,85,83,168,1.0240963855421688
690,2,176,92,268,1.9130434782608696
690,3,277,121,398,2.2892561983471076
690,4,406,97,503,4.185567010309279
690,5,664,176,840,3.772727272727273
690,6,859,505,1364,1.700990099009901
690,7,1511,245,1756,6.16734693877551
690,8,1818,628,2446,2.894904458598726
690,9,2525,584,3109,4.323630136986301
690,10,3258,614,3872,5.306188925081433
690,11,3963,902,4865,4.393569844789357
690,12,5054,15,5069,336.93333333333334
690,13,5195,13,5208,399.61538461538464
690,14,5380,23,5403,233.91304347826087
690,15,5483,6,5489,913.8333333333334
690,16,5592,13,5605,430.15384615384613
690,17,5706,247,5953,23.101214574898787
690,18,6135,8,6143,766.875
690,19,6323,7,6330,903.2857142857143
690,20,6546,12,6558,545.5
691,1,153,98,251,1.5612244897959184
691,2,308,496,804,0.6209677419354839
691,3,873,223,1096,3.914798206278027
691,4,1189,255,1444,4.662745098039216
691,5,1477,537,2014,2.750465549348231
691,6,2118,573,2691,3.696335078534031
692,1,52,867,919,0.05997693194925029
692,2,951,843,1794,1.1281138790035588
692,3,1815,37,1852,49.054054054054056
692,4,2038,848,2886,2.4033018867924527
692,5,2892,390,3282,7.415384615384616
692,6,3348,709,4057,4.722143864598025
692,7,5152,852,6004,6.046948356807512
692,8,6013,399,6412,15.070175438596491
693,1,28,891,919,0.031425364758698095
694,1,32,329,361,0.0972644376899696
695,1,34,921,955,0.03691639522258415
695,2,958,560,1518,1.7107142857142856
695,3,1541,977,2518,1.5772773797338793
695,4,2521,617,3138,4.085899513776337
695,5,3253,898,4151,3.6224944320712695
695,6,4154,247,4401,16.817813765182187
695,7,4459,928,5387,4.804956896551724
695,8,5390,580,5970,9.293103448275861
695,9,6007,912,6919,6.586622807017544
695,10,6922,433,7355,15.986143187066975
696,1,29,818,847,0.035452322738386305
696,2,865,870,1735,0.9942528735632183
697,1,26,432,458,0.06018518518518518
697,2,472,430,902,1.0976744186046512
697,3,915,411,1326,2.2262773722627736
697,4,1329,390,1719,3.4076923076923076
698,1,12,670,682,0.01791044776119403
698,2,694,733,1427,0.946793997271487
698,3,1435,1037,2472,1.3837994214079075
698,4,2482,1042,3524,2.381957773512476
698,5,3531,1039,4570,3.3984600577478346
698,6,4581,1032,5613,4.438953488372093
698,7,5624,1036,6660,5.428571428571429
698,8,6692,1045,7737,6.4038277511961725
698,9,7757,326,8083,23.79447852760736
699,1,40,673,713,0.05943536404160475
700,1,46,288,334,0.1597222222222222
700,2,359,472,831,0.760593220338983
700,3,849,596,1445,1.424496644295302
701,1,59,511,570,0.11545988258317025
701,2,590,358,948,1.6480446927374302
701,3,964,448,1412,2.1517857142857144
701,4,1487,385,1872,3.862337662337662
701,5,1886,374,2260,5.042780748663102
701,6,2300,520,2820,4.423076923076923
701,7,2912,322,3234,9.043478260869565
701,8,3249,166,3415,19.572289156626507
701,9,3433,368,3801,9.328804347826088
701,10,3845,256,4101,15.01953125
701,11,4147,1000,5147,4.147
701,12,5260,63,5323,83.4920634920635
701,13,5353,510,5863,10.496078431372549
701,14,5893,622,6515,9.47427652733119
701,15,6559,524,7083,12.517175572519085
701,16,7140,698,7838,10.229226361031518
702,1,57,119,176,0.4789915966386555
703,1,17,616,633,0.027597402597402596
703,2,641,953,1594,0.6726128016789087
703,3,1608,933,2541,1.7234726688102895
703,4,2546,875,3421,2.9097142857142857
703,5,3434,985,4419,3.4862944162436547
703,6,4421,446,4867,9.91255605381166
703,7,4883,936,5819,5.2168803418803416
703,8,5826,866,6692,6.727482678983834
704,1,39,418,457,0.09330143540669857
704,2,473,449,922,1.0534521158129175
704,3,1949,973,2922,2.0030832476875644
705,1,293,203,496,1.4433497536945812
705,2,1569,264,1833,5.943181818181818
705,3,1861,299,2160,6.224080267558528
705,4,2371,238,2609,9.96218487394958
705,5,2851,254,3105,11.224409448818898
705,6,3457,364,3821,9.497252747252746
705,7,3933,406,4339,9.687192118226601
705,8,4630,336,4966,13.779761904761905
705,9,5240,888,6128,5.900900900900901
705,10,6592,605,7197,10.895867768595041
706,1,45,708,753,0.0635593220338983
707,1,420,325,745,1.2923076923076924
707,2,750,328,1078,2.2865853658536586
707,3,1082,311,1393,3.4790996784565915
707,4,1397,299,1696,4.672240802675585
707,5,1700,324,2024,5.246913580246914
707,6,2028,312,2340,6.5
707,7,2345,311,2656,7.540192926045016
707,8,2660,302,2962,8.80794701986755
707,9,2966,292,3258,10.157534246575343
707,10,3262,316,3578,10.322784810126583
707,11,3582,327,3909,10.954128440366972
707,12,3913,138,4051,28.355072463768117
707,13,4104,329,4433,12.474164133738602
707,14,4437,327,4764,13.568807339449542
707,15,4768,294,5062,16.217687074829932
707,16,5073,300,5373,16.91
707,17,5377,311,5688,17.289389067524116
707,18,5692,262,5954,21.72519083969466
707,19,6050,343,6393,17.638483965014576
707,20,6397,301,6698,21.25249169435216
707,21,6702,338,7040,19.828402366863905
707,22,7044,333,7377,21.153153153153152
707,23,7381,352,7733,20.96875
708,1,25,94,119,0.26595744680851063
708,2,133,44,177,3.022727272727273
708,3,183,30,213,6.1
708,4,222,53,275,4.188679245283019
708,5,308,103,411,2.9902912621359223
709,1,52,543,595,0.09576427255985268
709,2,627,527,1154,1.189753320683112
710,1,147,69,216,2.130434782608696
710,2,259,84,343,3.0833333333333335
710,3,358,87,445,4.114942528735632
710,4,505,284,789,1.778169014084507
710,5,979,313,1292,3.1277955271565494
710,6,1459,256,1715,5.69921875
711,1,1173,622,1795,1.8858520900321543
711,2,1860,513,2373,3.625730994152047
711,3,2400,604,3004,3.9735099337748343
711,4,3032,615,3647,4.930081300813008
711,5,3665,605,4270,6.0578512396694215
711,6,4299,537,4836,8.005586592178771
712,1,2849,620,3469,4.59516129032258
712,2,3496,968,4464,3.6115702479338845
712,3,4466,239,4705,18.686192468619247
712,4,4724,981,5705,4.815494393476045
712,5,5715,727,6442,7.8610729023383765
713,1,99,549,648,0.18032786885245902
713,2,683,645,1328,1.0589147286821705
713,3,1347,488,1835,2.7602459016393444
713,4,1853,453,2306,4.0905077262693155
713,5,2344,371,2715,6.318059299191375
714,1,70,566,636,0.12367491166077739
714,2,676,618,1294,1.0938511326860842
714,3,1321,359,1680,3.67966573816156
714,4,1740,846,2586,2.0567375886524824
715,1,43,92,135,0.4673913043478261
715,2,182,66,248,2.757575757575758
716,1,61,769,830,0.07932379713914174
717,1,49,373,422,0.13136729222520108
717,2,430,368,798,1.1684782608695652
717,3,806,337,1143,2.391691394658754
717,4,1150,284,1434,4.049295774647887
718,1,16,475,491,0.03368421052631579
719,1,2533,347,2880,7.29971181556196
719,2,2932,548,3480,5.350364963503649
719,3,3515,585,4100,6.0085470085470085
719,4,4120,430,4550,9.581395348837209
720,1,1478,292,1770,5.061643835616438
720,2,1779,341,2120,5.217008797653959
720,3,2411,788,3199,3.0596446700507616
720,4,3233,872,4105,3.7075688073394497
720,5,4160,796,4956,5.226130653266332
720,6,4968,907,5875,5.477398015435502
720,7,5887,972,6859,6.056584362139918
720,8,6885,1003,7888,6.864406779661017
721,1,59,729,788,0.08093278463648834
722,1,1448,347,1795,4.172910662824208
722,2,1799,389,2188,4.624678663239075
722,3,2192,312,2504,7.0256410256410255
722,4,2551,188,2739,13.569148936170214
722,5,2764,377,3141,7.3315649867374
722,6,3154,141,3295,22.368794326241133
722,7,3400,290,3690,11.724137931034482
722,8,3859,217,4076,17.783410138248847
722,9,4144,389,4533,10.652956298200515
722,10,4544,342,4886,13.286549707602338
722,11,4891,217,5108,22.53917050691244
722,12,5173,334,5507,15.488023952095809
722,13,5628,337,5965,16.700296735905045
722,14,5970,271,6241,22.029520295202953
722,15,6303,321,6624,19.635514018691588
722,16,6629,397,7026,16.697732997481108
723,1,12,255,267,0.047058823529411764
723,2,301,413,714,0.7288135593220338
724,1,2849,620,3469,4.59516129032258
724,2,3496,968,4464,3.6115702479338845
724,3,4466,239,4705,18.686192468619247
725,1,117,1019,1136,0.11481844946025516
725,2,1271,730,2001,1.7410958904109588
725,3,2217,885,3102,2.5050847457627117
726,1,1333,781,2114,1.706786171574904
726,2,2154,642,2796,3.3551401869158877
726,3,3051,897,3948,3.4013377926421406
726,4,4167,561,4728,7.427807486631016
726,5,4912,601,5513,8.173044925124792
727,1,14,364,378,0.038461538461538464
727,2,380,228,608,1.6666666666666667
727,3,610,24,634,25.416666666666668
728,1,119,536,655,0.22201492537313433
728,2,675,525,1200,1.2857142857142858
728,3,1303,608,1911,2.143092105263158
728,4,1921,606,2527,3.16996699669967
729,1,51,819,870,0.06227106227106227
729,2,875,652,1527,1.3420245398773005
729,3,1585,805,2390,1.968944099378882
729,4,2395,731,3126,3.2763337893296853
729,5,3164,111,3275,28.504504504504503
729,6,3317,727,4044,4.562585969738652
729,7,4107,495,4602,8.296969696969697
729,8,4626,537,5163,8.614525139664805
729,9,5183,390,5573,13.28974358974359
729,10,5601,378,5979,14.817460317460318
729,11,6001,760,6761,7.896052631578947
730,1,152,503,655,0.30218687872763417
730,2,840,378,1218,2.2222222222222223
730,3,1310,6,1316,218.33333333333334
731,1,35,312,347,0.11217948717948718
732,1,21,411,432,0.051094890510948905
732,2,513,462,975,1.1103896103896105
733,1,15,780,795,0.019230769230769232
734,1,437,545,982,0.8018348623853211
734,2,998,548,1546,1.8211678832116789
734,3,1562,599,2161,2.6076794657762936
734,4,2177,498,2675,4.371485943775101
734,5,2693,499,3192,5.396793587174349
734,6,3208,624,3832,5.141025641025641
734,7,3850,590,4440,6.52542372881356
734,8,4454,578,5032,7.705882352941177
735,1,476,877,1353,0.5427594070695553
735,2,1404,545,1949,2.5761467889908256
735,3,2358,907,3265,2.599779492833517
735,4,3582,688,4270,5.2063953488372094
735,5,4715,851,5566,5.54054054054054
735,6,5840,878,6718,6.651480637813211
735,7,6724,200,6924,33.62
736,1,970,490,1460,1.9795918367346939
736,2,1474,671,2145,2.19672131147541
736,3,4795,560,5355,8.5625
737,1,129,764,893,0.168848167539267
738,1,75,1095,1170,0.0684931506849315
738,2,1192,418,1610,2.851674641148325
738,3,1652,485,2137,3.406185567010309
738,4,2230,703,2933,3.1721194879089616
738,5,2953,1046,3999,2.823135755258126
738,6,4046,1021,5067,3.962781586679726
738,7,5088,1000,6088,5.088
738,8,6118,1019,7137,6.003925417075564
739,1,61,47,108,1.297872340425532
739,2,875,23,898,38.04347826086956
739,3,2017,14,2031,144.07142857142858
739,4,2038,23,2061,88.6086956521739
739,5,3746,5,3751,749.2
739,6,3758,3,3761,1252.6666666666667
739,7,4761,10,4771,476.1
739,8,4784,97,4881,49.31958762886598
739,9,5366,3,5369,1788.6666666666667
740,1,2,211,213,0.009478672985781991
740,2,216,97,313,2.2268041237113403
740,3,316,123,439,2.569105691056911
740,4,442,90,532,4.911111111111111
740,5,535,92,627,5.815217391304348
740,6,630,147,777,4.285714285714286
740,7,780,113,893,6.902654867256637
740,8,896,77,973,11.636363636363637
740,9,976,93,1069,10.494623655913978
740,10,1072,87,1159,12.32183908045977
740,11,1162,127,1289,9.149606299212598
740,12,1292,55,1347,23.490909090909092
741,1,19,317,336,0.05993690851735016
741,2,357,231,588,1.5454545454545454
741,3,639,278,917,2.2985611510791366
741,4,930,239,1169,3.8912133891213387
741,5,1210,238,1448,5.084033613445378
741,6,1484,303,1787,4.897689768976898
741,7,1840,405,2245,4.54320987654321
741,8,2363,430,2793,5.495348837209303
741,9,2825,365,3190,7.739726027397261
741,10,3289,297,3586,11.074074074074074
741,11,3607,386,3993,9.344559585492227
741,12,4097,364,4461,11.255494505494505
741,13,4497,306,4803,14.696078431372548
741,14,5008,471,5479,10.632696390658174
741,15,5716,325,6041,17.587692307692308
741,16,6139,349,6488,17.59025787965616
741,17,6518,217,6735,30.036866359447004
742,1,508,721,1229,0.7045769764216366
743,1,8,363,371,0.02203856749311295
743,2,380,376,756,1.0106382978723405
743,3,759,362,1121,2.096685082872928
744,1,552,316,868,1.7468354430379747
745,1,56,74,130,0.7567567567567568
745,2,146,57,203,2.56140350877193
745,3,2845,737,3582,3.8602442333785616
745,4,5239,400,5639,13.0975
745,5,6960,297,7257,23.434343434343436
745,6,7315,735,8050,9.952380952380953
746,1,71,493,564,0.1440162271805274
746,2,586,544,1130,1.0772058823529411
747,1,12,508,520,0.023622047244094488
747,2,549,85,634,6.458823529411765
747,3,1157,941,2098,1.2295430393198725
747,4,2120,975,3095,2.174358974358974
747,5,3101,813,3914,3.814268142681427
747,6,3973,317,4290,12.533123028391167
747,7,4305,294,4599,14.642857142857142
747,8,4613,327,4940,14.107033639143731
747,9,4951,1007,5958,4.916583912611718
747,10,5974,389,6363,15.3573264781491
747,11,6369,579,6948,11.0
747,12,6972,542,7514,12.863468634686347
747,13,7555,104,7659,72.64423076923077
747,14,7683,274,7957,28.04014598540146
747,15,7968,114,8082,69.89473684210526
748,1,524,392,916,1.336734693877551
748,2,938,225,1163,4.168888888888889
748,3,1177,359,1536,3.278551532033426
748,4,1552,434,1986,3.576036866359447
749,1,93,359,452,0.2590529247910863
750,1,33,964,997,0.03423236514522822
750,2,1021,168,1189,6.0773809523809526
750,3,1205,283,1488,4.257950530035336
750,4,1496,175,1671,8.548571428571428
751,1,148,544,692,0.27205882352941174
752,1,723,983,1706,0.7355035605289929
752,2,1993,868,2861,2.296082949308756
752,3,3638,852,4490,4.269953051643192
752,4,4895,926,5821,5.286177105831533
752,5,5956,916,6872,6.502183406113537
752,6,7002,1070,8072,6.54392523364486
753,1,48,1856,1904,0.02586206896551724
753,2,1988,1633,3621,1.2173913043478262
753,3,4656,54,4710,86.22222222222223
753,4,5955,2039,7994,2.920549288867092
754,1,1230,958,2188,1.2839248434237995
754,2,2191,951,3142,2.3038906414300735
754,3,3144,10,3154,314.4
755,1,131,399,530,0.3283208020050125
755,2,770,353,1123,2.181303116147309
755,3,1184,803,1987,1.4744707347447072
755,4,2085,978,3063,2.1319018404907975
755,5,3110,883,3993,3.522083805209513
755,6,4026,994,5020,4.050301810865191
756,1,86,987,1073,0.08713272543059777
756,2,1078,528,1606,2.0416666666666665
756,3,1746,368,2114,4.744565217391305
756,4,2137,585,2722,3.652991452991453
756,5,2800,560,3360,5.0
756,6,3403,655,4058,5.195419847328244
756,7,4081,883,4964,4.621744054360136
756,8,5061,533,5594,9.4953095684803
756,9,5620,579,6199,9.706390328151986
756,10,6214,282,6496,22.0354609929078
756,11,6536,454,6990,14.396475770925111
756,12,7008,469,7477,14.942430703624733
756,13,7504,588,8092,12.761904761904763
757,1,727,203,930,3.58128078817734
758,1,25,241,266,0.1037344398340249
758,2,281,452,733,0.6216814159292036
758,3,749,273,1022,2.7435897435897436
758,4,1039,234,1273,4.44017094017094
758,5,1286,233,1519,5.51931330472103
758,6,1538,231,1769,6.658008658008658
758,7,1812,435,2247,4.165517241379311
758,8,2303,219,2522,10.515981735159817
759,1,10,829,839,0.012062726176115802
759,2,876,676,1552,1.2958579881656804
759,3,1560,980,2540,1.5918367346938775
759,4,2632,343,2975,7.673469387755102
759,5,3011,541,3552,5.565619223659889
759,6,3569,982,4551,3.634419551934827
759,7,4560,614,5174,7.4267100977198695
759,8,5205,959,6164,5.427528675703858
759,9,6189,831,7020,7.447653429602888
759,10,7040,809,7849,8.702101359703338
760,1,495,569,1064,0.8699472759226714
760,2,1100,481,1581,2.286902286902287
761,1,44,677,721,0.06499261447562776
761,2,736,794,1530,0.9269521410579346
761,3,1585,725,2310,2.1862068965517243
761,4,2326,752,3078,3.0930851063829787
761,5,3092,690,3782,4.481159420289855
761,6,3793,605,4398,6.269421487603306
761,7,4405,774,5179,5.691214470284238
761,8,5191,650,5841,7.986153846153846
762,1,10,262,272,0.03816793893129771
762,2,282,290,572,0.9724137931034482
762,3,578,456,1034,1.2675438596491229
763,1,10,459,469,0.02178649237472767
764,1,83,384,467,0.21614583333333334
765,1,166,465,631,0.35698924731182796
765,2,636,469,1105,1.3560767590618337
765,3,1107,461,1568,2.401301518438178
765,4,1571,461,2032,3.407809110629067
765,5,2038,483,2521,4.219461697722568
765,6,2525,480,3005,5.260416666666667
765,7,3008,491,3499,6.126272912423625
765,8,3501,468,3969,7.480769230769231
765,9,3972,454,4426,8.748898678414097
765,10,4430,473,4903,9.365750528541227
765,11,4905,466,5371,10.525751072961373
765,12,5385,488,5873,11.03483606557377
765,13,5876,470,6346,12.502127659574468
765,14,6359,458,6817,13.884279475982533
765,15,6825,92,6917,74.18478260869566
765,16,6941,276,7217,25.14855072463768
766,1,102,1022,1124,0.09980430528375733
766,2,1658,1030,2688,1.6097087378640778
767,1,13,370,383,0.03513513513513514
768,1,207,11,218,18.818181818181817
768,2,281,108,389,2.6018518518518516
768,3,450,160,610,2.8125
768,4,643,201,844,3.199004975124378
768,5,866,225,1091,3.848888888888889
768,6,1127,244,1371,4.618852459016393
768,7,1384,940,2324,1.4723404255319148
768,8,2327,495,2822,4.701010101010101
768,9,2863,789,3652,3.628643852978454
768,10,3704,599,4303,6.183639398998331
769,1,79,564,643,0.1400709219858156
769,2,665,574,1239,1.1585365853658536
769,3,1244,424,1668,2.9339622641509435
769,4,1687,405,2092,4.165432098765432
769,5,2117,61,2178,34.704918032786885
770,1,285,380,665,0.75
770,2,719,391,1110,1.8388746803069054
770,3,1131,925,2056,1.2227027027027026
770,4,2081,952,3033,2.185924369747899
770,5,3079,952,4031,3.2342436974789917
770,6,4033,170,4203,23.723529411764705
770,7,4240,959,5199,4.421272158498436
770,8,5201,163,5364,31.9079754601227
771,1,79,52,131,1.5192307692307692
771,2,566,109,675,5.192660550458716
771,3,1443,131,1574,11.01526717557252
771,4,2078,398,2476,5.221105527638191
771,5,2502,58,2560,43.13793103448276
771,6,3495,263,3758,13.288973384030419
771,7,5614,246,5860,22.821138211382113
771,8,5882,13,5895,452.46153846153845
771,9,5997,258,6255,23.24418604651163
771,10,6283,271,6554,23.18450184501845
771,11,6566,284,6850,23.119718309859156
771,12,6863,284,7147,24.16549295774648
772,1,1618,958,2576,1.6889352818371608
773,1,591,736,1327,0.8029891304347826
774,1,37,664,701,0.05572289156626506
774,2,713,552,1265,1.2916666666666667
774,3,1278,574,1852,2.226480836236934
774,4,1907,657,2564,2.902587519025875
774,5,2760,613,3373,4.502446982055465
774,6,3441,717,4158,4.799163179916318
774,7,7271,721,7992,10.084604715672677
775,1,168,864,1032,0.19444444444444445
775,2,1039,218,1257,4.76605504587156
776,1,19,782,801,0.024296675191815855
776,2,812,423,1235,1.9196217494089836
776,3,1344,564,1908,2.382978723404255
776,4,2066,501,2567,4.12375249500998
776,5,2588,531,3119,4.873822975517891
776,6,3131,238,3369,13.155462184873949
776,7,3377,396,3773,8.527777777777779
776,8,3851,779,4630,4.943517329910141
776,9,4639,465,5104,9.976344086021506
776,10,5116,338,5454,15.136094674556213
776,11,5463,410,5873,13.324390243902439
776,12,5880,101,5981,58.21782178217822
777,1,400,960,1360,0.4166666666666667
777,2,1397,700,2097,1.9957142857142858
777,3,2137,381,2518,5.608923884514436
777,4,2572,364,2936,7.065934065934066
777,5,3008,374,3382,8.042780748663102
777,6,3393,453,3846,7.490066225165563
778,1,19,27,46,0.7037037037037037
778,2,48,29,77,1.6551724137931034
778,3,81,209,290,0.3875598086124402
778,4,303,220,523,1.3772727272727272
778,5,532,341,873,1.5601173020527859
778,6,879,62,941,14.17741935483871
778,7,969,407,1376,2.380835380835381
778,8,1393,407,1800,3.4226044226044228
778,9,1820,100,1920,18.2
778,10,1946,408,2354,4.769607843137255
779,1,303,681,984,0.44493392070484583
779,2,1011,789,1800,1.2813688212927756
779,3,1829,500,2329,3.658
780,1,1142,909,2051,1.2563256325632564
780,2,2058,1004,3062,2.049800796812749
781,1,221,406,627,0.5443349753694581
781,2,1343,211,1554,6.3649289099526065
781,3,1583,709,2292,2.232722143864598
782,1,2504,317,2821,7.899053627760252
782,2,2823,60,2883,47.05
782,3,4901,17,4918,288.29411764705884
783,1,12,341,353,0.03519061583577713
784,1,348,1040,1388,0.3346153846153846
784,2,1401,808,2209,1.733910891089109
784,3,2222,663,2885,3.3514328808446456
785,1,47,434,481,0.10829493087557604
785,2,495,410,905,1.2073170731707317
785,3,994,462,1456,2.1515151515151514
785,4,1484,575,2059,2.5808695652173914
785,5,2080,101,2181,20.594059405940595
785,6,2264,178,2442,12.719101123595506
785,7,2456,453,2909,5.421633554083885
785,8,2924,636,3560,4.59748427672956
785,9,3574,596,4170,5.996644295302014
785,10,4193,1062,5255,3.9482109227871938
785,11,5268,241,5509,21.858921161825727
785,12,6621,206,6827,32.140776699029125
785,13,6879,271,7150,25.383763837638377
785,14,7174,505,7679,14.205940594059406
786,1,60,781,841,0.07682458386683738
786,2,848,810,1658,1.0469135802469136
786,3,1665,175,1840,9.514285714285714
786,4,1895,859,2754,2.2060535506402794
786,5,2761,464,3225,5.950431034482759
786,6,3265,807,4072,4.045848822800496
786,7,4114,898,5012,4.581291759465479
786,8,5033,338,5371,14.890532544378699
786,9,5382,465,5847,11.574193548387097
787,1,16,659,675,0.024279210925644917
787,2,688,845,1533,0.8142011834319527
787,3,1546,745,2291,2.0751677852348993
787,4,2306,639,2945,3.6087636932707357
788,1,530,32,562,16.5625
788,2,600,28,628,21.428571428571427
788,3,769,49,818,15.693877551020408
788,4,840,36,876,23.333333333333332
788,5,1362,288,1650,4.729166666666667
788,6,1913,46,1959,41.58695652173913
788,7,2047,435,2482,4.705747126436782
788,8,2485,68,2553,36.544117647058826
788,9,2703,687,3390,3.9344978165938866
788,10,3408,160,3568,21.3
788,11,3666,556,4222,6.593525179856115
788,12,4302,224,4526,19.205357142857142
788,13,4544,114,4658,39.85964912280702
789,1,171,3,174,57.0
790,1,2326,602,2928,3.8637873754152823
791,1,50,794,844,0.06297229219143577
791,2,866,636,1502,1.3616352201257862
791,3,2061,654,2715,3.1513761467889907
792,1,34,186,220,0.1827956989247312
792,2,274,250,524,1.096
792,3,612,294,906,2.0816326530612246
792,4,959,237,1196,4.046413502109704
792,5,1263,353,1616,3.5779036827195467
792,6,1785,359,2144,4.972144846796658
793,1,942,1152,2094,0.8177083333333334
793,2,2142,1279,3421,1.6747458952306489
793,3,6987,881,7868,7.930760499432463
794,1,118,430,548,0.2744186046511628
794,2,550,379,929,1.4511873350923483
794,3,1018,245,1263,4.155102040816327
794,4,1265,355,1620,3.563380281690141
794,5,1665,364,2029,4.574175824175824
795,1,26,306,332,0.08496732026143791
796,1,22,1008,1030,0.021825396825396824
797,1,662,92,754,7.195652173913044
797,2,898,360,1258,2.4944444444444445
797,3,1286,87,1373,14.781609195402298
797,4,1379,736,2115,1.8736413043478262
797,5,2153,765,2918,2.8143790849673205
797,6,2944,348,3292,8.459770114942529
797,7,3321,433,3754,7.669745958429561
797,8,3756,297,4053,12.646464646464647
797,9,4124,518,4642,7.961389961389961
797,10,4666,755,5421,6.180132450331126
798,1,845,438,1283,1.9292237442922375
798,2,1293,330,1623,3.918181818181818
798,3,3791,12,3803,315.9166666666667
798,4,5833,12,5845,486.0833333333333
798,5,6177,12,6189,514.75
799,1,15,549,564,0.0273224043715847
799,2,579,500,1079,1.158
800,1,138,4,142,34.5
800,2,446,4,450,111.5
800,3,457,19,476,24.05263157894737
800,4,643,4,647,160.75
800,5,682,727,1409,0.938101788170564
801,1,103,224,327,0.45982142857142855
802,1,36,38,74,0.9473684210526315
802,2,587,122,709,4.811475409836065
802,3,744,591,1335,1.2588832487309645
802,4,1348,698,2046,1.9312320916905443
802,5,2059,1023,3082,2.0127077223851417
802,6,3090,425,3515,7.270588235294118
802,7,3537,962,4499,3.676715176715177
802,8,4507,638,5145,7.064263322884012
802,9,5194,773,5967,6.719275549805951
803,1,19,341,360,0.05571847507331378
803,2,371,484,855,0.7665289256198347
804,1,6,44,50,0.13636363636363635
804,2,1559,357,1916,4.366946778711484
804,3,1922,285,2207,6.743859649122807
805,1,21,657,678,0.0319634703196347
806,1,39,29,68,1.3448275862068966
807,1,729,323,1052,2.2569659442724457
807,2,1066,645,1711,1.6527131782945736
807,3,1720,638,2358,2.695924764890282
807,4,2366,662,3028,3.5740181268882174
808,1,95,538,633,0.17657992565055763
808,2,728,537,1265,1.355679702048417
808,3,1362,590,1952,2.3084745762711862
808,4,1989,919,2908,2.1643090315560394
808,5,2947,810,3757,3.6382716049382715
808,6,3811,824,4635,4.625
809,1,32,976,1008,0.03278688524590164
810,1,33,793,826,0.0416141235813367
811,1,550,307,857,1.791530944625407
811,2,1383,264,1647,5.238636363636363
811,3,1848,298,2146,6.201342281879195
811,4,2180,950,3130,2.294736842105263
811,5,3145,1009,4154,3.1169474727452924
811,6,4157,794,4951,5.23551637279597
811,7,4987,427,5414,11.679156908665105
811,8,5437,1012,6449,5.372529644268774
812,1,735,386,1121,1.9041450777202074
812,2,1137,201,1338,5.656716417910448
812,3,1346,160,1506,8.4125
812,4,1518,249,1767,6.096385542168675
812,5,1784,257,2041,6.941634241245136
812,6,2063,390,2453,5.28974358974359
812,7,2467,263,2730,9.38022813688213
813,1,46,611,657,0.07528641571194762
813,2,667,489,1156,1.3640081799591002
813,3,1164,392,1556,2.9693877551020407
813,4,1585,77,1662,20.584415584415584
813,5,1673,360,2033,4.647222222222222
813,6,2050,442,2492,4.638009049773756
813,7,2504,492,2996,5.0894308943089435
813,8,3039,255,3294,11.91764705882353
813,9,3380,481,3861,7.027027027027027
813,10,3881,551,4432,7.043557168784029
813,11,4439,456,4895,9.734649122807017
813,12,4920,397,5317,12.39294710327456
813,13,5376,321,5697,16.747663551401867
813,14,5728,527,6255,10.869070208728653
813,15,6281,155,6436,40.52258064516129
813,16,6984,344,7328,20.302325581395348
813,17,7351,654,8005,11.240061162079511
814,1,31,357,388,0.08683473389355742
814,2,398,143,541,2.7832167832167833
814,3,567,437,1004,1.297482837528604
814,4,1009,605,1614,1.6677685950413224
814,5,1644,564,2208,2.9148936170212765
814,6,2225,542,2767,4.105166051660516
814,7,2779,479,3258,5.801670146137787
814,8,3280,433,3713,7.575057736720554
814,9,3725,525,4250,7.095238095238095
814,10,4292,437,4729,9.821510297482838
814,11,4743,434,5177,10.928571428571429
814,12,5205,75,5280,69.4
814,13,5284,79,5363,66.88607594936708
814,14,5380,73,5453,73.6986301369863
814,15,5466,663,6129,8.244343891402714
814,16,6197,804,7001,7.70771144278607
814,17,7283,743,8026,9.802153432032302
815,1,518,145,663,3.5724137931034483
815,2,703,713,1416,0.9859747545582047
815,3,1536,842,2378,1.824228028503563
815,4,2470,315,2785,7.841269841269841
815,5,2830,285,3115,9.929824561403509
815,6,3189,362,3551,8.80939226519337
815,7,3792,854,4646,4.4402810304449645
815,8,4675,946,5621,4.941860465116279
816,1,28,618,646,0.045307443365695796
816,2,665,454,1119,1.4647577092511013
816,3,1128,565,1693,1.9964601769911505
816,4,1701,565,2266,3.010619469026549
817,1,71,507,578,0.14003944773175542
817,2,613,674,1287,0.9094955489614244
817,3,1344,623,1967,2.157303370786517
817,4,2040,530,2570,3.849056603773585
817,5,2600,486,3086,5.349794238683128
818,1,31,394,425,0.07868020304568528
819,1,1086,687,1773,1.5807860262008733
820,1,15,793,808,0.018915510718789406
820,2,830,334,1164,2.4850299401197606
820,3,1173,491,1664,2.389002036659878
820,4,1740,323,2063,5.386996904024768
820,5,2086,435,2521,4.795402298850575
820,6,2533,91,2624,27.835164835164836
820,7,2672,723,3395,3.695712309820194
820,8,3401,352,3753,9.661931818181818
821,1,155,542,697,0.2859778597785978
821,2,709,709,1418,1.0
821,3,1429,599,2028,2.385642737896494
822,1,91,113,204,0.8053097345132744
822,2,321,513,834,0.6257309941520468
822,3,871,513,1384,1.6978557504873295
822,4,1434,822,2256,1.7445255474452555
823,1,28,37,65,0.7567567567567568
823,2,73,296,369,0.24662162162162163
823,3,386,173,559,2.23121387283237
824,1,1850,517,2367,3.5783365570599615
824,2,4221,428,4649,9.86214953271028
824,3,6511,390,6901,16.694871794871794
825,1,22,241,263,0.0912863070539419
825,2,297,568,865,0.522887323943662
826,1,414,24,438,17.25
826,2,1107,25,1132,44.28
826,3,1832,24,1856,76.33333333333333
826,4,2507,23,2530,109.0
826,5,3184,24,3208,132.66666666666666
826,6,3920,23,3943,170.43478260869566
826,7,4638,179,4817,25.910614525139664
826,8,4829,38,4867,127.07894736842105
826,9,4880,47,4927,103.82978723404256
826,10,4987,65,5052,76.72307692307692
826,11,5111,94,5205,54.37234042553192
826,12,5857,139,5996,42.13669064748201
826,13,6445,351,6796,18.36182336182336
826,14,6801,322,7123,21.12111801242236
827,1,271,956,1227,0.2834728033472803
827,2,1235,948,2183,1.3027426160337552
827,3,2191,453,2644,4.836644591611479
827,4,5716,628,6344,9.101910828025478
827,5,6401,651,7052,9.832565284178187
827,6,7094,866,7960,8.191685912240185
828,1,436,1008,1444,0.43253968253968256
828,2,1447,603,2050,2.399668325041459
828,3,2053,497,2550,4.130784708249497
828,4,2568,736,3304,3.489130434782609
828,5,3316,28,3344,118.42857142857143
828,6,3353,499,3852,6.719438877755511
828,7,3860,729,4589,5.2949245541838135
828,8,4623,399,5022,11.586466165413533
828,9,5024,228,5252,22.035087719298247
829,1,18,89,107,0.20224719101123595
829,2,118,204,322,0.5784313725490197
829,3,334,425,759,0.7858823529411765
829,4,771,209,980,3.688995215311005
829,5,992,371,1363,2.673854447439353
829,6,1375,305,1680,4.508196721311475
829,7,1698,446,2144,3.807174887892377
829,8,2159,331,2490,6.522658610271903
829,9,2505,348,2853,7.198275862068965
829,10,2871,405,3276,7.088888888888889
829,11,3311,359,3670,9.222841225626741
829,12,3703,417,4120,8.880095923261392
829,13,4127,88,4215,46.89772727272727
829,14,4223,229,4452,18.441048034934497
829,15,4485,447,4932,10.033557046979865
829,16,4950,452,5402,10.951327433628318
829,17,5412,239,5651,22.644351464435147
829,18,5666,67,5733,84.56716417910448
830,1,709,396,1105,1.7904040404040404
830,2,1121,428,1549,2.619158878504673
831,1,83,378,461,0.21957671957671956
831,2,472,47,519,10.042553191489361
831,3,525,162,687,3.240740740740741
831,4,698,3,701,232.66666666666666
831,5,715,139,854,5.143884892086331
831,6,870,205,1075,4.2439024390243905
831,7,1093,232,1325,4.711206896551724
831,8,1346,144,1490,9.347222222222221
832,1,166,861,1027,0.19279907084785133
832,2,1042,644,1686,1.6180124223602483
833,1,68,797,865,0.08531994981179424
833,2,868,592,1460,1.4662162162162162
834,1,17,713,730,0.023842917251051893
835,1,1968,179,2147,10.994413407821229
836,1,35,682,717,0.051319648093841645
836,2,728,834,1562,0.8729016786570744
836,3,1573,560,2133,2.8089285714285714
836,4,2146,228,2374,9.412280701754385
836,5,2392,263,2655,9.095057034220533
836,6,2680,471,3151,5.690021231422505
836,7,3185,496,3681,6.421370967741935
836,8,3692,657,4349,5.619482496194825
836,9,4367,470,4837,9.291489361702128
837,1,451,270,721,1.6703703703703703
837,2,743,81,824,9.17283950617284
837,3,854,26,880,32.84615384615385
837,4,911,348,1259,2.617816091954023
837,5,1277,136,1413,9.389705882352942
838,1,47,513,560,0.09161793372319688
839,1,78,952,1030,0.0819327731092437
839,2,1047,647,1694,1.6182380216383307
839,3,1750,322,2072,5.434782608695652
839,4,2115,324,2439,6.527777777777778
839,5,2518,905,3423,2.7823204419889502
839,6,3481,372,3853,9.35752688172043
839,7,3921,472,4393,8.307203389830509
839,8,4466,922,5388,4.843817787418655
839,9,5479,932,6411,5.878755364806867
839,10,6490,309,6799,21.003236245954692
839,11,6801,195,6996,34.87692307692308
839,12,6998,154,7152,45.44155844155844
839,13,7154,275,7429,26.014545454545456
839,14,7431,208,7639,35.72596153846154
840,1,390,368,758,1.059782608695652
840,2,1592,597,2189,2.6666666666666665
840,3,2924,59,2983,49.559322033898304
840,4,3771,614,4385,6.141693811074918
840,5,4392,212,4604,20.71698113207547
840,6,4615,709,5324,6.5091678420310295
840,7,5336,593,5929,8.99831365935919
840,8,5970,354,6324,16.864406779661017
840,9,6339,707,7046,8.966053748231966
840,10,7075,339,7414,20.870206489675518
841,1,1215,359,1574,3.384401114206128
841,2,1992,505,2497,3.9445544554455445
841,3,2513,646,3159,3.890092879256966
842,1,2899,387,3286,7.4909560723514215
842,2,3288,404,3692,8.138613861386139
842,3,3767,301,4068,12.514950166112957
842,4,4070,360,4430,11.305555555555555
842,5,4595,319,4914,14.404388714733543
842,6,4958,359,5317,13.81058495821727
842,7,5563,378,5941,14.716931216931217
843,1,78,441,519,0.17687074829931973
843,2,528,707,1235,0.7468175388967468
844,1,15,508,523,0.02952755905511811
845,1,73,780,853,0.09358974358974359
845,2,927,556,1483,1.6672661870503598
846,1,31,615,646,0.05040650406504065
846,2,669,468,1137,1.4294871794871795
846,3,1166,196,1362,5.948979591836735
846,4,1371,427,1798,3.210772833723653
846,5,1828,198,2026,9.232323232323232
846,6,2053,477,2530,4.30398322851153
847,1,99,401,500,0.24688279301745636
848,1,69,996,1065,0.06927710843373494
848,2,1152,506,1658,2.2766798418972334
848,3,1706,535,2241,3.188785046728972
848,4,2253,563,2816,4.001776198934281
848,5,2859,512,3371,5.583984375
848,6,3448,471,3919,7.320594479830149
848,7,3966,619,4585,6.407108239095315
848,8,4621,902,5523,5.123059866962306
848,9,5532,981,6513,5.63914373088685
848,10,6542,563,7105,11.619893428063943
848,11,7139,562,7701,12.702846975088969
849,1,91,397,488,0.22921914357682618
849,2,492,384,876,1.28125
849,3,924,422,1346,2.18957345971564
849,4,1412,408,1820,3.4607843137254903
849,5,1824,384,2208,4.75
849,6,2269,410,2679,5.534146341463415
849,7,2683,454,3137,5.909691629955947
849,8,3171,370,3541,8.57027027027027
849,9,3545,446,3991,7.948430493273543
849,10,3997,451,4448,8.862527716186253
849,11,4486,405,4891,11.076543209876544
849,12,4900,172,5072,28.488372093023255
850,1,176,409,585,0.43031784841075793
850,2,587,446,1033,1.3161434977578474
850,3,2453,314,2767,7.812101910828026
850,4,2769,145,2914,19.09655172413793
850,5,2961,283,3244,10.462897526501767
850,6,3273,520,3793,6.2942307692307695
850,7,3795,367,4162,10.340599455040872
850,8,4259,522,4781,8.159003831417625
850,9,4864,403,5267,12.069478908188586
850,10,5269,342,5611,15.40643274853801
851,1,237,538,775,0.44052044609665425
852,1,315,319,634,0.987460815047022
852,2,807,344,1151,2.3459302325581395
852,3,1290,330,1620,3.909090909090909
852,4,1760,299,2059,5.88628762541806
852,5,2167,267,2434,8.116104868913858
853,1,10,624,634,0.016025641025641024
853,2,688,646,1334,1.065015479876161
854,1,22,191,213,0.11518324607329843
854,2,226,324,550,0.6975308641975309
854,3,563,310,873,1.8161290322580645
854,4,889,365,1254,2.4356164383561643
854,5,1275,228,1503,5.592105263157895
855,1,87,801,888,0.10861423220973783
855,2,912,640,1552,1.425
855,3,1566,423,1989,3.702127659574468
855,4,2002,429,2431,4.666666666666667
855,5,2449,526,2975,4.655893536121673
855,6,2988,580,3568,5.151724137931034
856,1,57,245,302,0.23265306122448978
856,2,343,243,586,1.4115226337448559
856,3,833,291,1124,2.8625429553264605
856,4,1185,242,1427,4.896694214876033
856,5,1485,232,1717,6.400862068965517
856,6,1906,280,2186,6.807142857142857
856,7,2550,355,2905,7.183098591549296
856,8,3108,921,4029,3.3745928338762217
856,9,4267,965,5232,4.421761658031088
857,1,36,63,99,0.5714285714285714
858,1,78,463,541,0.16846652267818574
858,2,576,1000,1576,0.576
858,3,1591,918,2509,1.733115468409586
858,4,2533,691,3224,3.6657018813314037
858,5,3261,972,4233,3.3549382716049383
858,6,4248,39,4287,108.92307692307692
858,7,4315,996,5311,4.332329317269076
858,8,5328,764,6092,6.973821989528796
858,9,6148,300,6448,20.493333333333332
858,10,6510,882,7392,7.380952380952381
859,1,130,2475,2605,0.052525252525252523
860,1,68,1006,1074,0.06759443339960239
860,2,1112,489,1601,2.2740286298568506
861,1,18,963,981,0.018691588785046728
861,2,989,905,1894,1.0928176795580111
862,1,25,557,582,0.04488330341113106
862,2,604,569,1173,1.0615114235500878
862,3,1190,562,1752,2.117437722419929
862,4,1767,597,2364,2.959798994974874
862,5,2392,47,2439,50.8936170212766
863,1,22,337,359,0.06528189910979229
863,2,371,426,797,0.8708920187793427
863,3,818,267,1085,3.0636704119850187
863,4,1108,362,1470,3.0607734806629834
863,5,1499,328,1827,4.570121951219512
863,6,1850,358,2208,5.167597765363128
864,1,12,378,390,0.031746031746031744
864,2,429,649,1078,0.6610169491525424
865,1,1850,517,2367,3.5783365570599615
865,2,4221,428,4649,9.86214953271028
865,3,6511,390,6901,16.694871794871794
866,1,240,581,821,0.41308089500860584
867,1,32,404,436,0.07920792079207921
868,1,432,37,469,11.675675675675675
868,2,864,965,1829,0.8953367875647669
869,1,498,18,516,27.666666666666668
869,2,528,49,577,10.775510204081632
869,3,603,121,724,4.983471074380165
869,4,734,134,868,5.477611940298507
869,5,897,216,1113,4.152777777777778
869,6,1126,57,1183,19.75438596491228
869,7,1194,279,1473,4.279569892473118
869,8,1483,186,1669,7.973118279569892
870,1,160,41,201,3.902439024390244
870,2,236,266,502,0.8872180451127819
871,1,24,591,615,0.04060913705583756
871,2,680,469,1149,1.4498933901918976
871,3,1173,311,1484,3.7717041800643085
871,4,1505,268,1773,5.615671641791045
871,5,1861,789,2650,2.358681875792142
871,6,2680,490,3170,5.469387755102041
872,1,32,593,625,0.05396290050590219
872,2,661,611,1272,1.0818330605564648
872,3,1307,702,2009,1.8618233618233617
872,4,2277,888,3165,2.564189189189189
872,5,3245,662,3907,4.901812688821752
872,6,3960,669,4629,5.9192825112107625
872,7,4666,727,5393,6.418156808803301
872,8,5459,622,6081,8.77652733118971
872,9,6131,752,6883,8.152925531914894
872,10,7008,879,7887,7.972696245733788
873,1,33,469,502,0.07036247334754797
873,2,537,587,1124,0.9148211243611585
873,3,1235,709,1944,1.7418899858956276
873,4,2003,734,2737,2.7288828337874658
873,5,2782,698,3480,3.98567335243553
873,6,3502,498,4000,7.032128514056225
873,7,4021,636,4657,6.322327044025157
873,8,4685,687,5372,6.819505094614265
873,9,5825,511,6336,11.399217221135029
873,10,6816,943,7759,7.2279957582184515
873,11,7767,157,7924,49.47133757961783
874,1,15,278,293,0.0539568345323741
874,2,440,758,1198,0.5804749340369393
874,3,1267,975,2242,1.2994871794871794
874,4,2330,714,3044,3.2633053221288515
874,5,3091,811,3902,3.81134401972873
874,6,3931,839,4770,4.685339690107271
874,7,4802,915,5717,5.248087431693989
874,8,5788,882,6670,6.562358276643991
874,9,6698,771,7469,8.687418936446173
875,1,8,239,247,0.03347280334728033
875,2,251,290,541,0.8655172413793103
875,3,545,295,840,1.847457627118644
875,4,860,310,1170,2.774193548387097
875,5,1174,229,1403,5.126637554585153
876,1,51,461,512,0.11062906724511931
876,2,517,773,1290,0.6688227684346701
877,1,46,695,741,0.06618705035971223
877,2,799,709,1508,1.1269393511988717
877,3,1597,682,2279,2.341642228739003
877,4,2316,740,3056,3.1297297297297297
877,5,3087,515,3602,5.994174757281553
877,6,3645,683,4328,5.33674963396779
877,7,4362,677,5039,6.443131462333826
877,8,5067,690,5757,7.343478260869565
877,9,5810,731,6541,7.948016415868673
877,10,6584,653,7237,10.082695252679938
877,11,7270,719,7989,10.111265646731571
878,1,15,491,506,0.03054989816700611
878,2,538,479,1017,1.1231732776617953
878,3,1031,498,1529,2.070281124497992
878,4,1539,736,2275,2.0910326086956523
878,5,2296,332,2628,6.9156626506024095
879,1,192,18,210,10.666666666666666
880,1,152,200,352,0.76
880,2,360,204,564,1.7647058823529411
880,3,580,737,1317,0.7869742198100407
880,4,1349,791,2140,1.7054361567635903
880,5,2317,675,2992,3.4325925925925924
880,6,3002,234,3236,12.82905982905983
880,7,3258,214,3472,15.22429906542056
880,8,3491,325,3816,10.741538461538461
880,9,3826,310,4136,12.341935483870968
881,1,21,474,495,0.04430379746835443
881,2,519,906,1425,0.5728476821192053
881,3,1501,720,2221,2.084722222222222
881,4,2243,479,2722,4.682672233820459
881,5,2738,923,3661,2.9664138678223186
881,6,3705,601,4306,6.164725457570715
881,7,4379,700,5079,6.255714285714285
881,8,5113,589,5702,8.68081494057725
881,9,5724,390,6114,14.676923076923076
881,10,6136,822,6958,7.464720194647202
881,11,6984,782,7766,8.930946291560103
882,1,574,392,966,1.4642857142857142
882,2,1313,506,1819,2.5948616600790513
883,1,196,862,1058,0.2273781902552204
883,2,1066,948,2014,1.1244725738396624
883,3,2030,67,2097,30.29850746268657
883,4,2106,906,3012,2.3245033112582782
883,5,3217,840,4057,3.829761904761905
884,1,1705,763,2468,2.2346002621231977
884,2,2524,97,2621,26.02061855670103
884,3,2632,103,2735,25.553398058252426
884,4,2737,36,2773,76.02777777777777
884,5,2784,176,2960,15.818181818181818
885,1,80,615,695,0.13008130081300814
885,2,701,264,965,2.6553030303030303
885,3,990,160,1150,6.1875
885,4,1175,214,1389,5.490654205607477
885,5,1396,339,1735,4.117994100294985
886,1,31,381,412,0.08136482939632546
886,2,461,143,604,3.2237762237762237
887,1,90,206,296,0.4368932038834951
887,2,305,181,486,1.6850828729281768
887,3,515,233,748,2.2103004291845494
888,1,85,586,671,0.14505119453924914
888,2,697,740,1437,0.9418918918918919
889,1,12,767,779,0.01564537157757497
890,1,150,1018,1168,0.14734774066797643
890,2,1184,985,2169,1.202030456852792
890,3,2189,999,3188,2.191191191191191
890,4,3203,945,4148,3.389417989417989
891,1,33,336,369,0.09821428571428571
892,1,239,124,363,1.9274193548387097
892,2,445,89,534,5.0
892,3,563,184,747,3.0597826086956523
892,4,991,211,1202,4.696682464454977
892,5,1234,255,1489,4.8392156862745095
892,6,1503,200,1703,7.515
892,7,1781,282,2063,6.315602836879433
892,8,2079,167,2246,12.449101796407186
892,9,2287,278,2565,8.226618705035971
892,10,2643,117,2760,22.58974358974359
892,11,3070,507,3577,6.055226824457594
892,12,3593,167,3760,21.51497005988024
892,13,3772,206,3978,18.310679611650485
892,14,4209,845,5054,4.981065088757396
892,15,5068,309,5377,16.401294498381876
892,16,5393,386,5779,13.971502590673575
892,17,5790,481,6271,12.037422037422038
893,1,13,307,320,0.04234527687296417
893,2,345,708,1053,0.4872881355932203
893,3,1086,1042,2128,1.0422264875239924
893,4,2131,354,2485,6.019774011299435
894,1,17,419,436,0.0405727923627685
894,2,453,395,848,1.1468354430379746
894,3,872,437,1309,1.9954233409610984
894,4,1348,419,1767,3.217183770883055
894,5,1769,403,2172,4.389578163771712
894,6,2174,382,2556,5.69109947643979
894,7,2558,386,2944,6.626943005181347
894,8,2946,393,3339,7.4961832061068705
894,9,3341,399,3740,8.3734335839599
894,10,3742,466,4208,8.030042918454935
895,1,51,143,194,0.35664335664335667
895,2,242,432,674,0.5601851851851852
895,3,687,293,980,2.3447098976109215
895,4,997,191,1188,5.219895287958115
895,5,1304,448,1752,2.9107142857142856
895,6,1832,356,2188,5.146067415730337
895,7,2237,480,2717,4.660416666666666
895,8,2769,441,3210,6.27891156462585
895,9,3290,156,3446,21.08974358974359
895,10,3475,28,3503,124.10714285714286
895,11,3568,66,3634,54.06060606060606
895,12,3726,90,3816,41.4
895,13,3864,101,3965,38.257425742574256
895,14,4262,378,4640,11.275132275132275
895,15,4774,394,5168,12.116751269035532
895,16,5367,382,5749,14.049738219895287
895,17,5923,115,6038,51.504347826086956
895,18,6091,275,6366,22.14909090909091
895,19,6451,356,6807,18.120786516853933
895,20,6946,282,7228,24.631205673758867
895,21,7569,437,8006,17.320366132723112
896,1,306,41,347,7.463414634146342
896,2,502,600,1102,0.8366666666666667
896,3,1111,197,1308,5.6395939086294415
896,4,1330,573,1903,2.3211169284467714
896,5,1941,158,2099,12.284810126582279
896,6,2114,540,2654,3.914814814814815
896,7,2694,323,3017,8.340557275541796
897,1,2314,55,2369,42.07272727272727
897,2,2384,179,2563,13.318435754189943
897,3,2588,193,2781,13.409326424870466
897,4,2801,240,3041,11.670833333333333
897,5,3059,188,3247,16.27127659574468
897,6,3854,258,4112,14.937984496124031
897,7,4123,206,4329,20.014563106796118
897,8,4343,334,4677,13.002994011976048
897,9,4691,235,4926,19.961702127659574
897,10,4948,403,5351,12.277915632754343
897,11,5365,344,5709,15.595930232558139
897,12,5779,412,6191,14.026699029126213
898,1,156,27,183,5.777777777777778
898,2,1974,28,2002,70.5
898,3,2080,259,2339,8.03088803088803
898,4,2380,240,2620,9.916666666666666
898,5,2633,213,2846,12.36150234741784
898,6,2860,243,3103,11.76954732510288
898,7,3115,230,3345,13.543478260869565
898,8,3350,381,3731,8.79265091863517
898,9,3736,41,3777,91.1219512195122
899,1,24,672,696,0.03571428571428571
900,1,130,446,576,0.2914798206278027
900,2,584,413,997,1.414043583535109
900,3,1013,276,1289,3.670289855072464
900,4,1297,462,1759,2.8073593073593073
900,5,1767,629,2396,2.809220985691574
901,1,59,604,663,0.09768211920529801
902,1,18,470,488,0.03829787234042553
903,1,5359,585,5944,9.16068376068376
904,1,29,39,68,0.7435897435897436
904,2,70,13,83,5.384615384615385
904,3,89,15,104,5.933333333333334
904,4,106,11,117,9.636363636363637
904,5,120,12,132,10.0
904,6,134,12,146,11.166666666666666
904,7,149,11,160,13.545454545454545
904,8,170,21,191,8.095238095238095
904,9,196,4,200,49.0
904,10,205,18,223,11.38888888888889
904,11,225,41,266,5.487804878048781
904,12,271,5,276,54.2
904,13,289,60,349,4.816666666666666
904,14,355,18,373,19.72222222222222
904,15,376,54,430,6.962962962962963
904,16,466,88,554,5.295454545454546
905,1,32,781,813,0.040973111395646605
905,2,834,1025,1859,0.8136585365853658
905,3,1869,209,2078,8.942583732057416
905,4,2123,437,2560,4.85812356979405
905,5,2597,322,2919,8.065217391304348
905,6,2964,683,3647,4.339677891654466
905,7,3673,725,4398,5.066206896551724
905,8,4409,639,5048,6.899843505477309
906,1,96,579,675,0.16580310880829016
906,2,694,201,895,3.4527363184079602
907,1,78,372,450,0.20967741935483872
908,1,1898,640,2538,2.965625
908,2,2554,214,2768,11.934579439252337
909,1,150,22,172,6.818181818181818
909,2,668,826,1494,0.8087167070217918
909,3,1568,799,2367,1.962453066332916
909,4,2602,795,3397,3.2729559748427675
909,5,3429,911,4340,3.7639956092206366
909,6,4350,829,5179,5.247285886610374
910,1,49,118,167,0.4152542372881356
910,2,1723,416,2139,4.141826923076923
910,3,2170,179,2349,12.12290502793296
910,4,2358,328,2686,7.189024390243903
910,5,2723,109,2832,24.98165137614679
910,6,2865,353,3218,8.11614730878187
910,7,3235,178,3413,18.174157303370787
910,8,3426,229,3655,14.960698689956331
910,9,3682,381,4063,9.664041994750656
910,10,4071,189,4260,21.53968253968254
910,11,4278,259,4537,16.517374517374517
910,12,4553,228,4781,19.969298245614034
910,13,4798,233,5031,20.59227467811159
910,14,5039,258,5297,19.531007751937985
910,15,5321,164,5485,32.44512195121951
910,16,5494,228,5722,24.096491228070175
910,17,5732,249,5981,23.02008032128514
910,18,5997,320,6317,18.740625
910,19,6358,328,6686,19.384146341463413
910,20,6701,414,7115,16.185990338164252
910,21,7148,274,7422,26.087591240875913
910,22,7435,272,7707,27.334558823529413
910,23,7741,260,8001,29.773076923076925
911,1,1394,937,2331,1.487726787620064
911,2,2334,420,2754,5.557142857142857
911,3,2826,646,3472,4.374613003095975
911,4,3518,529,4047,6.650283553875236
911,5,4068,463,4531,8.786177105831534
911,6,4568,639,5207,7.148669796557121
911,7,5235,545,5780,9.605504587155963
911,8,5789,394,6183,14.692893401015228
911,9,6191,562,6753,11.016014234875446
911,10,6922,217,7139,31.898617511520737
911,11,7253,594,7847,12.210437710437711
912,1,24,191,215,0.1256544502617801
912,2,305,171,476,1.7836257309941521
913,1,1724,899,2623,1.917686318131257
913,2,2625,706,3331,3.718130311614731
913,3,4911,639,5550,7.685446009389671
913,4,5552,206,5758,26.95145631067961
913,5,5760,391,6151,14.731457800511508
913,6,6153,366,6519,16.811475409836067
913,7,7321,425,7746,17.225882352941177
913,8,7748,308,8056,25.155844155844157
914,1,15,30,45,0.5
914,2,64,131,195,0.48854961832061067
914,3,210,127,337,1.6535433070866141
914,4,344,230,574,1.4956521739130435
914,5,582,235,817,2.476595744680851
914,6,835,199,1034,4.1959798994974875
914,7,1045,100,1145,10.45
914,8,1154,201,1355,5.741293532338308
914,9,1373,203,1576,6.763546798029557
915,1,24,607,631,0.039538714991762765
915,2,668,692,1360,0.9653179190751445
915,3,1372,638,2010,2.1504702194357366
915,4,2019,616,2635,3.2775974025974026
915,5,2667,577,3244,4.622183708838821
915,6,3258,611,3869,5.332242225859247
916,1,11,447,458,0.024608501118568233
916,2,505,257,762,1.9649805447470816
917,1,23,464,487,0.04956896551724138
917,2,512,122,634,4.19672131147541
917,3,649,507,1156,1.280078895463511
918,1,548,347,895,1.579250720461095
918,2,898,356,1254,2.5224719101123596
918,3,1257,339,1596,3.7079646017699117
918,4,1599,314,1913,5.092356687898089
918,5,1916,121,2037,15.834710743801653
918,6,2055,403,2458,5.099255583126551
919,1,32,588,620,0.05442176870748299
919,2,638,514,1152,1.2412451361867705
919,3,1171,502,1673,2.3326693227091635
920,1,16,341,357,0.0469208211143695
920,2,373,376,749,0.9920212765957447
920,3,765,503,1268,1.5208747514910537
920,4,1285,505,1790,2.5445544554455446
920,5,1811,284,2095,6.376760563380282
920,6,2124,192,2316,11.0625
921,1,42,108,150,0.3888888888888889
921,2,803,747,1550,1.0749665327978581
921,3,2444,769,3213,3.1781534460338103
921,4,3217,756,3973,4.255291005291006
921,5,3996,809,4805,4.939431396786156
921,6,4813,759,5572,6.341238471673254
922,1,27,501,528,0.05389221556886228
922,2,561,640,1201,0.8765625
923,1,57,304,361,0.1875
924,1,2679,723,3402,3.7053941908713695
925,1,2005,884,2889,2.268099547511312
925,2,2909,213,3122,13.657276995305164
925,3,3156,211,3367,14.957345971563981
925,4,3374,498,3872,6.775100401606426
925,5,3892,82,3974,47.46341463414634
925,6,3994,54,4048,73.96296296296296
925,7,4061,132,4193,30.765151515151516
925,8,4196,381,4577,11.013123359580053
925,9,4580,474,5054,9.662447257383967
925,10,5057,705,5762,7.173049645390071
925,11,5778,146,5924,39.57534246575342
925,12,6145,718,6863,8.55849582172702
925,13,7608,6,7614,1268.0
925,14,7653,3,7656,2551.0
926,1,2,24,26,0.08333333333333333
926,2,32,239,271,0.13389121338912133
927,1,139,718,857,0.1935933147632312
927,2,886,570,1456,1.5543859649122806
928,1,161,901,1062,0.17869034406215317
928,2,1069,454,1523,2.354625550660793
928,3,1560,264,1824,5.909090909090909
928,4,1847,374,2221,4.938502673796791
928,5,2830,466,3296,6.072961373390558
929,1,1173,360,1533,3.2583333333333333
929,2,1553,394,1947,3.9416243654822334
929,3,1964,380,2344,5.168421052631579
930,1,55,972,1027,0.056584362139917695
930,2,1054,695,1749,1.516546762589928
930,3,1766,768,2534,2.2994791666666665
930,4,2545,747,3292,3.4069611780455156
930,5,3307,918,4225,3.60239651416122
930,6,4260,1013,5273,4.20533070088845
930,7,5288,832,6120,6.355769230769231
930,8,6148,941,7089,6.533475026567482
930,9,7100,668,7768,10.62874251497006
931,1,43,608,651,0.07072368421052631
931,2,666,425,1091,1.5670588235294118
931,3,1115,668,1783,1.6691616766467066
931,4,1806,638,2444,2.830721003134796
931,5,2459,1049,3508,2.344137273593899
931,6,3515,599,4114,5.868113522537563
931,7,4146,822,4968,5.043795620437956
931,8,4979,768,5747,6.483072916666667
931,9,5798,451,6249,12.855875831485587
931,10,6272,524,6796,11.969465648854962
931,11,6818,688,7506,9.909883720930232
932,1,22,417,439,0.05275779376498801
932,2,447,495,942,0.9030303030303031
932,3,961,565,1526,1.7008849557522123
932,4,1558,627,2185,2.484848484848485
932,5,2191,304,2495,7.207236842105263
932,6,2506,707,3213,3.5445544554455446
932,7,3221,625,3846,5.1536
932,8,3852,613,4465,6.283849918433932
932,9,4472,486,4958,9.201646090534979
932,10,4975,592,5567,8.403716216216216
932,11,5583,345,5928,16.182608695652174
932,12,5958,309,6267,19.281553398058254
932,13,6305,312,6617,20.208333333333332
932,14,6660,308,6968,21.623376623376622
933,1,12,33,45,0.36363636363636365
934,1,24,856,880,0.028037383177570093
935,1,292,824,1116,0.35436893203883496
936,1,1906,120,2026,15.883333333333333
936,2,2037,77,2114,26.454545454545453
936,3,2132,77,2209,27.68831168831169
937,1,449,810,1259,0.554320987654321
937,2,1752,922,2674,1.9002169197396963
937,3,3139,680,3819,4.616176470588235
938,1,18,512,530,0.03515625
938,2,552,523,1075,1.0554493307839388
938,3,1089,484,1573,2.25
938,4,1592,541,2133,2.942698706099815
939,1,35,715,750,0.04895104895104895
940,1,696,55,751,12.654545454545454
940,2,830,85,915,9.764705882352942
940,3,1066,57,1123,18.70175438596491
941,1,339,1014,1353,0.3343195266272189
941,2,1355,491,1846,2.759674134419552
941,3,2185,1014,3199,2.1548323471400392
941,4,3201,491,3692,6.519348268839104
941,5,3694,181,3875,20.408839779005525
941,6,4214,1001,5215,4.20979020979021
941,7,5217,807,6024,6.4646840148698885
941,8,6026,944,6970,6.383474576271187
942,1,68,79,147,0.8607594936708861
942,2,244,410,654,0.5951219512195122
942,3,686,328,1014,2.091463414634146
943,1,158,353,511,0.4475920679886686
943,2,513,467,980,1.0985010706638116
943,3,1016,453,1469,2.2428256070640176
943,4,1505,380,1885,3.960526315789474
943,5,1920,380,2300,5.052631578947368
943,6,2365,378,2743,6.256613756613756
943,7,2847,369,3216,7.715447154471545
943,8,3341,368,3709,9.078804347826088
943,9,3711,301,4012,12.32890365448505
943,10,4142,382,4524,10.842931937172775
943,11,4612,327,4939,14.103975535168196
943,12,5067,321,5388,15.785046728971963
943,13,5416,373,5789,14.520107238605899
943,14,5877,366,6243,16.057377049180328
943,15,6276,376,6652,16.69148936170213
943,16,6698,492,7190,13.613821138211382
943,17,7216,678,7894,10.64306784660767
944,1,143,737,880,0.19402985074626866
945,1,319,58,377,5.5
945,2,382,54,436,7.074074074074074
945,3,442,68,510,6.5
945,4,528,94,622,5.617021276595745
945,5,637,72,709,8.847222222222221
945,6,713,73,786,9.767123287671232
945,7,791,71,862,11.140845070422536
945,8,876,82,958,10.682926829268293
945,9,973,104,1077,9.35576923076923
945,10,1087,97,1184,11.206185567010309
945,11,1199,117,1316,10.247863247863247
945,12,1340,110,1450,12.181818181818182
945,13,1457,95,1552,15.336842105263157
945,14,1556,118,1674,13.186440677966102
945,15,1688,87,1775,19.402298850574713
945,16,1786,122,1908,14.639344262295081
945,17,1929,123,2052,15.682926829268293
946,1,31,137,168,0.22627737226277372
947,1,31,529,560,0.05860113421550094
947,2,1502,743,2245,2.0215343203230147
947,3,2276,387,2663,5.881136950904393
947,4,2685,1115,3800,2.408071748878924
947,5,3815,997,4812,3.8264794383149447
947,6,4825,997,5822,4.839518555667001
947,7,5836,460,6296,12.68695652173913
947,8,6312,276,6588,22.869565217391305
948,1,57,644,701,0.08850931677018634
948,2,719,715,1434,1.0055944055944055
948,3,1472,655,2127,2.2473282442748093
948,4,2152,116,2268,18.551724137931036
949,1,41,661,702,0.06202723146747353
949,2,746,685,1431,1.089051094890511
949,3,1462,648,2110,2.256172839506173
950,1,101,133,234,0.7593984962406015
950,2,296,179,475,1.6536312849162011
950,3,490,224,714,2.1875
950,4,811,98,909,8.275510204081632
950,5,922,174,1096,5.2988505747126435
951,1,29,255,284,0.11372549019607843
951,2,305,446,751,0.6838565022421524
951,3,768,565,1333,1.35929203539823
951,4,1350,581,1931,2.323580034423408
951,5,1954,676,2630,2.8905325443786984
951,6,2743,792,3535,3.4633838383838382
951,7,3564,752,4316,4.73936170212766
951,8,4407,696,5103,6.331896551724138
951,9,5183,661,5844,7.841149773071105
951,10,5892,688,6580,8.563953488372093
951,11,6638,720,7358,9.219444444444445
951,12,7395,688,8083,10.748546511627907
952,1,167,780,947,0.2141025641025641
952,2,983,460,1443,2.1369565217391306
952,3,1472,517,1989,2.8471953578336557
953,1,75,564,639,0.13297872340425532
953,2,672,277,949,2.4259927797833933
953,3,981,352,1333,2.7869318181818183
953,4,1338,278,1616,4.81294964028777
953,5,1624,8,1632,203.0
953,6,1637,292,1929,5.6061643835616435
953,7,1947,687,2634,2.834061135371179
954,1,452,315,767,1.434920634920635
954,2,830,200,1030,4.15
954,3,1059,322,1381,3.2888198757763973
954,4,1446,302,1748,4.788079470198675
954,5,1895,341,2236,5.557184750733138
954,6,2265,296,2561,7.652027027027027
954,7,2618,687,3305,3.8107714701601165
954,8,3376,552,3928,6.115942028985507
954,9,3955,502,4457,7.878486055776892
954,10,4530,437,4967,10.366132723112129
954,11,5053,458,5511,11.032751091703057
954,12,5627,519,6146,10.842003853564547
954,13,6322,473,6795,13.365750528541227
954,14,6824,448,7272,15.232142857142858
955,1,24,298,322,0.08053691275167785
956,1,18,970,988,0.018556701030927835
957,1,17,701,718,0.024251069900142655
957,2,753,994,1747,0.7575452716297787
957,3,1752,823,2575,2.1287970838396113
958,1,3303,100,3403,33.03
958,2,6730,639,7369,10.5320813771518
959,1,51,791,842,0.06447534766118837
959,2,880,823,1703,1.069258809234508
959,3,1724,559,2283,3.084078711985689
959,4,2346,940,3286,2.4957446808510637
959,5,3294,691,3985,4.767004341534009
960,1,47,405,452,0.11604938271604938
960,2,481,298,779,1.6140939597315436
961,1,754,625,1379,1.2064
961,2,1417,52,1469,27.25
961,3,3284,950,4234,3.4568421052631577
961,4,4939,586,5525,8.428327645051194
961,5,6580,861,7441,7.642276422764228
962,1,22,575,597,0.03826086956521739
962,2,602,569,1171,1.0579964850615113
962,3,1296,957,2253,1.35423197492163
962,4,2255,504,2759,4.474206349206349
962,5,2796,679,3475,4.117820324005891
962,6,3516,670,4186,5.2477611940298505
962,7,4218,471,4689,8.955414012738853
962,8,4730,563,5293,8.401420959147424
962,9,5321,476,5797,11.178571428571429
963,1,61,784,845,0.0778061224489796
963,2,848,65,913,13.046153846153846
963,3,1290,544,1834,2.3713235294117645
963,4,1879,336,2215,5.592261904761905
963,5,2266,396,2662,5.722222222222222
963,6,2713,337,3050,8.050445103857566
963,7,3091,387,3478,7.987080103359173
964,1,129,640,769,0.2015625
964,2,798,137,935,5.824817518248175
964,3,1034,450,1484,2.2977777777777777
964,4,1627,130,1757,12.515384615384615
964,5,1810,401,2211,4.513715710723192
964,6,2438,406,2844,6.004926108374384
964,7,2858,681,3539,4.196769456681351
964,8,3600,609,4209,5.911330049261084
964,9,4219,1080,5299,3.9064814814814817
964,10,5310,485,5795,10.948453608247423
964,11,5812,705,6517,8.243971631205675
965,1,17,678,695,0.025073746312684365
965,2,699,151,850,4.629139072847682
965,3,859,48,907,17.895833333333332
965,4,915,171,1086,5.350877192982456
965,5,1115,624,1739,1.7868589743589745
965,6,1750,263,2013,6.653992395437262
965,7,2027,196,2223,10.341836734693878
965,8,2255,357,2612,6.3165266106442575
965,9,2622,92,2714,28.5
965,10,2717,111,2828,24.47747747747748
965,11,3267,335,3602,9.75223880597015
965,12,3639,425,4064,8.56235294117647
965,13,4090,516,4606,7.926356589147287
966,1,123,104,227,1.1826923076923077
967,1,155,925,1080,0.16756756756756758
968,1,120,1003,1123,0.11964107676969092
968,2,1128,115,1243,9.808695652173913
968,3,1266,250,1516,5.064
968,4,1531,307,1838,4.986970684039088
968,5,1840,30,1870,61.333333333333336
968,6,1945,654,2599,2.974006116207951
968,7,2610,406,3016,6.428571428571429
968,8,3028,563,3591,5.378330373001776
968,9,3613,617,4230,5.855753646677472
969,1,196,84,280,2.3333333333333335
969,2,314,419,733,0.7494033412887828
969,3,814,345,1159,2.3594202898550725
969,4,1168,263,1431,4.44106463878327
969,5,1751,94,1845,18.627659574468087
969,6,1918,451,2369,4.252771618625277
969,7,2372,151,2523,15.708609271523178
969,8,2701,256,2957,10.55078125
969,9,2995,405,3400,7.395061728395062
969,10,3441,49,3490,70.22448979591837
969,11,3587,11,3598,326.09090909090907
969,12,3617,199,3816,18.175879396984925
969,13,3847,222,4069,17.32882882882883
969,14,4191,370,4561,11.327027027027027
969,15,4603,210,4813,21.919047619047618
969,16,4859,532,5391,9.13345864661654
969,17,5423,519,5942,10.448940269749519
969,18,6063,409,6472,14.8239608801956
969,19,6504,357,6861,18.218487394957982
969,20,6950,66,7016,105.3030303030303
969,21,7117,746,7863,9.540214477211796
970,1,97,198,295,0.4898989898989899
971,1,72,698,770,0.10315186246418338
972,1,33,530,563,0.062264150943396226
972,2,579,714,1293,0.8109243697478992
972,3,1301,385,1686,3.379220779220779
972,4,1738,326,2064,5.331288343558282
972,5,2104,410,2514,5.131707317073171
972,6,2538,446,2984,5.690582959641255
972,7,3024,354,3378,8.542372881355933
973,1,1286,981,2267,1.3109072375127422
973,2,2275,489,2764,4.652351738241308
973,3,4124,814,4938,5.066339066339066
973,4,5295,809,6104,6.545117428924598
973,5,6394,973,7367,6.571428571428571
974,1,24,186,210,0.12903225806451613
975,1,434,120,554,3.6166666666666667
976,1,56,809,865,0.069221260815822
977,1,110,250,360,0.44
977,2,435,668,1103,0.6511976047904192
977,3,1113,652,1765,1.7070552147239264
978,1,1045,1142,2187,0.9150612959719789
978,2,2404,738,3142,3.2574525745257454
978,3,3177,367,3544,8.6566757493188
979,1,61,782,843,0.07800511508951406
980,1,132,132,264,1.0
980,2,271,317,588,0.8548895899053628
980,3,595,349,944,1.7048710601719197
980,4,963,396,1359,2.4318181818181817
980,5,1366,452,1818,3.02212389380531
980,6,1825,357,2182,5.1120448179271705
980,7,2190,253,2443,8.65612648221344
981,1,370,152,522,2.4342105263157894
981,2,684,893,1577,0.7659574468085106
981,3,1619,833,2452,1.943577430972389
981,4,2458,653,3111,3.76416539050536
982,1,95,862,957,0.11020881670533643
982,2,961,646,1607,1.4876160990712075
983,1,442,602,1044,0.7342192691029901
984,1,551,561,1112,0.982174688057041
984,2,1163,594,1757,1.9579124579124578
985,1,23,234,257,0.09829059829059829
985,2,276,304,580,0.9078947368421053
985,3,609,269,878,2.2639405204460967
985,4,908,347,1255,2.61671469740634
985,5,1283,219,1502,5.858447488584475
985,6,1515,254,1769,5.964566929133858
985,7,1788,281,2069,6.362989323843417
986,1,55,618,673,0.0889967637540453
987,1,18,434,452,0.041474654377880185
987,2,482,591,1073,0.8155668358714044
987,3,1119,777,1896,1.4401544401544402
987,4,1924,777,2701,2.4761904761904763
987,5,2736,1011,3747,2.706231454005935
988,1,25,34,59,0.7352941176470589
988,2,315,479,794,0.6576200417536534
988,3,826,30,856,27.533333333333335
988,4,1481,621,2102,2.3848631239935587
989,1,28,618,646,0.045307443365695796
989,2,655,463,1118,1.4146868250539957
989,3,1129,439,1568,2.571753986332574
989,4,1600,455,2055,3.5164835164835164
990,1,1254,440,1694,2.85
990,2,1708,757,2465,2.2562747688243063
990,3,2484,304,2788,8.171052631578947
991,1,6,17,23,0.35294117647058826
991,2,253,327,580,0.7737003058103975
991,3,603,282,885,2.1382978723404253
991,4,920,311,1231,2.9581993569131835
991,5,1249,326,1575,3.831288343558282
991,6,1582,333,1915,4.7507507507507505
991,7,2137,322,2459,6.636645962732919
991,8,2466,261,2727,9.448275862068966
991,9,2880,335,3215,8.597014925373134
991,10,3221,357,3578,9.022408963585434
991,11,3585,302,3887,11.870860927152318
991,12,3952,304,4256,13.0
991,13,4322,329,4651,13.136778115501519
991,14,4685,257,4942,18.229571984435797
991,15,4988,311,5299,16.038585209003216
991,16,5342,356,5698,15.00561797752809
991,17,5706,324,6030,17.61111111111111
991,18,6038,196,6234,30.806122448979593
991,19,6336,345,6681,18.36521739130435
991,20,6689,188,6877,35.579787234042556
991,21,6882,349,7231,19.719197707736388
991,22,7242,438,7680,16.534246575342465
992,1,278,34,312,8.176470588235293
993,1,14,242,256,0.05785123966942149
993,2,271,617,888,0.4392220421393841
993,3,909,209,1118,4.349282296650718
994,1,44,410,454,0.1073170731707317
994,2,495,819,1314,0.6043956043956044
994,3,1318,358,1676,3.6815642458100557
995,1,108,872,980,0.12385321100917432
996,1,134,94,228,1.425531914893617
996,2,257,195,452,1.317948717948718
996,3,468,216,684,2.1666666666666665
997,1,88,1058,1146,0.0831758034026465
997,2,1154,562,1716,2.0533807829181496
997,3,1747,1075,2822,1.6251162790697675
997,4,2838,717,3555,3.9581589958158996
997,5,3618,992,4610,3.6471774193548385
997,6,4618,624,5242,7.4006410256410255
997,7,5266,1074,6340,4.9031657355679705
997,8,6356,958,7314,6.634655532359082
997,9,7350,487,7837,15.092402464065708
998,1,19,614,633,0.030944625407166124
998,2,650,375,1025,1.7333333333333334
998,3,1141,425,1566,2.684705882352941
998,4,1593,271,1864,5.878228782287823
998,5,1886,481,2367,3.920997920997921
998,6,2398,534,2932,4.49063670411985
999,1,16,371,387,0.0431266846361186
999,2,390,369,759,1.056910569105691
1000,1,18,15,33,1.2
1000,2,41,82,123,0.5
1000,3,129,319,448,0.4043887147335423
1000,4,456,639,1095,0.7136150234741784
1000,5,1106,236,1342,4.686440677966102
1000,6,1352,256,1608,5.28125
1000,7,1622,257,1879,6.311284046692607
1000,8,1896,262,2158,7.236641221374046
1000,9,2168,247,2415,8.777327935222672
1000,10,2426,272,2698,8.919117647058824
1000,11,2710,245,2955,11.061224489795919
1000,12,2963,251,3214,11.804780876494023
1000,13,3226,232,3458,13.905172413793103
1000,14,3473,240,3713,14.470833333333333
1000,15,3737,155,3892,24.10967741935484
1000,16,3902,707,4609,5.519094766619519
1000,17,4617,290,4907,15.920689655172414
1000,18,4918,257,5175,19.136186770428015
1000,19,5188,274,5462,18.934306569343065
1000,20,5472,247,5719,22.153846153846153
1000,21,5729,258,5987,22.205426356589147
1000,22,5996,254,6250,23.606299212598426
1000,23,6264,310,6574,20.206451612903226
1000,24,6584,314,6898,20.96815286624204
1000,25,6909,282,7191,24.5
1000,26,7204,334,7538,21.568862275449103
1001,1,118,814,932,0.14496314496314497
1001,2,970,823,1793,1.1786148238153098
1002,1,166,273,439,0.608058608058608
1002,2,452,260,712,1.7384615384615385
1002,3,728,295,1023,2.4677966101694917
1002,4,1027,357,1384,2.876750700280112
1002,5,1394,344,1738,4.0523255813953485
1002,6,1748,271,2019,6.450184501845018
1002,7,2034,423,2457,4.808510638297872
1002,8,2460,352,2812,6.988636363636363
1003,1,58,845,903,0.06863905325443787
1003,2,937,474,1411,1.9767932489451476
1003,3,1434,943,2377,1.52067868504772
1003,4,2413,1015,3428,2.3773399014778325
1003,5,3458,625,4083,5.5328
1003,6,4101,800,4901,5.12625
1003,7,4970,748,5718,6.644385026737968
1004,1,68,797,865,0.08531994981179424
1005,1,96,173,269,0.5549132947976878
1005,2,480,321,801,1.4953271028037383
1005,3,806,314,1120,2.56687898089172
1005,4,1125,313,1438,3.594249201277955
1005,5,1443,259,1702,5.571428571428571
1005,6,1707,267,1974,6.393258426966292
1005,7,2048,338,2386,6.059171597633136
1005,8,2485,261,2746,9.521072796934867
1006,1,241,1026,1267,0.23489278752436646
1006,2,1275,1018,2293,1.2524557956777995
1007,1,38,218,256,0.1743119266055046
1007,2,273,146,419,1.86986301369863
1008,1,188,429,617,0.4382284382284382
1009,1,51,115,166,0.4434782608695652
1009,2,537,998,1535,0.5380761523046093
1009,3,1719,1159,2878,1.4831751509922346
1009,4,3158,1240,4398,2.546774193548387
1009,5,4598,1179,5777,3.8999151823579306
1010,1,17,701,718,0.024251069900142655
1011,1,307,93,400,3.3010752688172045
1011,2,2026,964,2990,2.1016597510373445
1012,1,17,983,1000,0.017293997965412006
1013,1,235,846,1081,0.2777777777777778
1013,2,1088,531,1619,2.048964218455744
1013,3,1747,742,2489,2.3544474393530996
1014,1,19,394,413,0.048223350253807105
1015,1,72,1176,1248,0.061224489795918366
1015,2,1250,1221,2471,1.0237510237510237
1015,3,2473,1242,3715,1.9911433172302737
1015,4,3717,810,4527,4.588888888888889
1016,1,99,54,153,1.8333333333333333
1016,2,1154,673,1827,1.714710252600297
1016,3,1873,429,2302,4.365967365967366
1016,4,2331,604,2935,3.859271523178808
1016,5,2970,557,3527,5.332136445242369
1016,6,3565,503,4068,7.087475149105368
1016,7,4089,507,4596,8.065088757396449
1016,8,4632,537,5169,8.625698324022347
1016,9,5203,298,5501,17.459731543624162
1016,10,5567,339,5906,16.421828908554573
1016,11,5998,331,6329,18.12084592145015
1016,12,6406,220,6626,29.118181818181817
1016,13,6656,291,6947,22.872852233676976
1016,14,6965,226,7191,30.81858407079646
1016,15,7221,158,7379,45.70253164556962
1016,16,7399,201,7600,36.81094527363184
1016,17,7672,179,7851,42.86033519553072
1017,1,841,818,1659,1.028117359413203
1017,2,1675,542,2217,3.0904059040590406
1017,3,2233,612,2845,3.6486928104575163
1017,4,2869,887,3756,3.234498308906426
1017,5,3772,870,4642,4.335632183908046
1017,6,4658,866,5524,5.378752886836028
1017,7,5540,433,5973,12.79445727482679
1017,8,5989,562,6551,10.65658362989324
1017,9,6581,631,7212,10.429477020602219
1017,10,7228,584,7812,12.376712328767123
1018,1,72,79,151,0.9113924050632911
1018,2,904,363,1267,2.490358126721763
1018,3,1287,65,1352,19.8
1018,4,3034,351,3385,8.643874643874645
1018,5,3404,53,3457,64.22641509433963
1018,6,3679,456,4135,8.067982456140351
1018,7,4155,457,4612,9.091903719912473
1018,8,6370,1038,7408,6.136801541425819
1019,1,70,245,315,0.2857142857142857
1019,2,361,242,603,1.4917355371900827
1019,3,656,391,1047,1.6777493606138107
1020,1,84,823,907,0.10206561360874848
1020,2,934,570,1504,1.6385964912280702
1021,1,13,286,299,0.045454545454545456
1021,2,321,331,652,0.9697885196374623
1021,3,667,373,1040,1.7882037533512065
1021,4,1050,817,1867,1.285189718482252
1021,5,1879,655,2534,2.8687022900763357
1022,1,200,371,571,0.5390835579514824
1022,2,585,490,1075,1.1938775510204083
1022,3,1091,383,1474,2.848563968668407
1022,4,1480,415,1895,3.566265060240964
1022,5,1950,308,2258,6.3311688311688314
1022,6,2290,440,2730,5.204545454545454
1023,1,19,473,492,0.040169133192389
1023,2,518,460,978,1.126086956521739
1023,3,997,347,1344,2.873198847262248
1023,4,1359,397,1756,3.4231738035264483
1023,5,1783,499,2282,3.5731462925851702
1023,6,2315,599,2914,3.8647746243739567
1023,7,2956,366,3322,8.076502732240437
1023,8,3349,508,3857,6.59251968503937
1024,1,33,541,574,0.06099815157116451
1025,1,1124,758,1882,1.482849604221636
1025,2,1902,769,2671,2.47334200260078
1026,1,114,32,146,3.5625
1026,2,818,304,1122,2.6907894736842106
1026,3,1154,275,1429,4.196363636363636
1026,4,1656,351,2007,4.717948717948718
1026,5,2019,28,2047,72.10714285714286
1026,6,2668,404,3072,6.603960396039604
1026,7,3092,393,3485,7.867684478371501
1026,8,3510,468,3978,7.5
1026,9,4021,431,4452,9.329466357308585
1026,10,4479,416,4895,10.766826923076923
1026,11,5198,442,5640,11.760180995475114
1026,12,5689,495,6184,11.492929292929293
1026,13,6198,49,6247,126.48979591836735
1027,1,1910,985,2895,1.9390862944162437
1027,2,2926,778,3704,3.7609254498714653
1027,3,3753,991,4744,3.7870837537840565
1028,1,24,786,810,0.030534351145038167
1028,2,1788,1176,2964,1.5204081632653061
1028,3,3218,392,3610,8.209183673469388
1028,4,3703,811,4514,4.5659679408138105
1028,5,4924,479,5403,10.279749478079331
1028,6,5814,1697,7511,3.4260459634649383
1029,1,29,612,641,0.04738562091503268
1029,2,663,525,1188,1.262857142857143
1029,3,1211,783,1994,1.5466155810983397
1029,4,2027,349,2376,5.808022922636103
1029,5,2401,353,2754,6.801699716713881
1029,6,2779,501,3280,5.54690618762475
1029,7,3329,282,3611,11.804964539007091
1029,8,3628,293,3921,12.382252559726963
1029,9,3944,167,4111,23.61676646706587
1029,10,4154,281,4435,14.782918149466193
1029,11,4502,387,4889,11.633074935400517
1029,12,4924,795,5719,6.1937106918239
1029,13,5744,781,6525,7.354673495518566
1029,14,6563,989,7552,6.635995955510617
1030,1,25,460,485,0.05434782608695652
1031,1,976,465,1441,2.098924731182796
1031,2,1512,465,1977,3.2516129032258063
1031,3,2004,407,2411,4.923832923832924
1031,4,2438,479,2917,5.0897703549060545
1032,1,9,831,840,0.010830324909747292
1032,2,853,465,1318,1.8344086021505377
1032,3,1328,888,2216,1.4954954954954955
1032,4,2229,832,3061,2.6790865384615383
1032,5,3104,983,4087,3.157680569684639
1032,6,4098,802,4900,5.109725685785536
1032,7,4914,978,5892,5.024539877300613
1032,8,5910,668,6578,8.847305389221557
1032,9,6591,684,7275,9.635964912280702
1033,1,167,331,498,0.5045317220543807
1033,2,539,321,860,1.679127725856698
1033,3,1092,709,1801,1.540197461212976
1033,4,1839,660,2499,2.786363636363636
1033,5,2628,913,3541,2.87842278203724
1033,6,3608,429,4037,8.41025641025641
1033,7,4137,676,4813,6.1198224852071
1033,8,4991,627,5618,7.960127591706539
1034,1,60,579,639,0.10362694300518134
1034,2,686,645,1331,1.0635658914728683
1034,3,1350,363,1713,3.71900826446281
1034,4,1729,542,2271,3.190036900369004
1034,5,2296,431,2727,5.327146171693736
1034,6,2747,524,3271,5.24236641221374
1034,7,3306,489,3795,6.7607361963190185
1034,8,3818,647,4465,5.901081916537867
1034,9,4500,513,5013,8.771929824561404
1034,10,5034,398,5432,12.64824120603015
1034,11,5491,358,5849,15.337988826815643
1034,12,5883,416,6299,14.141826923076923
1034,13,6321,350,6671,18.06
1034,14,6697,437,7134,15.324942791762014
1034,15,7156,107,7263,66.8785046728972
1034,16,7273,418,7691,17.39952153110048
1035,1,602,45,647,13.377777777777778
1035,2,655,65,720,10.076923076923077
1035,3,726,92,818,7.891304347826087
1035,4,848,130,978,6.523076923076923
1035,5,984,134,1118,7.343283582089552
1035,6,1124,126,1250,8.920634920634921
1035,7,1257,186,1443,6.758064516129032
1036,1,75,983,1058,0.0762970498474059
1036,2,1078,968,2046,1.1136363636363635
1037,1,34,803,837,0.04234122042341221
1038,1,349,643,992,0.5427682737169518
1039,1,180,736,916,0.24456521739130435
1039,2,951,684,1635,1.3903508771929824
1040,1,24,636,660,0.03773584905660377
1040,2,691,687,1378,1.0058224163027656
1040,3,1408,582,1990,2.4192439862542954
1040,4,2006,240,2246,8.358333333333333
1040,5,2272,532,2804,4.2706766917293235
1040,6,2826,740,3566,3.8189189189189188
1040,7,3574,390,3964,9.164102564102564
1040,8,3987,274,4261,14.55109489051095
1040,9,5059,305,5364,16.58688524590164
1040,10,5383,137,5520,39.29197080291971
1040,11,6170,85,6255,72.58823529411765
1040,12,6272,130,6402,48.246153846153845
1040,13,6453,225,6678,28.68
1040,14,6698,229,6927,29.24890829694323
1040,15,6963,183,7146,38.049180327868854
1040,16,7174,170,7344,42.2
1040,17,7360,179,7539,41.11731843575419
1040,18,7557,467,8024,16.182012847965737
1041,1,30,378,408,0.07936507936507936
1041,2,420,226,646,1.8584070796460177
1041,3,676,432,1108,1.5648148148148149
1041,4,1157,637,1794,1.816326530612245
1041,5,1813,381,2194,4.758530183727034
1041,6,2235,506,2741,4.41699604743083
1042,1,28,469,497,0.05970149253731343
1042,2,511,616,1127,0.8295454545454546
1042,3,1149,1013,2162,1.134254689042448
1042,4,2178,905,3083,2.4066298342541437
1042,5,3105,967,4072,3.2109617373319543
1042,6,4074,163,4237,24.993865030674847
1042,7,4282,812,5094,5.273399014778325
1042,8,5152,842,5994,6.118764845605701
1042,9,6006,592,6598,10.14527027027027
1042,10,6623,750,7373,8.830666666666668
1043,1,28,40,68,0.7
1043,2,500,3,503,166.66666666666666
1043,3,1280,3,1283,426.6666666666667
1043,4,1839,3,1842,613.0
1043,5,2616,3,2619,872.0
1043,6,2643,36,2679,73.41666666666667
1043,7,3372,445,3817,7.5775280898876405
1043,8,3838,30,3868,127.93333333333334
1043,9,4360,94,4454,46.38297872340426
1043,10,6356,3,6359,2118.6666666666665
1043,11,6447,318,6765,20.27358490566038
1043,12,6809,340,7149,20.026470588235295
1043,13,7180,318,7498,22.57861635220126
1043,14,7514,322,7836,23.335403726708076
1044,1,25,796,821,0.031407035175879394
1044,2,845,791,1636,1.06826801517067
1044,3,1657,454,2111,3.649779735682819
1044,4,2127,608,2735,3.4983552631578947
1045,1,284,2507,2791,0.11328280813721579
1046,1,49,184,233,0.266304347826087
1046,2,269,623,892,0.4317817014446228
1047,1,75,87,162,0.8620689655172413
1047,2,193,336,529,0.5744047619047619
1047,3,560,401,961,1.3965087281795512
1047,4,983,57,1040,17.24561403508772
1047,5,1062,56,1118,18.964285714285715
1047,6,1126,99,1225,11.373737373737374
1047,7,1240,304,1544,4.078947368421052
1047,8,1557,212,1769,7.34433962264151
1047,9,1784,281,2065,6.3487544483985765
1047,10,2082,125,2207,16.656
1047,11,2223,121,2344,18.371900826446282
1047,12,2364,161,2525,14.683229813664596
1047,13,2530,77,2607,32.857142857142854
1047,14,2649,515,3164,5.14368932038835
1047,15,3169,25,3194,126.76
1047,16,3200,81,3281,39.50617283950617
1047,17,3288,221,3509,14.877828054298643
1048,1,465,613,1078,0.7585644371941273
1049,1,206,23,229,8.956521739130435
1049,2,280,476,756,0.5882352941176471
1049,3,788,538,1326,1.4646840148698885
1049,4,1332,538,1870,2.475836431226766
1049,5,1877,544,2421,3.4503676470588234
1049,6,2427,557,2984,4.357271095152603
1049,7,2990,538,3528,5.557620817843866
1049,8,3534,558,4092,6.333333333333333
1049,9,4098,549,4647,7.46448087431694
1049,10,4653,528,5181,8.8125
1049,11,5187,549,5736,9.448087431693988
1049,12,5742,541,6283,10.613678373382625
1050,1,946,200,1146,4.73
1051,1,740,574,1314,1.289198606271777
1051,2,2568,878,3446,2.924829157175399
1051,3,3503,545,4048,6.427522935779817
1051,4,4060,790,4850,5.139240506329114
1052,1,2833,304,3137,9.319078947368421
1052,2,3154,451,3605,6.993348115299335
1052,3,6346,628,6974,10.105095541401274
1052,4,7002,309,7311,22.660194174757283
1052,5,7486,283,7769,26.452296819787986
1053,1,13,292,305,0.04452054794520548
1053,2,318,449,767,0.7082405345211581
1054,1,591,736,1327,0.8029891304347826
1055,1,935,987,1922,0.9473150962512664
1055,2,1924,1047,2971,1.8376313276026743
1055,3,2975,981,3956,3.032619775739042
1055,4,3958,990,4948,3.997979797979798
1056,1,16,512,528,0.03125
1056,2,549,509,1058,1.0785854616895874
1056,3,1066,418,1484,2.550239234449761
1056,4,1498,440,1938,3.4045454545454548
1057,1,18,559,577,0.03220035778175313
1057,2,590,268,858,2.201492537313433
1057,3,869,251,1120,3.462151394422311
1057,4,1135,298,1433,3.8087248322147653
1057,5,1447,445,1892,3.251685393258427
1058,1,58,328,386,0.17682926829268292
1058,2,1761,1180,2941,1.4923728813559323
1058,3,2981,602,3583,4.951827242524917
1058,4,3986,556,4542,7.169064748201439
1058,5,4554,343,4897,13.276967930029155
1058,6,4962,821,5783,6.043848964677223
1058,7,5857,1310,7167,4.470992366412213
1059,1,238,787,1025,0.30241423125794153
1059,2,1045,742,1787,1.408355795148248
1059,3,2053,855,2908,2.401169590643275
1059,4,3026,311,3337,9.729903536977492
1059,5,3455,390,3845,8.85897435897436
1059,6,3901,572,4473,6.81993006993007
1059,7,4500,433,4933,10.392609699769054
1059,8,5346,363,5709,14.727272727272727
1059,9,5733,290,6023,19.76896551724138
1059,10,6139,894,7033,6.866890380313199
1059,11,7104,871,7975,8.156142365097589
1060,1,15,48,63,0.3125
1060,2,75,44,119,1.7045454545454546
1060,3,164,151,315,1.086092715231788
1060,4,348,280,628,1.2428571428571429
1060,5,643,362,1005,1.776243093922652
1061,1,41,326,367,0.12576687116564417
1061,2,447,431,878,1.037122969837587
1062,1,460,402,862,1.144278606965174
1062,2,876,426,1302,2.056338028169014
1062,3,1366,566,1932,2.4134275618374557
1062,4,1970,605,2575,3.256198347107438
1062,5,2596,577,3173,4.499133448873484
1063,1,23,779,802,0.029525032092426188
1063,2,833,705,1538,1.1815602836879433
1063,3,1564,135,1699,11.585185185185185
1063,4,1731,144,1875,12.020833333333334
1063,5,1910,630,2540,3.0317460317460316
1063,6,2568,851,3419,3.017626321974148
1063,7,3439,107,3546,32.14018691588785
1063,8,3579,331,3910,10.812688821752266
1064,1,627,963,1590,0.6510903426791277
1064,2,1662,648,2310,2.564814814814815
1064,3,2349,802,3151,2.928927680798005
1064,4,3290,649,3939,5.0693374422187985
1064,5,3988,1021,5009,3.9059745347698334
1064,6,5093,1025,6118,4.968780487804878
1064,7,6126,271,6397,22.605166051660518
1064,8,6575,262,6837,25.095419847328245
1065,1,16,314,330,0.050955414012738856
1065,2,356,345,701,1.0318840579710145
1065,3,722,340,1062,2.123529411764706
1065,4,1287,325,1612,3.96
1066,1,24,976,1000,0.02459016393442623
1066,2,1005,575,1580,1.7478260869565216
1067,1,71,532,603,0.13345864661654136
1067,2,625,490,1115,1.2755102040816326
1068,1,61,405,466,0.1506172839506173
1068,2,486,601,1087,0.8086522462562395
1068,3,1227,370,1597,3.3162162162162163
1069,1,110,697,807,0.15781922525107603
1070,1,10,393,403,0.02544529262086514
1071,1,52,395,447,0.13164556962025317
1071,2,455,369,824,1.2330623306233062
1071,3,848,214,1062,3.9626168224299065
1071,4,1133,331,1464,3.4229607250755287
1071,5,1472,146,1618,10.082191780821917
1072,1,1061,375,1436,2.8293333333333335
1073,1,60,729,789,0.0823045267489712
1073,2,2065,619,2684,3.3360258481421647
1073,3,2712,566,3278,4.791519434628976
1073,4,4438,368,4806,12.059782608695652
1074,1,18,198,216,0.09090909090909091
1075,1,16,640,656,0.025
1076,1,23,633,656,0.036334913112164295
1076,2,692,600,1292,1.1533333333333333
1076,3,1305,349,1654,3.7392550143266474
1076,4,1692,473,2165,3.5771670190274842
1076,5,2189,310,2499,7.061290322580645
1076,6,2544,473,3017,5.378435517970401
1076,7,3021,44,3065,68.6590909090909
1077,1,1812,511,2323,3.5459882583170255
1077,2,2332,609,2941,3.8292282430213467
1078,1,663,366,1029,1.8114754098360655
1078,2,1059,530,1589,1.9981132075471697
1078,3,1613,410,2023,3.9341463414634146
1078,4,2048,403,2451,5.0818858560794045
1078,5,2625,67,2692,39.17910447761194
1078,6,2865,546,3411,5.247252747252747
1078,7,3428,271,3699,12.649446494464945
1078,8,3813,31,3844,123.0
1078,9,3865,705,4570,5.4822695035460995
1079,1,13,331,344,0.03927492447129909
1079,2,352,276,628,1.2753623188405796
1079,3,653,423,1076,1.5437352245862883
1079,4,1093,428,1521,2.553738317757009
1080,1,361,923,1284,0.39111592632719394
1080,2,1323,667,1990,1.9835082458770614
1080,3,2022,694,2716,2.913544668587896
1080,4,2776,504,3280,5.507936507936508
1080,5,3354,690,4044,4.860869565217391
1080,6,4123,489,4612,8.431492842535787
1080,7,4691,758,5449,6.188654353562005
1080,8,5521,689,6210,8.013062409288825
1080,9,6278,20,6298,313.9
1080,10,6364,644,7008,9.881987577639752
1080,11,7087,689,7776,10.285921625544267
1081,1,108,660,768,0.16363636363636364
1081,2,788,535,1323,1.4728971962616821
1081,3,1347,561,1908,2.4010695187165774
1081,4,1952,835,2787,2.3377245508982036
1081,5,2884,643,3527,4.485225505443235
1081,6,3718,587,4305,6.333901192504259
1081,7,4349,507,4856,8.577909270216962
1081,8,4893,462,5355,10.590909090909092
1081,9,5452,525,5977,10.384761904761906
1081,10,6010,497,6507,12.092555331991951
1081,11,6551,504,7055,12.998015873015873
1082,1,72,691,763,0.10419681620839363
1082,2,777,185,962,4.2
1082,3,978,131,1109,7.465648854961832
1082,4,1117,156,1273,7.160256410256411
1082,5,1282,226,1508,5.672566371681416
1082,6,1516,309,1825,4.906148867313916
1083,1,23,768,791,0.029947916666666668
1084,1,340,584,924,0.5821917808219178
1084,2,936,754,1690,1.2413793103448276
1085,1,94,648,742,0.14506172839506173
1085,2,791,668,1459,1.1841317365269461
1086,1,1258,836,2094,1.5047846889952152
1086,2,2096,790,2886,2.6531645569620252
1086,3,2888,570,3458,5.066666666666666
1086,4,3506,188,3694,18.648936170212767
1086,5,3717,701,4418,5.302425106990015
1086,6,4485,765,5250,5.862745098039215
1087,1,12,322,334,0.037267080745341616
1087,2,343,446,789,0.7690582959641256
1087,3,812,520,1332,1.5615384615384615
1088,1,65,359,424,0.181058495821727
1088,2,431,215,646,2.0046511627906978
1089,1,995,61,1056,16.311475409836067
1089,2,1192,218,1410,5.467889908256881
1089,3,1522,134,1656,11.35820895522388
1089,4,1660,138,1798,12.028985507246377
1090,1,129,76,205,1.6973684210526316
1090,2,246,68,314,3.6176470588235294
1090,3,395,75,470,5.266666666666667
1090,4,491,71,562,6.915492957746479
1090,5,574,65,639,8.830769230769231
1090,6,649,75,724,8.653333333333334
1090,7,852,91,943,9.362637362637363
1090,8,979,90,1069,10.877777777777778
1090,9,1121,93,1214,12.053763440860216
1090,10,1264,98,1362,12.89795918367347
1090,11,1381,81,1462,17.049382716049383
1090,12,1613,153,1766,10.542483660130719
1090,13,1784,30,1814,59.46666666666667
1090,14,1898,44,1942,43.13636363636363
1090,15,1951,23,1974,84.82608695652173
1090,16,2139,98,2237,21.8265306122449
1090,17,2264,133,2397,17.022556390977442
1090,18,2470,110,2580,22.454545454545453
1090,19,2650,125,2775,21.2
1090,20,2806,117,2923,23.982905982905983
1090,21,2934,148,3082,19.824324324324323
1091,1,668,281,949,2.377224199288256
1091,2,1041,1181,2222,0.8814563928873835
1091,3,2230,897,3127,2.4860646599777034
1091,4,3142,63,3205,49.87301587301587
1091,5,3213,69,3282,46.56521739130435
1092,1,209,662,871,0.3157099697885196
1092,2,926,726,1652,1.2754820936639117
1092,3,1849,665,2514,2.780451127819549
1092,4,2569,684,3253,3.7558479532163744
1092,5,3312,183,3495,18.098360655737704
1092,6,3690,628,4318,5.875796178343949
1092,7,4344,627,4971,6.92822966507177
1093,1,860,931,1791,0.9237379162191193
1093,2,1806,327,2133,5.522935779816514
1093,3,2456,370,2826,6.6378378378378375
1094,1,1168,362,1530,3.226519337016575
1095,1,82,1107,1189,0.07407407407407407
1095,2,1197,406,1603,2.9482758620689653
1096,1,64,385,449,0.16623376623376623
1096,2,492,309,801,1.5922330097087378
1096,3,826,264,1090,3.128787878787879
1096,4,1107,291,1398,3.804123711340206
1096,5,1408,243,1651,5.794238683127572
1096,6,1668,55,1723,30.327272727272728
1097,1,20,383,403,0.05221932114882506
1097,2,420,428,848,0.9813084112149533
1097,3,886,465,1351,1.9053763440860214
1097,4,1381,27,1408,51.148148148148145
1097,5,1451,538,1989,2.697026022304833
1097,6,2049,135,2184,15.177777777777777
1097,7,2209,130,2339,16.99230769230769
1097,8,2393,367,2760,6.520435967302452
1097,9,2850,399,3249,7.142857142857143
1097,10,3283,393,3676,8.353689567430026
1097,11,3710,372,4082,9.973118279569892
1097,12,4125,413,4538,9.987893462469733
1097,13,4580,317,4897,14.447949526813881
1097,14,4918,333,5251,14.76876876876877
1097,15,5283,140,5423,37.73571428571429
1097,16,5464,209,5673,26.14354066985646
1097,17,5701,331,6032,17.22356495468278
1097,18,6073,332,6405,18.292168674698797
1097,19,6412,367,6779,17.47138964577657
1097,20,6786,344,7130,19.726744186046513
1097,21,7137,466,7603,15.315450643776824
1098,1,26,532,558,0.04887218045112782
1098,2,572,128,700,4.46875
1098,3,721,587,1308,1.2282793867120954
1099,1,519,913,1432,0.5684556407447974
1099,2,1461,795,2256,1.8377358490566038
1099,3,2737,592,3329,4.6233108108108105
1100,1,25,848,873,0.0294811320754717
1100,2,915,651,1566,1.4055299539170507
1100,3,2024,494,2518,4.097165991902834
1100,4,2613,461,3074,5.668112798264642
1100,5,3105,734,3839,4.230245231607629
1100,6,3878,649,4527,5.975346687211094
1100,7,4904,525,5429,9.34095238095238
1100,8,5444,734,6178,7.416893732970027
1100,9,6206,832,7038,7.459134615384615
1100,10,7060,779,7839,9.062901155327342
1101,1,28,52,80,0.5384615384615384
1101,2,386,498,884,0.7751004016064257
1101,3,956,572,1528,1.6713286713286712
1101,4,1584,429,2013,3.6923076923076925
1101,5,2022,437,2459,4.627002288329519
1101,6,2469,33,2502,74.81818181818181
1101,7,2509,33,2542,76.03030303030303
1102,1,26,212,238,0.12264150943396226
1102,2,494,951,1445,0.519453207150368
1104,1,459,581,1040,0.7900172117039587
1104,2,1070,588,1658,1.8197278911564625
1104,3,1700,670,2370,2.537313432835821
1104,4,2407,644,3051,3.737577639751553
1104,5,3104,693,3797,4.479076479076479
1104,6,3872,760,4632,5.094736842105263
1104,7,4657,654,5311,7.120795107033639
1104,8,5324,639,5963,8.331768388106417
1104,9,6189,282,6471,21.9468085106383
1104,10,6503,565,7068,11.509734513274337
1104,11,7078,564,7642,12.549645390070921
1105,1,6,115,121,0.05217391304347826
1105,2,183,450,633,0.4066666666666667
1105,3,692,361,1053,1.9168975069252077
1105,4,1099,350,1449,3.14
1105,5,1500,357,1857,4.201680672268908
1105,6,1875,345,2220,5.434782608695652
1105,7,2299,397,2696,5.790931989924434
1106,1,24,322,346,0.07453416149068323
1106,2,381,433,814,0.8799076212471132
1106,3,891,1211,2102,0.7357555739058629
1106,4,2220,1199,3419,1.8515429524603837
1106,5,3435,914,4349,3.7582056892778994
1107,1,2,29,31,0.06896551724137931
1107,2,137,828,965,0.16545893719806765
1107,3,1005,355,1360,2.8309859154929575
1107,4,1398,608,2006,2.299342105263158
1107,5,2034,587,2621,3.4650766609880748
1107,6,2675,501,3176,5.339321357285429
1107,7,3359,837,4196,4.013142174432497
1107,8,4220,802,5022,5.261845386533666
1107,9,5135,636,5771,8.073899371069182
1107,10,5813,916,6729,6.346069868995633
1107,11,6796,510,7306,13.325490196078432
1107,12,7362,451,7813,16.323725055432373
1108,1,29,31,60,0.9354838709677419
1109,1,389,224,613,1.7366071428571428
1109,2,629,209,838,3.0095693779904304
1109,3,845,168,1013,5.029761904761905
1109,4,1027,196,1223,5.239795918367347
1109,5,1230,132,1362,9.318181818181818
1109,6,1376,205,1581,6.712195121951219
1109,7,1588,193,1781,8.2279792746114
1109,8,1997,277,2274,7.209386281588448
1109,9,2293,242,2535,9.475206611570249
1109,10,2580,271,2851,9.52029520295203
1109,11,2872,499,3371,5.755511022044089
1110,1,12,460,472,0.02608695652173913
1110,2,494,455,949,1.0857142857142856
1111,1,31,927,958,0.03344120819848975
1111,2,967,513,1480,1.884990253411306
1111,3,1496,400,1896,3.74
1111,4,1909,445,2354,4.289887640449439
1112,1,17,493,510,0.034482758620689655
1112,2,555,512,1067,1.083984375
1112,3,1170,520,1690,2.25
1112,4,1733,710,2443,2.4408450704225353
1113,1,22,626,648,0.03514376996805112
1113,2,665,487,1152,1.3655030800821355
1113,3,1175,233,1408,5.042918454935623
1113,4,1430,786,2216,1.8193384223918576
1113,5,2269,373,2642,6.083109919571045
1113,6,2677,443,3120,6.042889390519187
1114,1,234,962,1196,0.24324324324324326
1114,2,1198,891,2089,1.3445566778900113
1114,3,2091,978,3069,2.138036809815951
1114,4,3071,714,3785,4.3011204481792715
1114,5,3787,446,4233,8.491031390134529
1114,6,4235,570,4805,7.4298245614035086
1114,7,4807,612,5419,7.854575163398692
1115,1,111,420,531,0.2642857142857143
1115,2,540,550,1090,0.9818181818181818
1115,3,1098,393,1491,2.7938931297709924
1116,1,113,781,894,0.1446862996158771
1116,2,907,698,1605,1.2994269340974212
1117,1,97,682,779,0.14222873900293256
1117,2,825,653,1478,1.2633996937212864
1118,1,24,311,335,0.07717041800643087
1118,2,345,509,854,0.6777996070726916
1119,1,84,775,859,0.10838709677419354
1119,2,919,838,1757,1.0966587112171837
1119,3,1848,759,2607,2.4347826086956523
1120,1,2542,912,3454,2.787280701754386
1120,2,5902,534,6436,11.05243445692884
1121,1,2158,401,2559,5.381546134663342
1121,2,2563,384,2947,6.674479166666667
1121,3,2997,382,3379,7.845549738219895
1121,4,3381,353,3734,9.577903682719548
1121,5,3790,385,4175,9.844155844155845
1121,6,4177,347,4524,12.037463976945245
1121,7,4586,448,5034,10.236607142857142
1121,8,5056,350,5406,14.445714285714285
1121,9,5408,117,5525,46.22222222222222
1121,10,5545,176,5721,31.505681818181817
1122,1,281,2,283,140.5
1122,2,968,349,1317,2.773638968481375
1122,3,1319,146,1465,9.034246575342467
1122,4,1475,378,1853,3.9021164021164023
1122,5,1855,212,2067,8.75
1123,1,49,757,806,0.06472919418758256
1123,2,930,457,1387,2.035010940919037
1123,3,1530,411,1941,3.7226277372262775
1123,4,2009,347,2356,5.789625360230548
1123,5,2485,582,3067,4.269759450171821
1123,6,4419,347,4766,12.734870317002882
1123,7,5045,391,5436,12.902813299232736
1123,8,5585,309,5894,18.07443365695793
1123,9,5918,223,6141,26.53811659192825
1123,10,6207,217,6424,28.6036866359447
1123,11,6617,343,6960,19.291545189504372
1123,12,7059,807,7866,8.74721189591078
1124,1,537,880,1417,0.6102272727272727
1124,2,2011,929,2940,2.1646932185145316
1124,3,3541,898,4439,3.943207126948775
1125,1,14,63,77,0.2222222222222222
1125,2,181,649,830,0.27889060092449924
1125,3,889,682,1571,1.3035190615835777
1125,4,1622,892,2514,1.8183856502242153
1125,5,2525,873,3398,2.8923253150057273
1125,6,3418,960,4378,3.560416666666667
1125,7,4380,106,4486,41.320754716981135
1125,8,4505,911,5416,4.945115257958288
1125,9,5429,745,6174,7.287248322147651
1125,10,6184,713,6897,8.673211781206172
1125,11,6928,679,7607,10.203240058910161
1126,1,35,3,38,11.666666666666666
1127,1,75,1095,1170,0.0684931506849315
1127,2,1192,418,1610,2.851674641148325
1127,3,1652,485,2137,3.406185567010309
1127,4,2230,703,2933,3.1721194879089616
1127,5,2953,1046,3999,2.823135755258126
1127,6,4046,1021,5067,3.962781586679726
1127,7,5088,1000,6088,5.088
1127,8,6118,1019,7137,6.003925417075564
1128,1,59,501,560,0.11776447105788423
1128,2,568,501,1069,1.1337325349301397
1128,3,1075,457,1532,2.352297592997812
1128,4,1559,398,1957,3.9170854271356785
1128,5,1983,522,2505,3.7988505747126435
1128,6,2514,502,3016,5.00796812749004
1128,7,3035,588,3623,5.16156462585034
1128,8,3656,586,4242,6.238907849829351
1128,9,4271,206,4477,20.733009708737864
1128,10,4487,376,4863,11.933510638297872
1128,11,4900,427,5327,11.475409836065573
1128,12,5354,528,5882,10.140151515151516
1128,13,5889,519,6408,11.346820809248555
1128,14,6429,352,6781,18.264204545454547
1128,15,6808,421,7229,16.171021377672208
1128,16,7252,388,7640,18.690721649484537
1129,1,92,71,163,1.295774647887324
1130,1,484,631,1115,0.7670364500792393
1131,1,9,51,60,0.17647058823529413
1131,2,74,657,731,0.1126331811263318
1131,3,742,873,1615,0.849942726231386
1131,4,1622,998,2620,1.625250501002004
1132,1,405,386,791,1.049222797927461
1133,1,114,591,705,0.19289340101522842
1133,2,750,255,1005,2.9411764705882355
1134,1,32,485,517,0.06597938144329897
1134,2,535,800,1335,0.66875
1134,3,1360,735,2095,1.8503401360544218
1134,4,2119,690,2809,3.071014492753623
1134,5,2835,694,3529,4.085014409221902
1134,6,3533,46,3579,76.80434782608695
1135,1,30,831,861,0.036101083032490974
1136,1,103,119,222,0.865546218487395
1136,2,931,672,1603,1.3854166666666667
1136,3,1785,230,2015,7.760869565217392
1136,4,2445,477,2922,5.1257861635220126
1136,5,3094,161,3255,19.217391304347824
1136,6,3691,433,4124,8.524249422632794
1136,7,4129,433,4562,9.53579676674365
1137,1,55,391,446,0.14066496163682865
1137,2,463,398,861,1.1633165829145728
1138,1,171,874,1045,0.1956521739130435
1138,2,1088,832,1920,1.3076923076923077
1139,1,50,361,411,0.13850415512465375
1139,2,447,477,924,0.9371069182389937
1139,3,939,417,1356,2.2517985611510793
1139,4,1365,455,1820,3.0
1139,5,1826,408,2234,4.4754901960784315
1139,6,2240,383,2623,5.848563968668407
1140,1,27,794,821,0.03400503778337532
1140,2,831,531,1362,1.5649717514124293
1140,3,1386,226,1612,6.132743362831858
1140,4,3825,250,4075,15.3
1140,5,4276,126,4402,33.93650793650794
1140,6,4418,939,5357,4.705005324813632
1140,7,5365,879,6244,6.103526734926052
1140,8,6266,413,6679,15.171912832929783
1140,9,6706,305,7011,21.98688524590164
1140,10,7021,493,7514,14.241379310344827
1140,11,7522,405,7927,18.57283950617284
1141,1,30,884,914,0.033936651583710405
1141,2,926,465,1391,1.9913978494623656
1141,3,1405,418,1823,3.361244019138756
1141,4,1840,395,2235,4.658227848101266
1141,5,2250,680,2930,3.3088235294117645
1141,6,2942,466,3408,6.313304721030043
1142,1,83,766,849,0.10835509138381201
1143,1,11,232,243,0.04741379310344827
1143,2,273,92,365,2.967391304347826
1143,3,397,71,468,5.591549295774648
1143,4,498,435,933,1.1448275862068966
1143,5,936,206,1142,4.543689320388349
1143,6,1169,718,1887,1.628133704735376
1144,1,83,460,543,0.18043478260869567
1144,2,572,315,887,1.8158730158730159
1144,3,959,194,1153,4.943298969072165
1145,1,179,87,266,2.057471264367816
1145,2,302,126,428,2.3968253968253967
1145,3,488,380,868,1.2842105263157895
1145,4,912,647,1559,1.4095826893353942
1145,5,1565,238,1803,6.57563025210084
1146,1,29,861,890,0.03368176538908246
1146,2,897,64,961,14.015625
1146,3,977,102,1079,9.57843137254902
1146,4,1096,683,1779,1.6046852122986823
1146,5,1800,916,2716,1.965065502183406
1147,1,1432,904,2336,1.584070796460177
1148,1,1252,268,1520,4.6716417910447765
1149,1,48,26,74,1.8461538461538463
1149,2,78,63,141,1.2380952380952381
1149,3,249,127,376,1.9606299212598426
1149,4,388,111,499,3.4954954954954953
1149,5,556,26,582,21.384615384615383
1149,6,731,71,802,10.295774647887324
1149,7,822,158,980,5.2025316455696204
1149,8,990,57,1047,17.36842105263158
1150,1,21,302,323,0.0695364238410596
1150,2,331,240,571,1.3791666666666667
1151,1,114,240,354,0.475
1151,2,389,282,671,1.3794326241134751
1151,3,673,358,1031,1.8798882681564246
1151,4,1033,9,1042,114.77777777777777
1151,5,1058,380,1438,2.7842105263157895
1151,6,1440,247,1687,5.82995951417004
1151,7,1689,31,1720,54.483870967741936
1151,8,1748,427,2175,4.0936768149882905
1151,9,2177,334,2511,6.517964071856287
1151,10,2531,337,2868,7.510385756676558
1151,11,2870,389,3259,7.377892030848329
1151,12,3261,264,3525,12.352272727272727
1151,13,3542,3,3545,1180.6666666666667
1152,1,38,806,844,0.04714640198511166
1152,2,893,470,1363,1.9
1152,3,1394,612,2006,2.2777777777777777
1152,4,2083,842,2925,2.473871733966746
1152,5,3489,1175,4664,2.9693617021276597
1152,6,4681,449,5130,10.425389755011135
1152,7,5153,1164,6317,4.426975945017182
1153,1,113,532,645,0.212406015037594
1154,1,27,639,666,0.04225352112676056
1154,2,681,9,690,75.66666666666667
1154,3,1139,631,1770,1.8050713153724247
1154,4,1986,616,2602,3.2240259740259742
1155,1,11,409,420,0.02689486552567237
1155,2,538,447,985,1.203579418344519
1155,3,1061,55,1116,19.29090909090909
1155,4,1135,197,1332,5.761421319796955
1155,5,1343,350,1693,3.837142857142857
1155,6,1707,540,2247,3.161111111111111
1155,7,2278,189,2467,12.052910052910052
1156,1,88,785,873,0.11210191082802548
1156,2,949,560,1509,1.6946428571428571
1156,3,1606,755,2361,2.1271523178807947
1156,4,2373,659,3032,3.600910470409712
1156,5,3044,740,3784,4.113513513513514
1156,6,3923,560,4483,7.005357142857143
1156,7,4578,761,5339,6.015768725361367
1156,8,5346,851,6197,6.282021151586369
1156,9,6204,785,6989,7.903184713375796
1156,10,7169,461,7630,15.550976138828634
1157,1,114,637,751,0.17896389324960754
1158,1,25,1003,1028,0.024925224327018942
1158,2,1036,737,1773,1.4056987788331072
1158,3,1793,843,2636,2.1269276393831555
1158,4,2658,885,3543,3.0033898305084747
1159,1,132,577,709,0.22876949740034663
1160,1,8,212,220,0.03773584905660377
1160,2,229,254,483,0.9015748031496063
1161,1,3655,624,4279,5.857371794871795
1161,2,4311,41,4352,105.14634146341463
1161,3,4367,185,4552,23.605405405405406
1162,1,28,336,364,0.08333333333333333
1162,2,2829,657,3486,4.30593607305936
1162,3,6150,446,6596,13.789237668161435
1162,4,6633,560,7193,11.844642857142857
1162,5,7242,583,7825,12.421955403087479
1163,1,501,30,531,16.7
1164,1,13,360,373,0.03611111111111111
1164,2,379,329,708,1.1519756838905775
1164,3,728,331,1059,2.199395770392749
1164,4,1067,279,1346,3.824372759856631
1164,5,1363,318,1681,4.286163522012578
1165,1,3438,305,3743,11.272131147540984
1165,2,3765,346,4111,10.88150289017341
1165,3,4136,601,4737,6.881863560732113
1165,4,4789,617,5406,7.761750405186386
1165,5,5428,449,5877,12.089086859688196
1165,6,5948,609,6557,9.766830870279145
1165,7,6603,841,7444,7.8513674197384065
1166,1,119,209,328,0.569377990430622
1166,2,360,307,667,1.1726384364820848
1166,3,680,139,819,4.892086330935252
1166,4,835,324,1159,2.5771604938271606
1166,5,1195,99,1294,12.070707070707071
1166,6,1311,457,1768,2.8687089715536107
1166,7,1776,237,2013,7.493670886075949
1166,8,2028,190,2218,10.673684210526316
1167,1,12,303,315,0.039603960396039604
1167,2,330,431,761,0.765661252900232
1167,3,775,721,1496,1.0748959778085991
1167,4,1511,623,2134,2.4253611556982344
1167,5,2153,400,2553,5.3825
1167,6,2570,468,3038,5.4914529914529915
1167,7,3068,814,3882,3.769041769041769
1167,8,3890,264,4154,14.734848484848484
1168,1,49,158,207,0.310126582278481
1168,2,259,420,679,0.6166666666666667
1168,3,691,436,1127,1.584862385321101
1168,4,1134,432,1566,2.625
1169,1,641,165,806,3.8848484848484848
1169,2,1305,201,1506,6.492537313432836
1170,1,21,692,713,0.030346820809248554
1170,2,724,543,1267,1.3333333333333333
1170,3,1275,285,1560,4.473684210526316
1170,4,1596,591,2187,2.700507614213198
1170,5,2207,458,2665,4.818777292576419
1170,6,2688,475,3163,5.658947368421052
1171,1,13,858,871,0.015151515151515152
1171,2,917,992,1909,0.9243951612903226
1171,3,1911,653,2564,2.9264931087289434
1171,4,2601,944,3545,2.7552966101694913
1171,5,3547,249,3796,14.244979919678714
1171,6,3871,505,4376,7.665346534653465
1171,7,4448,501,4949,8.878243512974052
1171,8,4984,641,5625,7.775351014040561
1171,9,5720,505,6225,11.326732673267326
1171,10,6271,591,6862,10.61082910321489
1171,11,6886,539,7425,12.775510204081632
1171,12,7457,43,7500,173.41860465116278
1172,1,45,847,892,0.053128689492325853
1172,2,895,949,1844,0.9430979978925185
1172,3,1847,398,2245,4.64070351758794
1172,4,2263,359,2622,6.303621169916434
1172,5,2828,732,3560,3.8633879781420766
1172,6,3669,933,4602,3.932475884244373
1172,7,4640,310,4950,14.96774193548387
1172,8,4980,894,5874,5.570469798657718
1172,9,5897,262,6159,22.50763358778626
1172,10,6197,75,6272,82.62666666666667
1173,1,53,50,103,1.06
1173,2,118,636,754,0.18553459119496854
1173,3,776,62,838,12.516129032258064
1173,4,847,313,1160,2.7060702875399363
1174,1,242,896,1138,0.2700892857142857
1174,2,1141,147,1288,7.761904761904762
1174,3,1323,919,2242,1.439608269858542
1175,1,1247,755,2002,1.651655629139073
1175,2,2009,349,2358,5.756446991404012
1175,3,2370,974,3344,2.433264887063655
1175,4,3346,195,3541,17.15897435897436
1176,1,18,512,530,0.03515625
1176,2,552,523,1075,1.0554493307839388
1176,3,1089,484,1573,2.25
1176,4,1592,541,2133,2.942698706099815
1176,5,2150,586,2736,3.6689419795221845
1177,1,6,17,23,0.35294117647058826
1177,2,253,327,580,0.7737003058103975
1177,3,603,282,885,2.1382978723404253
1177,4,920,311,1231,2.9581993569131835
1177,5,1249,326,1575,3.831288343558282
1177,6,1582,333,1915,4.7507507507507505
1177,7,2137,322,2459,6.636645962732919
1177,8,2466,261,2727,9.448275862068966
1177,9,2880,335,3215,8.597014925373134
1177,10,3221,357,3578,9.022408963585434
1177,11,3585,302,3887,11.870860927152318
1177,12,3952,304,4256,13.0
1177,13,4322,329,4651,13.136778115501519
1177,14,4685,257,4942,18.229571984435797
1177,15,4988,311,5299,16.038585209003216
1177,16,5342,3,5345,1780.6666666666667
1178,1,630,1194,1824,0.5276381909547738
1178,2,1838,405,2243,4.538271604938272
1179,1,23,779,802,0.029525032092426188
1179,2,823,933,1756,0.8821007502679529
1180,1,298,669,967,0.445440956651719
1181,1,22,311,333,0.0707395498392283
1182,1,103,596,699,0.17281879194630873
1183,1,259,872,1131,0.29701834862385323
1184,1,356,43,399,8.279069767441861
1184,2,422,170,592,2.4823529411764707
1185,1,75,712,787,0.10533707865168539
1185,2,841,179,1020,4.698324022346369
1185,3,1100,732,1832,1.5027322404371584
1185,4,1913,674,2587,2.8382789317507418
1185,5,2665,660,3325,4.037878787878788
1185,6,3340,672,4012,4.970238095238095
1185,7,4050,798,4848,5.075187969924812
1185,8,4883,822,5705,5.940389294403893
1186,1,310,101,411,3.0693069306930694
1187,1,33,634,667,0.052050473186119876
1188,1,600,845,1445,0.7100591715976331
1188,2,1453,27,1480,53.81481481481482
1188,3,2755,845,3600,3.260355029585799
1188,4,3608,146,3754,24.71232876712329
1189,1,21,596,617,0.03523489932885906
1189,2,652,973,1625,0.6700924974306269
1189,3,1627,771,2398,2.1102464332036317
1189,4,2417,220,2637,10.986363636363636
1189,5,2678,951,3629,2.8159831756046265
1189,6,3654,800,4454,4.5675
1189,7,4508,937,5445,4.811099252934898
1189,8,5459,132,5591,41.35606060606061
1189,9,5600,266,5866,21.05263157894737
1189,10,6051,945,6996,6.4031746031746035
1189,11,7009,131,7140,53.50381679389313
1189,12,7302,117,7419,62.41025641025641
1189,13,7434,227,7661,32.74889867841409
1189,14,7672,333,8005,23.03903903903904
1190,1,49,118,167,0.4152542372881356
1190,2,1723,416,2139,4.141826923076923
1190,3,2170,179,2349,12.12290502793296
1190,4,2358,328,2686,7.189024390243903
1190,5,2723,109,2832,24.98165137614679
1190,6,2865,353,3218,8.11614730878187
1190,7,3235,178,3413,18.174157303370787
1190,8,3426,229,3655,14.960698689956331
1190,9,3682,381,4063,9.664041994750656
1190,10,4071,189,4260,21.53968253968254
1190,11,4278,259,4537,16.517374517374517
1190,12,4553,228,4781,19.969298245614034
1190,13,4798,233,5031,20.59227467811159
1190,14,5039,258,5297,19.531007751937985
1190,15,5321,164,5485,32.44512195121951
1190,16,5494,228,5722,24.096491228070175
1190,17,5732,249,5981,23.02008032128514
1190,18,5997,320,6317,18.740625
1190,19,6358,328,6686,19.384146341463413
1190,20,6701,414,7115,16.185990338164252
1190,21,7148,274,7422,26.087591240875913
1190,22,7435,272,7707,27.334558823529413
1190,23,7741,260,8001,29.773076923076925
1191,1,147,69,216,2.130434782608696
1191,2,259,84,343,3.0833333333333335
1191,3,358,87,445,4.114942528735632
1191,4,505,284,789,1.778169014084507
1191,5,979,313,1292,3.1277955271565494
1191,6,1459,256,1715,5.69921875
1192,1,31,652,683,0.04754601226993865
1193,1,122,73,195,1.6712328767123288
1193,2,269,67,336,4.014925373134329
1193,3,437,69,506,6.333333333333333
1193,4,512,199,711,2.5728643216080402
1193,5,743,150,893,4.953333333333333
1193,6,1407,339,1746,4.150442477876106
1193,7,1916,72,1988,26.61111111111111
1193,8,2142,78,2220,27.46153846153846
1193,9,2224,91,2315,24.439560439560438
1193,10,2320,98,2418,23.6734693877551
1193,11,2421,142,2563,17.049295774647888
1193,12,2703,99,2802,27.303030303030305
1193,13,3123,34,3157,91.8529411764706
1193,14,3503,37,3540,94.67567567567568
1193,15,4275,57,4332,75.0
1193,16,5203,62,5265,83.91935483870968
1193,17,5949,64,6013,92.953125
1193,18,6772,75,6847,90.29333333333334
1194,1,2447,503,2950,4.864811133200795
1194,2,2958,412,3370,7.179611650485437
1194,3,3378,387,3765,8.728682170542635
1194,4,3773,473,4246,7.976744186046512
1194,5,4254,262,4516,16.236641221374047
1195,1,11,720,731,0.015277777777777777
1195,2,759,742,1501,1.022911051212938
1195,3,1512,974,2486,1.5523613963039014
1195,4,2502,633,3135,3.9526066350710902
1195,5,3155,669,3824,4.715994020926757
1195,6,3833,325,4158,11.793846153846154
1195,7,4176,839,5015,4.977353992848629
1195,8,5035,673,5708,7.481426448736999
1195,9,5714,3,5717,1904.6666666666667
1196,1,574,392,966,1.4642857142857142
1197,1,207,11,218,18.818181818181817
1197,2,272,134,406,2.029850746268657
1197,3,487,193,680,2.523316062176166
1197,4,716,164,880,4.365853658536586
1197,5,906,17,923,53.294117647058826
1198,1,31,274,305,0.11313868613138686
1198,2,342,604,946,0.5662251655629139
1198,3,1088,627,1715,1.7352472089314195
1198,4,1749,593,2342,2.9494097807757167
1198,5,2374,373,2747,6.3646112600536195
1199,1,43,543,586,0.07918968692449356
1199,2,601,667,1268,0.9010494752623688
1200,1,18,573,591,0.031413612565445025
1200,2,661,1133,1794,0.5834068843777581
1200,3,1850,1101,2951,1.6802906448683015
1200,4,2960,670,3630,4.417910447761194
1200,5,3690,694,4384,5.31700288184438
1200,6,4446,588,5034,7.561224489795919
1200,7,5101,393,5494,12.979643765903308
1200,8,5524,1173,6697,4.709292412617221
1200,9,6708,1105,7813,6.070588235294117
1201,1,11,745,756,0.01476510067114094
1201,2,766,111,877,6.900900900900901
1201,3,5391,76,5467,70.9342105263158
1202,1,14,1036,1050,0.013513513513513514
1202,2,1072,1048,2120,1.0229007633587786
1202,3,2141,706,2847,3.0325779036827196
1202,4,2870,860,3730,3.3372093023255816
1202,5,3744,855,4599,4.378947368421053
1202,6,4611,880,5491,5.239772727272728
1202,7,5503,957,6460,5.750261233019854
1202,8,6486,983,7469,6.598168870803662
1203,1,60,1158,1218,0.05181347150259067
1203,2,1221,891,2112,1.3703703703703705
1204,1,200,564,764,0.3546099290780142
1205,1,38,982,1020,0.038696537678207736
1205,2,1033,718,1751,1.4387186629526463
1205,3,1771,506,2277,3.5
1205,4,2337,186,2523,12.564516129032258
1205,5,2554,414,2968,6.169082125603865
1205,6,2976,36,3012,82.66666666666667
1205,7,3041,573,3614,5.307155322862129
1205,8,3665,280,3945,13.089285714285714
1205,9,3963,365,4328,10.857534246575343
1205,10,4348,565,4913,7.695575221238938
1205,11,4946,415,5361,11.918072289156626
1205,12,5386,184,5570,29.27173913043478
1205,13,5580,382,5962,14.607329842931938
1205,14,5977,347,6324,17.22478386167147
1205,15,6366,382,6748,16.664921465968586
1205,16,6807,292,7099,23.311643835616437
1205,17,7109,233,7342,30.510729613733904
1205,18,7362,208,7570,35.39423076923077
1206,1,49,118,167,0.4152542372881356
1206,2,1723,416,2139,4.141826923076923
1206,3,2170,179,2349,12.12290502793296
1206,4,2358,328,2686,7.189024390243903
1206,5,2723,109,2832,24.98165137614679
1206,6,2865,353,3218,8.11614730878187
1206,7,3235,178,3413,18.174157303370787
1206,8,3426,229,3655,14.960698689956331
1206,9,3682,381,4063,9.664041994750656
1206,10,4071,189,4260,21.53968253968254
1206,11,4278,259,4537,16.517374517374517
1206,12,4553,228,4781,19.969298245614034
1206,13,4798,233,5031,20.59227467811159
1206,14,5039,258,5297,19.531007751937985
1206,15,5321,164,5485,32.44512195121951
1206,16,5494,228,5722,24.096491228070175
1206,17,5732,249,5981,23.02008032128514
1206,18,5997,320,6317,18.740625
1206,19,6358,328,6686,19.384146341463413
1206,20,6701,414,7115,16.185990338164252
1206,21,7148,274,7422,26.087591240875913
1206,22,7435,272,7707,27.334558823529413
1206,23,7741,260,8001,29.773076923076925
1207,1,35,143,178,0.24475524475524477
1207,2,732,1179,1911,0.6208651399491094
1207,3,1919,1217,3136,1.5768282662284305
1207,4,3172,1000,4172,3.172
1207,5,4180,916,5096,4.563318777292577
1207,6,5149,1180,6329,4.363559322033899
1207,7,6337,819,7156,7.7374847374847375
1207,8,7337,227,7564,32.3215859030837
1207,9,7614,381,7995,19.984251968503937
1208,1,27,676,703,0.03994082840236687
1208,2,727,458,1185,1.5873362445414847
1208,3,1203,588,1791,2.045918367346939
1208,4,1801,682,2483,2.6407624633431084
1209,1,1201,227,1428,5.290748898678414
1209,2,1431,269,1700,5.319702602230484
1209,3,1703,315,2018,5.406349206349207
1209,4,2021,293,2314,6.897610921501706
1209,5,2317,281,2598,8.245551601423488
1209,6,2601,255,2856,10.2
1209,7,2859,278,3137,10.284172661870503
1209,8,3140,265,3405,11.849056603773585
1209,9,3408,227,3635,15.013215859030836
1209,10,3638,256,3894,14.2109375
1209,11,3897,259,4156,15.046332046332047
1209,12,4159,273,4432,15.234432234432234
1209,13,4435,293,4728,15.136518771331058
1209,14,4731,331,5062,14.293051359516616
1209,15,5065,234,5299,21.645299145299145
1209,16,5302,290,5592,18.282758620689656
1209,17,5595,269,5864,20.799256505576206
1209,18,5867,296,6163,19.820945945945947
1209,19,6166,282,6448,21.865248226950353
1209,20,6451,281,6732,22.95729537366548
1209,21,6735,289,7024,23.304498269896193
1209,22,7027,277,7304,25.36823104693141
1209,23,7307,284,7591,25.72887323943662
1209,24,7594,313,7907,24.261980830670925
1210,1,28,186,214,0.15053763440860216
1211,1,42,557,599,0.07540394973070018
1211,2,619,162,781,3.8209876543209877
1212,1,50,859,909,0.05820721769499418
1212,2,911,351,1262,2.5954415954415953
1213,1,46,883,929,0.052095130237825596
1213,2,944,538,1482,1.754646840148699
1213,3,1489,617,2106,2.413290113452188
1213,4,2119,383,2502,5.532637075718016
1214,1,952,911,1863,1.0450054884742042
1215,1,80,560,640,0.14285714285714285
1215,2,689,663,1352,1.0392156862745099
1216,1,367,502,869,0.7310756972111554
1216,2,903,1007,1910,0.8967229394240318
1216,3,2098,200,2298,10.49
1216,4,2306,491,2797,4.696537678207739
1216,5,2804,314,3118,8.929936305732484
1216,6,3131,1061,4192,2.9509896324222433
1216,7,4224,487,4711,8.673511293634498
1217,1,1750,585,2335,2.9914529914529915
1218,1,33,354,387,0.09322033898305085
1218,2,626,535,1161,1.1700934579439253
1218,3,1209,862,2071,1.402552204176334
1218,4,2080,506,2586,4.1106719367588935
1218,5,2604,823,3427,3.164034021871203
1218,6,3559,282,3841,12.620567375886525
1218,7,3990,559,4549,7.137745974955277
1218,8,4699,689,5388,6.820029027576197
1218,9,5559,545,6104,10.2
1218,10,6276,498,6774,12.602409638554217
1218,11,6811,600,7411,11.351666666666667
1218,12,7484,439,7923,17.047835990888384
1219,1,1437,292,1729,4.921232876712328
1220,1,58,192,250,0.3020833333333333
1221,1,43,507,550,0.08481262327416174
1221,2,574,529,1103,1.0850661625708884
1221,3,1122,488,1610,2.2991803278688523
1221,4,1623,953,2576,1.7030430220356767
1222,1,32,350,382,0.09142857142857143
1223,1,141,182,323,0.7747252747252747
1223,2,333,582,915,0.5721649484536082
1223,3,921,552,1473,1.6684782608695652
1223,4,1497,611,2108,2.4500818330605565
1223,5,2118,527,2645,4.018975332068311
1224,1,786,739,1525,1.0635994587280109
1225,1,89,793,882,0.11223203026481715
1225,2,891,552,1443,1.6141304347826086
1225,3,1495,850,2345,1.7588235294117647
1226,1,227,1042,1269,0.21785028790786948
1226,2,1277,826,2103,1.5460048426150121
1226,3,2137,374,2511,5.713903743315508
1227,1,79,627,706,0.12599681020733652
1227,2,806,790,1596,1.0202531645569621
1227,3,1655,791,2446,2.092288242730721
1227,4,2603,825,3428,3.1551515151515153
1227,5,3430,825,4255,4.157575757575757
1227,6,4299,833,5132,5.160864345738295
1227,7,5142,234,5376,21.974358974358974
1227,8,5540,398,5938,13.919597989949748
1227,9,5952,612,6564,9.72549019607843
1227,10,6625,410,7035,16.158536585365855
1227,11,7042,856,7898,8.226635514018692
1227,12,7903,22,7925,359.22727272727275
1228,1,147,188,335,0.7819148936170213
1228,2,435,333,768,1.3063063063063063
1228,3,990,452,1442,2.190265486725664
1228,4,1659,402,2061,4.126865671641791
1229,1,11,657,668,0.0167427701674277
1229,2,691,636,1327,1.0864779874213837
1230,1,340,642,982,0.5295950155763239
1231,1,600,353,953,1.6997167138810199
1231,2,970,401,1371,2.4189526184538654
1231,3,1386,339,1725,4.088495575221239
1231,4,1742,381,2123,4.572178477690288
1231,5,2140,265,2405,8.075471698113208
1232,1,38,560,598,0.06785714285714285
1232,2,609,3,612,203.0
1232,3,638,738,1376,0.8644986449864499
1233,1,1092,124,1216,8.806451612903226
1233,2,1228,440,1668,2.790909090909091
1233,3,1685,573,2258,2.9406631762652706
1233,4,2275,777,3052,2.9279279279279278
1233,5,3068,678,3746,4.525073746312684
1234,1,6,67,73,0.08955223880597014
1234,2,101,184,285,0.5489130434782609
1234,3,294,501,795,0.5868263473053892
1235,1,36,386,422,0.09326424870466321
1235,2,424,209,633,2.028708133971292
1235,3,635,95,730,6.684210526315789
1235,4,732,218,950,3.3577981651376145
1236,1,2296,249,2545,9.220883534136545
1236,2,2577,678,3255,3.8008849557522124
1236,3,3341,862,4203,3.8758700696055683
1236,4,4359,964,5323,4.521784232365145
1236,5,5378,702,6080,7.660968660968661
1237,1,28,469,497,0.05970149253731343
1237,2,511,616,1127,0.8295454545454546
1237,3,1149,1013,2162,1.134254689042448
1237,4,2178,905,3083,2.4066298342541437
1237,5,3105,967,4072,3.2109617373319543
1237,6,4074,163,4237,24.993865030674847
1237,7,4282,812,5094,5.273399014778325
1237,8,5152,842,5994,6.118764845605701
1237,9,6006,592,6598,10.14527027027027
1237,10,6623,750,7373,8.830666666666668
1238,1,44,504,548,0.0873015873015873
1238,2,559,426,985,1.312206572769953
1238,3,996,243,1239,4.098765432098766
1239,1,166,861,1027,0.19279907084785133
1239,2,1042,644,1686,1.6180124223602483
1240,1,530,823,1353,0.6439854191980559
1240,2,1380,190,1570,7.2631578947368425
1241,1,33,484,517,0.06818181818181818
1242,1,31,605,636,0.0512396694214876
1242,2,956,709,1665,1.3483779971791254
1242,3,1677,510,2187,3.288235294117647
1242,4,2202,271,2473,8.125461254612546
1242,5,2486,188,2674,13.22340425531915
1242,6,2700,249,2949,10.843373493975903
1242,7,2970,352,3322,8.4375
1243,1,46,356,402,0.12921348314606743
1243,2,434,242,676,1.7933884297520661
1243,3,685,348,1033,1.9683908045977012
1244,1,37,852,889,0.04342723004694836
1245,1,477,41,518,11.634146341463415
1245,2,825,37,862,22.2972972972973
1245,3,1190,39,1229,30.512820512820515
1245,4,1578,41,1619,38.48780487804878
1245,5,5214,145,5359,35.95862068965517
1245,6,6790,19,6809,357.36842105263156
1246,1,144,453,597,0.31788079470198677
1246,2,620,820,1440,0.7560975609756098
1246,3,1467,509,1976,2.882121807465619
1247,1,146,923,1069,0.1581798483206934
1248,1,73,637,710,0.11459968602825746
1248,2,724,984,1708,0.7357723577235772
1248,3,1719,255,1974,6.741176470588235
1249,1,162,290,452,0.5586206896551724
1249,2,459,387,846,1.186046511627907
1249,3,957,876,1833,1.0924657534246576
1249,4,1854,875,2729,2.1188571428571428
1249,5,2749,874,3623,3.145308924485126
1249,6,3694,834,4528,4.429256594724221
1249,7,4570,266,4836,17.18045112781955
1249,8,4918,309,5227,15.915857605177994
1249,9,5279,526,5805,10.036121673003802
1250,1,15,39,54,0.38461538461538464
1250,2,75,26,101,2.8846153846153846
1250,3,503,529,1032,0.9508506616257089
1251,1,69,326,395,0.2116564417177914
1251,2,401,255,656,1.572549019607843
1251,3,690,273,963,2.5274725274725274
1252,1,30,377,407,0.07957559681697612
1252,2,412,359,771,1.1476323119777159
1252,3,776,379,1155,2.0474934036939314
1252,4,1160,394,1554,2.9441624365482233
1252,5,1563,202,1765,7.737623762376238
1253,1,481,604,1085,0.7963576158940397
1254,1,80,415,495,0.1927710843373494
1254,2,553,360,913,1.5361111111111112
1254,3,963,556,1519,1.7320143884892085
1255,1,21,596,617,0.03523489932885906
1255,2,652,973,1625,0.6700924974306269
1255,3,1627,771,2398,2.1102464332036317
1255,4,2417,220,2637,10.986363636363636
1255,5,2678,951,3629,2.8159831756046265
1255,6,3654,800,4454,4.5675
1255,7,4508,937,5445,4.811099252934898
1255,8,5459,132,5591,41.35606060606061
1255,9,5600,266,5866,21.05263157894737
1255,10,6051,945,6996,6.4031746031746035
1256,1,19,97,116,0.1958762886597938
1256,2,192,477,669,0.4025157232704403
1256,3,684,659,1343,1.0379362670713201
1256,4,1361,623,1984,2.1845906902086676
1256,5,2001,331,2332,6.045317220543807
1257,1,205,197,402,1.0406091370558375
1257,2,523,212,735,2.4669811320754715
1257,3,878,106,984,8.283018867924529
1258,1,739,203,942,3.6403940886699506
1258,2,953,101,1054,9.435643564356436
1258,3,1066,162,1228,6.580246913580247
1258,4,1239,261,1500,4.747126436781609
1258,5,1505,69,1574,21.81159420289855
1258,6,1591,92,1683,17.293478260869566
1259,1,8,26,34,0.3076923076923077
1259,2,68,428,496,0.1588785046728972
1259,3,776,839,1615,0.9249106078665077
1259,4,1622,236,1858,6.872881355932203
1259,5,2491,93,2584,26.78494623655914
1259,6,2607,837,3444,3.1146953405017923
1259,7,3513,274,3787,12.821167883211679
1259,8,4014,829,4843,4.841978287092883
1259,9,4885,837,5722,5.836320191158901
1259,10,5734,522,6256,10.984674329501916
1259,11,6271,162,6433,38.70987654320987
1259,12,6472,66,6538,98.06060606060606
1259,13,7018,709,7727,9.898448519040903
1259,14,7738,82,7820,94.36585365853658
1260,1,27,54,81,0.5
1260,2,234,543,777,0.430939226519337
1260,3,2779,772,3551,3.599740932642487
1260,4,3563,27,3590,131.96296296296296
1260,5,4056,462,4518,8.779220779220779
1260,6,4532,804,5336,5.63681592039801
1260,7,6058,929,6987,6.520990312163617
1260,8,7054,858,7912,8.221445221445222
1261,1,98,346,444,0.2832369942196532
1261,2,481,139,620,3.460431654676259
1262,1,73,489,562,0.1492842535787321
1262,2,580,483,1063,1.2008281573498965
1262,3,1175,62,1237,18.951612903225808
1262,4,1260,146,1406,8.63013698630137
1262,5,1414,68,1482,20.794117647058822
1262,6,1505,83,1588,18.132530120481928
1262,7,1596,77,1673,20.727272727272727
1262,8,1700,130,1830,13.076923076923077
1262,9,1865,98,1963,19.03061224489796
1262,10,2076,580,2656,3.579310344827586
1263,1,78,406,484,0.1921182266009852
1263,2,506,280,786,1.8071428571428572
1263,3,803,174,977,4.614942528735632
1264,1,341,483,824,0.7060041407867494
1265,1,186,498,684,0.37349397590361444
1265,2,731,276,1007,2.648550724637681
1265,3,1055,841,1896,1.2544589774078478
1265,4,1955,1008,2963,1.939484126984127
1266,1,6,44,50,0.13636363636363635
1266,2,1559,357,1916,4.366946778711484
1266,3,1922,285,2207,6.743859649122807
1266,4,2221,323,2544,6.876160990712075
1267,1,14,466,480,0.030042918454935622
1267,2,922,478,1400,1.9288702928870294
1267,3,1880,523,2403,3.5946462715105163
1267,4,2845,489,3334,5.81799591002045
1268,1,175,283,458,0.6183745583038869
1268,2,485,405,890,1.1975308641975309
1268,3,962,348,1310,2.764367816091954
1268,4,1337,411,1748,3.2530413625304138
1268,5,1778,425,2203,4.183529411764706
1268,6,2253,225,2478,10.013333333333334
1268,7,2494,608,3102,4.1019736842105265
1269,1,49,101,150,0.48514851485148514
1269,2,165,158,323,1.0443037974683544
1269,3,339,163,502,2.079754601226994
1269,4,532,478,1010,1.112970711297071
1269,5,1019,525,1544,1.940952380952381
1269,6,1559,82,1641,19.01219512195122
1269,7,3001,499,3500,6.014028056112225
1269,8,7309,59,7368,123.88135593220339
1269,9,7383,30,7413,246.1
1270,1,20,482,502,0.04149377593360996
1270,2,528,830,1358,0.636144578313253
1270,3,1372,494,1866,2.777327935222672
1270,4,1882,560,2442,3.3607142857142858
1271,1,672,55,727,12.218181818181819
1272,1,45,895,940,0.05027932960893855
1272,2,943,444,1387,2.123873873873874
1272,3,1464,600,2064,2.44
1272,4,2125,619,2744,3.4329563812600967
1272,5,2840,658,3498,4.316109422492401
1272,6,3547,505,4052,7.023762376237624
1272,7,4117,617,4734,6.672609400324149
1272,8,4810,594,5404,8.097643097643097
1272,9,5488,560,6048,9.8
1272,10,6106,582,6688,10.491408934707904
1272,11,6759,597,7356,11.321608040201005
1272,12,7399,505,7904,14.651485148514851
1273,1,790,597,1387,1.323283082077052
1273,2,3331,1826,5157,1.8242059145673604
1274,1,309,328,637,0.9420731707317073
1274,2,789,334,1123,2.3622754491017965
1274,3,1462,335,1797,4.364179104477612
1274,4,2249,331,2580,6.794561933534744
1274,5,2591,331,2922,7.827794561933535
1274,6,2933,322,3255,9.108695652173912
1274,7,3628,250,3878,14.512
1274,8,4048,264,4312,15.333333333333334
1274,9,4334,336,4670,12.898809523809524
1274,10,4710,300,5010,15.7
1274,11,5443,338,5781,16.10355029585799
1274,12,5831,310,6141,18.809677419354838
1274,13,6162,332,6494,18.56024096385542
1274,14,6497,74,6571,87.79729729729729
1274,15,7196,317,7513,22.70031545741325
1274,16,7535,370,7905,20.364864864864863
1275,1,1265,242,1507,5.2272727272727275
1275,2,1518,230,1748,6.6
1275,3,1772,117,1889,15.145299145299145
1276,1,413,462,875,0.8939393939393939
1276,2,941,105,1046,8.961904761904762
1276,3,1112,111,1223,10.018018018018019
1276,4,1257,180,1437,6.983333333333333
1276,5,1460,125,1585,11.68
1277,1,124,569,693,0.2179261862917399
1278,1,31,233,264,0.13304721030042918
1279,1,11,56,67,0.19642857142857142
1279,2,90,188,278,0.4787234042553192
1279,3,432,628,1060,0.6878980891719745
1279,4,1099,528,1627,2.081439393939394
1279,5,1653,583,2236,2.8353344768439106
1279,6,2268,668,2936,3.395209580838323
1279,7,2964,311,3275,9.530546623794212
1279,8,3295,499,3794,6.603206412825651
1279,9,3838,602,4440,6.3754152823920265
1279,10,4479,732,5211,6.118852459016393
1279,11,5229,797,6026,6.560853199498118
1280,1,145,20,165,7.25
1280,2,198,28,226,7.071428571428571
1280,3,357,54,411,6.611111111111111
1280,4,519,57,576,9.105263157894736
1280,5,663,236,899,2.809322033898305
1280,6,966,401,1367,2.4089775561097255
1280,7,1423,232,1655,6.133620689655173
1280,8,1673,447,2120,3.742729306487696
1280,9,2182,433,2615,5.0392609699769055
1280,10,2652,59,2711,44.94915254237288
1280,11,2777,83,2860,33.45783132530121
1280,12,2966,116,3082,25.56896551724138
1280,13,3163,345,3508,9.168115942028985
1280,14,3518,61,3579,57.67213114754098
1280,15,3594,380,3974,9.457894736842105
1280,16,4042,186,4228,21.731182795698924
1280,17,4344,333,4677,13.045045045045045
1280,18,4786,352,5138,13.596590909090908
1280,19,5289,313,5602,16.89776357827476
1280,20,5766,362,6128,15.92817679558011
1280,21,6159,83,6242,74.20481927710843
1280,22,6381,338,6719,18.87869822485207
1280,23,6727,205,6932,32.81463414634146
1280,24,6973,677,7650,10.299852289512556
1280,25,7659,73,7732,104.91780821917808
1281,1,14,650,664,0.021538461538461538
1281,2,677,280,957,2.4178571428571427
1282,1,590,2454,3044,0.2404237978810106
1282,2,3438,2188,5626,1.5712979890310785
1283,1,33,433,466,0.07621247113163972
1283,2,481,230,711,2.091304347826087
1283,3,728,197,925,3.6954314720812182
1283,4,951,363,1314,2.6198347107438016
1283,5,1354,390,1744,3.471794871794872
1283,6,1756,496,2252,3.5403225806451615
1283,7,2274,600,2874,3.79
1283,8,2909,464,3373,6.269396551724138
1284,1,20,109,129,0.1834862385321101
1284,2,259,340,599,0.7617647058823529
1284,3,607,365,972,1.663013698630137
1284,4,1018,345,1363,2.9507246376811596
1284,5,1371,358,1729,3.829608938547486
1284,6,1737,364,2101,4.771978021978022
1284,7,2109,276,2385,7.641304347826087
1285,1,54,229,283,0.23580786026200873
1285,2,294,184,478,1.5978260869565217
1285,3,489,244,733,2.0040983606557377
1285,4,741,288,1029,2.5729166666666665
1285,5,1037,298,1335,3.4798657718120807
1285,6,1343,353,1696,3.8045325779036827
1285,7,1704,319,2023,5.341692789968652
1285,8,2031,340,2371,5.973529411764706
1285,9,2379,343,2722,6.9358600583090375
1285,10,2730,354,3084,7.711864406779661
1285,11,3092,399,3491,7.74937343358396
1285,12,3499,422,3921,8.291469194312796
1286,1,3590,81,3671,44.32098765432099
1286,2,3738,183,3921,20.42622950819672
1286,3,3946,328,4274,12.03048780487805
1287,1,119,653,772,0.18223583460949463
1287,2,820,168,988,4.880952380952381
1287,3,1001,212,1213,4.721698113207547
1287,4,1287,81,1368,15.88888888888889
1287,5,1442,323,1765,4.464396284829721
1287,6,1772,26,1798,68.15384615384616
1287,7,1882,221,2103,8.515837104072398
1287,8,2156,62,2218,34.774193548387096
1287,9,2331,129,2460,18.069767441860463
1287,10,2496,80,2576,31.2
1287,11,2602,51,2653,51.01960784313726
1287,12,2678,78,2756,34.333333333333336
1287,13,2765,73,2838,37.87671232876713
1287,14,2921,110,3031,26.554545454545455
1287,15,3051,76,3127,40.14473684210526
1287,16,3133,14,3147,223.78571428571428
1287,17,3174,40,3214,79.35
1287,18,3238,103,3341,31.436893203883496
1287,19,3367,54,3421,62.351851851851855
1287,20,3432,19,3451,180.6315789473684
1287,21,3693,551,4244,6.702359346642468
1287,22,4272,57,4329,74.94736842105263
1287,23,4359,64,4423,68.109375
1287,24,4440,103,4543,43.10679611650485
1287,25,4564,243,4807,18.781893004115226
1287,26,4821,90,4911,53.56666666666667
1287,27,5051,179,5230,28.217877094972067
1287,28,5257,148,5405,35.520270270270274
1287,29,5430,261,5691,20.804597701149426
1287,30,5700,102,5802,55.88235294117647
1287,31,5830,93,5923,62.68817204301075
1287,32,5930,60,5990,98.83333333333333
1287,33,6007,90,6097,66.74444444444444
1287,34,6118,113,6231,54.14159292035398
1287,35,6300,98,6398,64.28571428571429
1287,36,6416,77,6493,83.32467532467533
1287,37,6516,162,6678,40.22222222222222
1287,38,6704,243,6947,27.588477366255145
1287,39,6960,640,7600,10.875
1288,1,30,502,532,0.05976095617529881
1288,2,541,628,1169,0.8614649681528662
1289,1,56,729,785,0.07681755829903979
1290,1,973,624,1597,1.5592948717948718
1290,2,1704,689,2393,2.4731494920174164
1290,3,2431,826,3257,2.943099273607748
1291,1,177,77,254,2.2987012987012987
1291,2,268,258,526,1.0387596899224807
1291,3,565,211,776,2.677725118483412
1292,1,390,386,776,1.0103626943005182
1293,1,11,440,451,0.025
1293,2,605,913,1518,0.6626506024096386
1293,3,1535,964,2499,1.592323651452282
1293,4,2516,978,3494,2.572597137014315
1293,5,3525,983,4508,3.585961342828077
1293,6,4539,991,5530,4.580221997981837
1293,7,5564,992,6556,5.608870967741935
1293,8,6588,961,7549,6.855359001040583
1294,1,21,562,583,0.037366548042704624
1294,2,597,734,1331,0.8133514986376021
1294,3,1339,613,1952,2.1843393148450243
1294,4,1956,671,2627,2.9150521609538003
1294,5,2631,660,3291,3.9863636363636363
1294,6,3317,442,3759,7.504524886877828
1294,7,3771,611,4382,6.171849427168576
1294,8,4422,528,4950,8.375
1294,9,4972,382,5354,13.015706806282722
1294,10,5427,399,5826,13.601503759398497
1294,11,5954,636,6590,9.361635220125786
1294,12,6648,655,7303,10.149618320610687
1294,13,7372,694,8066,10.622478386167147
1295,1,284,590,874,0.48135593220338985
1295,3,876,66,942,13.272727272727273
1295,4,1017,316,1333,3.2183544303797467
1295,5,1343,265,1608,5.067924528301887
1295,6,1616,276,1892,5.855072463768116
1295,7,1992,340,2332,5.858823529411764
1295,8,2349,522,2871,4.5
1295,9,2972,567,3539,5.241622574955908
1295,10,3561,229,3790,15.550218340611353
1295,11,3829,334,4163,11.464071856287426
1295,84,4170,271,4441,15.387453874538746
1295,86,4482,247,4729,18.14574898785425
1295,87,4736,300,5036,15.786666666666667
1295,88,5051,516,5567,9.78875968992248
1296,1,556,438,994,1.269406392694064
1297,1,27,475,502,0.056842105263157895
1298,1,24,765,789,0.03137254901960784
1299,1,24,163,187,0.147239263803681
1300,1,2873,34,2907,84.5
1300,2,5379,130,5509,41.37692307692308
1300,3,6524,52,6576,125.46153846153847
1300,4,6595,475,7070,13.884210526315789
1300,5,7105,480,7585,14.802083333333334
1300,6,7851,156,8007,50.32692307692308
1301,1,31,453,484,0.0684326710816777
1301,2,489,443,932,1.1038374717832957
1302,1,542,561,1103,0.966131907308378
1302,2,1149,329,1478,3.492401215805471
1303,1,3746,955,4701,3.9225130890052355
1303,2,4715,816,5531,5.778186274509804
1303,3,5828,1011,6839,5.764589515331355
1304,1,1083,70,1153,15.471428571428572
1304,2,3613,48,3661,75.27083333333333
1304,3,6521,831,7352,7.847172081829122
1305,1,86,694,780,0.1239193083573487
1305,2,848,9,857,94.22222222222223
1305,3,876,6,882,146.0
1305,4,959,435,1394,2.2045977011494253
1305,5,1413,463,1876,3.0518358531317493
1305,6,1964,401,2365,4.897755610972569
1305,7,2450,393,2843,6.234096692111959
1305,8,2928,289,3217,10.131487889273357
1305,9,3302,515,3817,6.411650485436893
1305,10,3855,464,4319,8.308189655172415
1305,11,4404,592,4996,7.4391891891891895
1305,12,5081,406,5487,12.514778325123153
1305,13,5502,326,5828,16.87730061349693
1305,14,6007,670,6677,8.965671641791046
1305,15,6772,771,7543,8.783398184176395
1306,1,31,194,225,0.15979381443298968
1306,2,239,929,1168,0.2572658772874058
1306,3,1220,933,2153,1.307609860664523
1306,4,2161,685,2846,3.154744525547445
1306,5,2869,949,3818,3.0231822971549
1307,1,91,22,113,4.136363636363637
1307,2,117,47,164,2.4893617021276597
1307,3,175,59,234,2.9661016949152543
1307,4,242,32,274,7.5625
1307,5,299,270,569,1.1074074074074074
1307,6,596,51,647,11.686274509803921
1307,7,662,67,729,9.880597014925373
1307,8,738,49,787,15.061224489795919
1307,9,798,50,848,15.96
1307,10,850,70,920,12.142857142857142
1307,11,927,51,978,18.176470588235293
1307,12,988,351,1339,2.814814814814815
1307,13,1357,366,1723,3.7076502732240435
1308,1,1003,760,1763,1.319736842105263
1308,2,1832,475,2307,3.856842105263158
1308,3,2940,500,3440,5.88
1308,4,3896,314,4210,12.40764331210191
1308,5,4419,79,4498,55.936708860759495
1308,6,4515,200,4715,22.575
1308,7,4873,322,5195,15.133540372670808
1308,8,5226,640,5866,8.165625
1308,9,5974,332,6306,17.99397590361446
1308,10,6326,362,6688,17.475138121546962
1308,11,6758,422,7180,16.01421800947867
1309,1,60,89,149,0.6741573033707865
1309,2,1370,561,1931,2.442067736185383
1309,3,1943,1057,3000,1.8382213812677388
1309,4,3003,332,3335,9.045180722891565
1310,1,12,818,830,0.014669926650366748
1310,2,845,935,1780,0.9037433155080213
1311,1,74,449,523,0.16481069042316257
1311,2,645,199,844,3.241206030150754
1311,3,970,219,1189,4.429223744292237
1311,4,1215,251,1466,4.840637450199203
1311,5,1516,617,2133,2.4570502431118313
1311,6,2144,182,2326,11.780219780219781
1311,7,2350,274,2624,8.576642335766424
1311,8,2677,195,2872,13.728205128205127
1311,9,2907,476,3383,6.107142857142857
1312,1,179,320,499,0.559375
1313,1,35,1055,1090,0.03317535545023697
1314,1,277,431,708,0.642691415313225
1314,2,715,479,1194,1.4926931106471817
1314,3,1197,438,1635,2.732876712328767
1314,4,1638,508,2146,3.2244094488188977
1314,5,2148,556,2704,3.8633093525179856
1315,1,74,625,699,0.1184
1315,2,734,498,1232,1.4738955823293172
1315,3,1274,655,1929,1.9450381679389313
1315,4,1977,651,2628,3.0368663594470044
1315,5,2697,657,3354,4.105022831050229
1315,6,3401,683,4084,4.979502196193265
1315,7,4234,268,4502,15.798507462686567
1315,8,4532,620,5152,7.309677419354839
1315,9,5264,535,5799,9.839252336448599
1315,10,5873,565,6438,10.394690265486725
1315,11,6479,626,7105,10.349840255591054
1315,12,7215,740,7955,9.75
1316,1,19,332,351,0.0572289156626506
1316,2,409,1017,1426,0.40216322517207476
1316,3,1528,728,2256,2.098901098901099
1316,4,2284,737,3021,3.0990502035278156
1317,1,745,845,1590,0.8816568047337278
1317,2,1598,868,2466,1.8410138248847927
1317,3,2474,878,3352,2.8177676537585423
1317,4,3360,732,4092,4.590163934426229
1318,1,518,145,663,3.5724137931034483
1318,2,703,713,1416,0.9859747545582047
1318,3,1536,842,2378,1.824228028503563
1318,4,2470,315,2785,7.841269841269841
1318,5,2830,285,3115,9.929824561403509
1318,6,3189,362,3551,8.80939226519337
1318,7,3792,854,4646,4.4402810304449645
1318,8,4675,946,5621,4.941860465116279
1319,1,16,545,561,0.029357798165137616
1319,2,580,851,1431,0.681551116333725
1319,3,1433,325,1758,4.409230769230769
1319,4,1788,375,2163,4.768
1319,5,2175,656,2831,3.3155487804878048
1319,6,2862,667,3529,4.290854572713643
1319,7,3541,728,4269,4.864010989010989
1319,8,4284,352,4636,12.170454545454545
1319,9,4647,428,5075,10.857476635514018
1319,10,5093,418,5511,12.18421052631579
1320,1,48,321,369,0.14953271028037382
1320,2,414,333,747,1.2432432432432432
1320,3,764,410,1174,1.8634146341463416
1321,1,142,352,494,0.4034090909090909
1322,1,19,567,586,0.03350970017636684
1322,2,608,261,869,2.3295019157088124
1322,3,884,242,1126,3.652892561983471
1322,4,1137,448,1585,2.5379464285714284
1322,5,1618,408,2026,3.965686274509804
1323,1,42,460,502,0.09130434782608696
1323,2,507,616,1123,0.823051948051948
1323,3,1128,662,1790,1.70392749244713
1323,4,1795,569,2364,3.154657293497364
1324,1,1635,486,2121,3.3641975308641974
1325,1,30,955,985,0.031413612565445025
1325,2,1193,1589,2782,0.7507866582756451
1325,3,3008,1233,4241,2.4395782643957826
1325,4,4463,968,5431,4.610537190082645
1325,5,5521,757,6278,7.29326287978864
1325,6,6358,613,6971,10.37194127243067
1325,7,7101,504,7605,14.089285714285714
1326,1,301,858,1159,0.3508158508158508
1327,1,105,95,200,1.105263157894737
1327,2,736,610,1346,1.2065573770491804
1327,3,1766,330,2096,5.351515151515152
1327,4,2448,416,2864,5.884615384615385
1327,5,3240,247,3487,13.117408906882591
1327,6,3864,207,4071,18.666666666666668
1327,7,4144,468,4612,8.854700854700855
1327,8,4720,670,5390,7.044776119402985
1327,9,5501,107,5608,51.41121495327103
1327,10,6520,181,6701,36.02209944751381
1327,11,6741,93,6834,72.48387096774194
1327,12,7709,185,7894,41.67027027027027
1328,1,119,783,902,0.15197956577266922
1328,2,910,526,1436,1.7300380228136882
1328,3,1560,775,2335,2.0129032258064514
1328,4,2343,727,3070,3.22283356258597
1328,5,3200,839,4039,3.8140643623361146
1328,6,4047,799,4846,5.065081351689612
1328,7,4854,256,5110,18.9609375
1328,8,5239,756,5995,6.9298941798941796
1328,9,6003,808,6811,7.429455445544554
1328,10,6944,790,7734,8.78987341772152
1329,1,61,362,423,0.1685082872928177
1329,2,460,614,1074,0.749185667752443
1329,3,1097,712,1809,1.5407303370786516
1329,4,1864,664,2528,2.8072289156626504
1329,5,2566,409,2975,6.273838630806846
1329,6,3002,617,3619,4.86547811993517
1329,7,3628,479,4107,7.5741127348643005
1329,8,4118,507,4625,8.122287968441814
1329,9,4641,798,5439,5.815789473684211
1329,10,5453,623,6076,8.752808988764045
1330,1,124,189,313,0.656084656084656
1331,1,34,161,195,0.2111801242236025
1332,1,203,312,515,0.6506410256410257
1332,2,824,12,836,68.66666666666667
1332,3,930,188,1118,4.946808510638298
1332,4,1226,244,1470,5.024590163934426
1332,5,1494,272,1766,5.492647058823529
1332,6,1870,320,2190,5.84375
1332,7,2200,361,2561,6.094182825484765
1332,8,2584,311,2895,8.308681672025724
1333,1,17,104,121,0.16346153846153846
1334,1,157,882,1039,0.17800453514739228
1334,2,2248,909,3157,2.473047304730473
1335,1,111,296,407,0.375
1335,2,408,316,724,1.2911392405063291
1335,3,725,325,1050,2.230769230769231
1335,4,1051,430,1481,2.444186046511628
1335,5,1482,336,1818,4.410714285714286
1335,6,1819,257,2076,7.0778210116731515
1335,7,2077,651,2728,3.1904761904761907
1335,8,2729,284,3013,9.609154929577464
1335,9,3014,384,3398,7.848958333333333
1335,10,3399,86,3485,39.52325581395349
1335,11,3486,272,3758,12.816176470588236
1335,12,3759,352,4111,10.678977272727273
1335,13,4112,337,4449,12.201780415430267
1335,14,4450,194,4644,22.938144329896907
1335,15,4645,282,4927,16.47163120567376
1335,16,4928,286,5214,17.23076923076923
1335,17,5215,302,5517,17.2682119205298
1335,18,5536,515,6051,10.749514563106796
1335,19,6052,247,6299,24.502024291497975
1335,20,6300,200,6500,31.5
1335,21,6501,268,6769,24.257462686567163
1335,22,6770,292,7062,23.184931506849313
1335,23,7063,348,7411,20.29597701149425
1335,24,7426,380,7806,19.542105263157893
1336,1,19,332,351,0.0572289156626506
1336,2,409,1017,1426,0.40216322517207476
1336,3,1528,741,2269,2.0620782726045883
1337,1,17,922,939,0.01843817787418655
1338,1,64,1000,1064,0.064
1339,1,376,376,752,1.0
1340,1,83,840,923,0.0988095238095238
1340,2,953,754,1707,1.2639257294429709
1340,3,1762,905,2667,1.9469613259668508
1340,4,2681,206,2887,13.014563106796116
1340,5,2926,1125,4051,2.600888888888889
1340,6,4100,1127,5227,3.6379769299023956
1340,7,5243,194,5437,27.02577319587629
1340,8,5475,384,5859,14.2578125
1341,1,12,449,461,0.026726057906458798
1341,2,474,481,955,0.9854469854469855
1341,3,981,508,1489,1.9311023622047243
1341,4,1529,204,1733,7.495098039215686
1341,5,1754,179,1933,9.798882681564246
1341,6,1955,518,2473,3.7741312741312742
1341,7,2543,324,2867,7.848765432098766
1341,8,2922,251,3173,11.641434262948207
1342,1,128,831,959,0.15403128760529483
1342,2,1041,662,1703,1.5725075528700907
1342,3,1755,738,2493,2.3780487804878048
1342,4,2522,624,3146,4.041666666666667
1342,5,3171,500,3671,6.342
1343,1,7,139,146,0.050359712230215826
1344,1,13,327,340,0.039755351681957186
1344,2,356,317,673,1.1230283911671923
1344,3,682,325,1007,2.0984615384615384
1344,4,1009,302,1311,3.3410596026490067
1344,5,1328,250,1578,5.312
1344,6,1611,298,1909,5.406040268456376
1344,7,1936,322,2258,6.012422360248447
1344,8,2260,228,2488,9.912280701754385
1344,9,2523,318,2841,7.933962264150943
1344,10,2874,370,3244,7.767567567567568
1344,11,3385,402,3787,8.42039800995025
1344,12,3813,385,4198,9.903896103896104
1345,1,31,683,714,0.04538799414348463
1346,1,2121,389,2510,5.4524421593830334
1346,2,2548,492,3040,5.178861788617886
1346,3,4377,462,4839,9.474025974025974
1346,4,4855,450,5305,10.78888888888889
1347,1,40,858,898,0.046620046620046623
1348,1,1189,1028,2217,1.156614785992218
1348,2,2223,426,2649,5.21830985915493
1348,3,2663,511,3174,5.211350293542075
1348,4,3238,659,3897,4.91350531107739
1348,5,3912,1035,4947,3.7797101449275363
1348,6,4961,603,5564,8.227197346600331
1348,7,5841,564,6405,10.356382978723405
1348,8,6453,1004,7457,6.427290836653387
1348,9,7466,496,7962,15.05241935483871
1349,1,30,49,79,0.6122448979591837
1349,2,254,676,930,0.3757396449704142
1349,3,963,154,1117,6.253246753246753
1349,4,1135,732,1867,1.5505464480874316
1350,1,167,817,984,0.204406364749082
1350,2,1039,632,1671,1.643987341772152
1350,3,1708,650,2358,2.6276923076923078
1350,4,2436,802,3238,3.0374064837905235
1350,5,3368,490,3858,6.873469387755102
1350,6,3960,500,4460,7.92
1350,7,4485,444,4929,10.10135135135135
1350,8,5021,605,5626,8.299173553719008
1350,9,5665,310,5975,18.274193548387096
1350,10,6001,845,6846,7.101775147928994
1351,1,218,116,334,1.8793103448275863
1352,1,55,825,880,0.06666666666666667
1352,2,989,526,1515,1.8802281368821292
1352,3,1544,447,1991,3.4541387024608503
1352,4,2040,811,2851,2.5154130702836004
1352,5,2868,53,2921,54.113207547169814
1352,6,2981,289,3270,10.314878892733564
1352,7,3334,10,3344,333.4
1352,8,3548,15,3563,236.53333333333333
1352,9,3641,709,4350,5.1354019746121295
1352,10,4444,666,5110,6.672672672672673
1352,11,5223,655,5878,7.974045801526717
1352,12,5978,560,6538,10.675
1352,13,6561,313,6874,20.961661341853034
1352,14,6946,668,7614,10.39820359281437
1353,1,16,258,274,0.06201550387596899
1353,2,296,186,482,1.5913978494623655
1353,3,500,162,662,3.0864197530864197
1353,4,682,323,1005,2.111455108359133
1354,1,175,498,673,0.3514056224899598
1355,1,95,538,633,0.17657992565055763
1355,2,728,537,1265,1.355679702048417
1355,3,1362,590,1952,2.3084745762711862
1355,4,1989,919,2908,2.1643090315560394
1356,1,18,623,641,0.028892455858747994
1356,2,713,905,1618,0.7878453038674034
1357,1,12,641,653,0.0187207488299532
1357,2,655,571,1226,1.1471103327495622
1357,3,1232,664,1896,1.855421686746988
1358,1,1279,461,1740,2.774403470715835
1358,2,1967,667,2634,2.949025487256372
1359,1,112,526,638,0.21292775665399238
1359,2,645,338,983,1.9082840236686391
1359,3,1004,454,1458,2.211453744493392
1360,1,210,262,472,0.8015267175572519
1360,2,493,677,1170,0.7282127031019202
1360,3,1193,178,1371,6.702247191011236
1360,4,1385,368,1753,3.7635869565217392
1360,5,1763,154,1917,11.448051948051948
1360,6,1926,154,2080,12.506493506493506
1360,7,2100,157,2257,13.375796178343949
1360,8,2275,195,2470,11.666666666666666
1360,9,2481,318,2799,7.80188679245283
1360,10,2806,199,3005,14.100502512562814
1360,11,3032,304,3336,9.973684210526315
1361,1,17,207,224,0.0821256038647343
1361,2,262,393,655,0.6666666666666666
1361,3,687,652,1339,1.053680981595092
1361,4,1365,747,2112,1.8273092369477912
1361,5,2132,771,2903,2.7652399481193255
1361,6,2935,493,3428,5.953346855983773
1361,7,3444,449,3893,7.6703786191536745
1361,8,3932,441,4373,8.91609977324263
1361,9,4536,175,4711,25.92
1362,1,42,366,408,0.11475409836065574
1362,2,434,476,910,0.9117647058823529
1362,3,950,610,1560,1.5573770491803278
1363,1,384,669,1053,0.5739910313901345
1363,2,1216,692,1908,1.7572254335260116
1363,3,2077,787,2864,2.639135959339263
1363,4,3001,834,3835,3.5983213429256593
1363,5,3875,746,4621,5.194369973190349
1363,6,4718,468,5186,10.081196581196581
1363,7,5534,822,6356,6.732360097323601
1363,8,6833,698,7531,9.789398280802292
1364,1,483,333,816,1.4504504504504505
1365,1,232,50,282,4.64
1365,2,345,85,430,4.0588235294117645
1365,3,469,314,783,1.4936305732484076
1365,4,975,189,1164,5.158730158730159
1365,5,1206,118,1324,10.220338983050848
1365,6,1347,86,1433,15.662790697674419
1365,7,1463,94,1557,15.563829787234043
1365,8,1612,164,1776,9.829268292682928
1365,9,1915,137,2052,13.978102189781023
1365,10,2096,79,2175,26.531645569620252
1365,11,2284,399,2683,5.724310776942356
1365,12,2747,169,2916,16.254437869822485
1365,13,2996,328,3324,9.134146341463415
1365,14,3372,260,3632,12.96923076923077
1365,15,3737,104,3841,35.93269230769231
1365,16,3908,276,4184,14.159420289855072
1366,1,326,924,1250,0.3528138528138528
1366,2,1252,839,2091,1.4922526817640047
1367,1,207,11,218,18.818181818181817
1367,2,272,177,449,1.536723163841808
1367,3,486,165,651,2.9454545454545453
1367,4,698,194,892,3.597938144329897
1367,5,923,224,1147,4.120535714285714
1367,6,1157,460,1617,2.515217391304348
1367,7,1625,361,1986,4.501385041551247
1368,1,43,65,108,0.6615384615384615
1368,2,113,54,167,2.0925925925925926
1368,3,235,384,619,0.6119791666666666
1368,4,621,165,786,3.7636363636363637
1368,5,799,345,1144,2.315942028985507
1368,6,1161,316,1477,3.6740506329113924
1368,7,1554,344,1898,4.517441860465116
1368,8,1915,290,2205,6.603448275862069
1368,9,2231,377,2608,5.917771883289125
1368,10,2630,390,3020,6.743589743589744
1368,11,3053,321,3374,9.510903426791277
1369,1,411,488,899,0.8422131147540983
1370,1,111,684,795,0.16228070175438597
1370,2,815,289,1104,2.820069204152249
1370,3,1118,267,1385,4.187265917602996
1370,4,1418,169,1587,8.390532544378699
1370,5,1596,393,1989,4.061068702290076
1370,6,2008,673,2681,2.9836552748885588
1370,7,2737,921,3658,2.971769815418024
1370,8,3660,284,3944,12.887323943661972
1370,9,3987,499,4486,7.98997995991984
1370,10,4535,267,4802,16.98501872659176
1370,11,4826,944,5770,5.112288135593221
1370,12,5772,230,6002,25.095652173913045
1370,13,6013,350,6363,17.18
1370,14,6404,896,7300,7.147321428571429
1371,1,258,359,617,0.7186629526462396
1372,1,21,94,115,0.22340425531914893
1372,2,139,58,197,2.396551724137931
1372,3,245,296,541,0.8277027027027027
1373,1,80,617,697,0.12965964343598055
1373,2,708,425,1133,1.6658823529411764
1373,3,1162,461,1623,2.5206073752711498
1373,4,1646,270,1916,6.0962962962962965
1373,5,1947,316,2263,6.1613924050632916
1373,6,2286,249,2535,9.180722891566266
1373,7,2553,456,3009,5.598684210526316
1373,8,3087,777,3864,3.972972972972973
1373,9,3942,651,4593,6.055299539170507
1374,1,126,634,760,0.19873817034700317
1375,1,101,436,537,0.231651376146789
1375,2,555,440,995,1.2613636363636365
1375,3,1003,430,1433,2.332558139534884
1375,4,1443,373,1816,3.868632707774799
1375,5,1838,303,2141,6.066006600660066
1375,6,2315,381,2696,6.076115485564304
1375,7,2711,426,3137,6.363849765258216
1375,8,3148,281,3429,11.202846975088969
1375,9,3573,203,3776,17.600985221674875
1375,10,3974,289,4263,13.750865051903114
1375,11,4829,328,5157,14.722560975609756
1375,12,5369,205,5574,26.190243902439025
1375,13,5714,401,6115,14.24937655860349
1375,14,6172,409,6581,15.09046454767726
1375,15,6630,126,6756,52.61904761904762
1375,16,6810,422,7232,16.137440758293838
1375,17,7255,422,7677,17.191943127962084
1376,1,22,315,337,0.06984126984126984
1377,1,10,624,634,0.016025641025641024
1377,2,688,646,1334,1.065015479876161
1377,3,1345,146,1491,9.212328767123287
1378,1,218,1081,1299,0.20166512488436633
1378,2,1313,606,1919,2.1666666666666665
1378,3,2104,1040,3144,2.023076923076923
1378,4,3158,824,3982,3.8325242718446604
1379,1,684,673,1357,1.0163447251114412
1379,2,1505,662,2167,2.273413897280967
1379,3,2243,654,2897,3.429663608562691
1379,4,2973,588,3561,5.0561224489795915
1379,5,3637,643,4280,5.656298600311042
1379,6,4356,654,5010,6.660550458715596
1379,7,5130,578,5708,8.875432525951558
1379,8,5828,718,6546,8.116991643454039
1379,9,6666,716,7382,9.310055865921788
1380,1,43,73,116,0.589041095890411
1380,2,151,79,230,1.9113924050632911
1380,3,254,50,304,5.08
1380,4,425,475,900,0.8947368421052632
1380,5,1811,930,2741,1.9473118279569892
1381,1,8,317,325,0.025236593059936908
1381,2,544,487,1031,1.1170431211498972
1381,3,1187,649,1836,1.8289676425269645
1381,4,1912,115,2027,16.62608695652174
1381,5,2111,784,2895,2.6926020408163267
1381,6,2979,674,3653,4.419881305637982
1381,7,3703,586,4289,6.319112627986348
1381,8,4339,786,5125,5.520356234096692
1382,1,70,739,809,0.09472259810554803
1382,2,818,676,1494,1.2100591715976332
1383,1,163,954,1117,0.1708595387840671
1383,2,1153,1007,2160,1.1449851042701091
1383,3,2202,997,3199,2.208625877632899
1383,4,3236,1042,4278,3.105566218809981
1383,5,4312,892,5204,4.834080717488789
1383,6,5239,939,6178,5.579339723109691
1383,7,6215,836,7051,7.434210526315789
1383,8,7083,792,7875,8.943181818181818
1384,1,51,69,120,0.7391304347826086
1384,2,847,811,1658,1.0443896424167693
1384,3,1662,18,1680,92.33333333333333
1384,4,2673,504,3177,5.303571428571429
1384,5,4796,607,5403,7.901153212520593
1384,6,6887,317,7204,21.725552050473187
1385,1,1259,649,1908,1.9399075500770415
1386,1,23,117,140,0.19658119658119658
1386,2,165,103,268,1.6019417475728155
1386,3,310,496,806,0.625
1386,4,845,422,1267,2.0023696682464456
1386,5,1307,471,1778,2.774946921443737
1386,6,1816,581,2397,3.125645438898451
1386,7,2445,648,3093,3.7731481481481484
1386,8,3141,660,3801,4.759090909090909
1386,9,3854,668,4522,5.769461077844311
1386,10,4572,671,5243,6.81371087928465
1386,11,5293,664,5957,7.971385542168675
1386,12,6018,704,6722,8.548295454545455
1386,13,6769,646,7415,10.478328173374614
1387,1,153,98,251,1.5612244897959184
1387,2,308,496,804,0.6209677419354839
1388,1,62,64,126,0.96875
1388,2,137,593,730,0.23102866779089376
1389,1,26,349,375,0.07449856733524356
1389,2,377,330,707,1.1424242424242423
1389,3,726,351,1077,2.0683760683760686
1389,4,1102,315,1417,3.4984126984126984
1389,5,1444,435,1879,3.3195402298850576
1389,6,1897,317,2214,5.9842271293375395
1389,7,2217,315,2532,7.038095238095238
1389,8,2534,286,2820,8.86013986013986
1389,9,2824,53,2877,53.283018867924525
1389,10,2892,62,2954,46.645161290322584
1390,1,217,1009,1226,0.21506442021803765
1390,2,1228,978,2206,1.2556237218813906
1391,1,73,698,771,0.10458452722063037
1391,2,789,408,1197,1.9338235294117647
1391,3,1235,580,1815,2.1293103448275863
1391,4,1824,324,2148,5.62962962962963
1392,1,7,35,42,0.2
1392,2,572,178,750,3.2134831460674156
1392,3,781,642,1423,1.2165109034267914
1392,4,1457,921,2378,1.5819761129207384
1393,1,53,907,960,0.05843439911797133
1394,1,11,65,76,0.16923076923076924
1394,2,108,250,358,0.432
1394,3,371,429,800,0.8648018648018648
1394,4,816,88,904,9.272727272727273
1394,5,924,99,1023,9.333333333333334
1394,6,1037,120,1157,8.641666666666667
1394,7,1175,184,1359,6.385869565217392
1395,1,24,650,674,0.036923076923076927
1395,2,780,821,1601,0.9500609013398295
1395,3,1632,843,2475,1.9359430604982206
1396,1,1405,937,2342,1.4994663820704375
1396,2,2353,420,2773,5.602380952380952
1396,3,2852,646,3498,4.414860681114551
1396,4,3550,529,4079,6.710775047258979
1396,5,4105,463,4568,8.86609071274298
1396,6,4609,639,5248,7.21283255086072
1396,7,5279,545,5824,9.686238532110092
1396,8,5835,394,6229,14.809644670050762
1396,9,6240,562,6802,11.103202846975089
1397,1,34,357,391,0.09523809523809523
1397,2,446,362,808,1.2320441988950277
1397,3,851,325,1176,2.6184615384615384
1397,4,1194,336,1530,3.5535714285714284
1397,5,1533,249,1782,6.156626506024097
1397,6,1877,340,2217,5.520588235294118
1397,7,2226,267,2493,8.337078651685394
1397,8,2608,330,2938,7.903030303030303
1397,9,2947,281,3228,10.487544483985765
1397,10,3276,298,3574,10.993288590604028
1397,11,3637,300,3937,12.123333333333333
1397,12,3965,260,4225,15.25
1397,13,4320,354,4674,12.203389830508474
1397,14,4749,359,5108,13.22841225626741
1397,15,5111,222,5333,23.02252252252252
1397,16,5396,315,5711,17.13015873015873
1397,17,5714,299,6013,19.110367892976587
1397,18,6037,284,6321,21.257042253521128
1397,19,6324,328,6652,19.28048780487805
1397,20,6700,200,6900,33.5
1397,21,6925,55,6980,125.9090909090909
1398,1,47,434,481,0.10829493087557604
1398,2,495,410,905,1.2073170731707317
1398,3,994,462,1456,2.1515151515151514
1398,4,1484,575,2059,2.5808695652173914
1398,5,2080,101,2181,20.594059405940595
1398,6,2264,178,2442,12.719101123595506
1398,7,2456,453,2909,5.421633554083885
1398,8,2924,636,3560,4.59748427672956
1398,9,3574,596,4170,5.996644295302014
1398,10,4193,1062,5255,3.9482109227871938
1398,11,5268,241,5509,21.858921161825727
1398,12,6621,206,6827,32.140776699029125
1398,13,6879,271,7150,25.383763837638377
1398,14,7174,505,7679,14.205940594059406
1399,1,58,50,108,1.16
1399,2,122,221,343,0.5520361990950227
1399,3,378,967,1345,0.390899689762151
1399,4,1361,937,2298,1.4525080042689433
1399,5,2323,901,3224,2.5782463928967814
1399,6,3253,1011,4264,3.217606330365974
1399,7,4318,827,5145,5.221281741233374
1399,8,5170,799,5969,6.470588235294118
1399,9,6007,809,6816,7.425216316440049
1399,10,6862,750,7612,9.149333333333333
1400,1,48,558,606,0.08602150537634409
1400,2,647,582,1229,1.111683848797251
1401,1,16,58,74,0.27586206896551724
1401,2,94,660,754,0.14242424242424243
1401,3,810,651,1461,1.2442396313364055
1401,4,1526,644,2170,2.369565217391304
1401,5,2556,720,3276,3.55
1401,6,3719,158,3877,23.537974683544302
1401,7,4353,187,4540,23.27807486631016
1401,8,4946,163,5109,30.34355828220859
1401,9,5166,889,6055,5.811023622047244
1401,10,6059,289,6348,20.965397923875432
1401,11,6398,391,6789,16.36317135549872
1401,12,6945,615,7560,11.292682926829269
1402,1,36,108,144,0.3333333333333333
1403,1,87,744,831,0.11693548387096774
1403,2,862,630,1492,1.3682539682539683
1403,3,1517,826,2343,1.8365617433414043
1403,4,2381,413,2794,5.765133171912833
1403,5,2812,765,3577,3.675816993464052
1404,1,487,1212,1699,0.4018151815181518
1405,1,130,619,749,0.210016155088853
1405,2,760,603,1363,1.2603648424543947
1405,3,1379,616,1995,2.2386363636363638
1405,4,2030,663,2693,3.06184012066365
1405,5,2719,750,3469,3.6253333333333333
1406,1,23,88,111,0.26136363636363635
1406,2,174,626,800,0.2779552715654952
1406,3,855,670,1525,1.2761194029850746
1406,4,1585,790,2375,2.0063291139240507
1406,5,2484,746,3230,3.329758713136729
1406,6,3277,787,4064,4.163913595933926
1407,1,34,531,565,0.064030131826742
1407,2,1208,1311,2519,0.9214340198321892
1407,3,2522,540,3062,4.67037037037037
1408,1,67,63,130,1.0634920634920635
1408,2,145,314,459,0.46178343949044587
1408,3,483,382,865,1.2643979057591623
1409,1,32,139,171,0.2302158273381295
1409,2,290,233,523,1.2446351931330473
1409,3,542,260,802,2.0846153846153848
1409,4,812,88,900,9.227272727272727
1409,5,917,149,1066,6.154362416107382
1409,6,1078,181,1259,5.955801104972376
1409,7,1286,158,1444,8.139240506329115
1409,8,1455,325,1780,4.476923076923077
1409,9,1789,60,1849,29.816666666666666
1410,1,23,633,656,0.036334913112164295
1410,2,692,600,1292,1.1533333333333333
1410,3,1305,349,1654,3.7392550143266474
1410,4,1692,473,2165,3.5771670190274842
1410,5,2189,310,2499,7.061290322580645
1410,6,2544,473,3017,5.378435517970401
1410,7,3021,44,3065,68.6590909090909
1411,1,935,987,1922,0.9473150962512664
1411,2,1924,1047,2971,1.8376313276026743
1411,3,2975,981,3956,3.032619775739042
1411,4,3958,990,4948,3.997979797979798
1412,1,50,671,721,0.07451564828614009
1412,2,744,338,1082,2.201183431952663
1412,3,1342,836,2178,1.605263157894737
1412,4,2342,750,3092,3.1226666666666665
1412,5,3125,703,3828,4.445234708392603
1413,1,20,275,295,0.07272727272727272
1413,2,303,284,587,1.0669014084507042
1413,3,596,290,886,2.0551724137931036
1413,4,894,154,1048,5.805194805194805
1413,5,1059,265,1324,3.9962264150943394
1414,1,15,505,520,0.0297029702970297
1415,1,20,525,545,0.0380952380952381
1416,1,85,66,151,1.2878787878787878
1416,2,176,627,803,0.2807017543859649
1416,3,881,409,1290,2.154034229828851
1416,4,1354,331,1685,4.090634441087613
1416,5,1755,166,1921,10.572289156626505
1416,6,1999,619,2618,3.2294022617124396
1416,7,2672,288,2960,9.277777777777779
1417,1,40,19,59,2.1052631578947367
1417,2,101,93,194,1.086021505376344
1417,3,224,89,313,2.5168539325842696
1418,1,57,590,647,0.09661016949152543
1419,1,103,374,477,0.27540106951871657
1420,1,72,1005,1077,0.07164179104477612
1420,2,1095,1018,2113,1.075638506876228
1420,3,2129,1026,3155,2.0750487329434697
1420,4,3157,996,4153,3.1696787148594376
1421,1,152,65,217,2.3384615384615386
1421,2,542,76,618,7.131578947368421
1421,3,652,58,710,11.241379310344827
1421,4,741,110,851,6.736363636363636
1421,5,1242,322,1564,3.857142857142857
1421,6,1574,46,1620,34.21739130434783
1421,7,1629,189,1818,8.619047619047619
1421,8,2194,294,2488,7.462585034013605
1421,9,2713,350,3063,7.751428571428572
1421,10,4115,253,4368,16.26482213438735
1421,11,5638,328,5966,17.1890243902439
1421,12,6166,269,6435,22.92193308550186
1421,13,6844,275,7119,24.887272727272727
1422,1,43,74,117,0.581081081081081
1422,2,555,533,1088,1.0412757973733584
1422,3,1623,405,2028,4.007407407407407
1422,4,2143,401,2544,5.344139650872818
1422,5,2590,44,2634,58.86363636363637
1422,6,2752,419,3171,6.5680190930787585
1422,7,3253,387,3640,8.405684754521964
1423,1,79,498,577,0.15863453815261044
1423,2,591,515,1106,1.1475728155339806
1424,1,22,399,421,0.05513784461152882
1425,1,507,788,1295,0.6434010152284264
1425,2,1329,787,2116,1.6886912325285897
1425,3,2210,846,3056,2.6122931442080377
1425,4,3162,484,3646,6.533057851239669
1425,5,3830,660,4490,5.803030303030303
1425,6,4648,814,5462,5.7100737100737105
1425,7,5497,492,5989,11.172764227642276
1425,8,6029,639,6668,9.435054773082943
1425,9,6888,859,7747,8.018626309662398
1426,1,12,333,345,0.036036036036036036
1426,2,354,341,695,1.0381231671554252
1426,3,742,360,1102,2.061111111111111
1426,4,1105,364,1469,3.0357142857142856
1426,5,1472,278,1750,5.294964028776978
1426,6,1767,345,2112,5.121739130434783
1426,7,2115,325,2440,6.507692307692308
1426,8,2443,231,2674,10.575757575757576
1426,9,2710,325,3035,8.338461538461539
1426,10,3041,359,3400,8.470752089136491
1426,11,3403,355,3758,9.585915492957746
1426,12,3761,52,3813,72.32692307692308
1426,13,3832,190,4022,20.16842105263158
1426,14,4025,424,4449,9.492924528301886
1426,15,4452,735,5187,6.057142857142857
1426,16,5225,170,5395,30.735294117647058
1426,17,5398,361,5759,14.952908587257618
1426,18,5762,608,6370,9.476973684210526
1426,19,6373,119,6492,53.554621848739494
1426,20,6495,346,6841,18.771676300578033
1426,21,6843,369,7212,18.54471544715447
1426,22,7214,350,7564,20.611428571428572
1426,23,7566,120,7686,63.05
1427,1,1393,382,1775,3.6465968586387434
1427,2,1805,318,2123,5.676100628930818
1427,3,2142,389,2531,5.506426735218509
1427,4,2563,382,2945,6.709424083769633
1427,5,3019,408,3427,7.3995098039215685
1427,6,3446,220,3666,15.663636363636364
1427,7,3692,278,3970,13.280575539568344
1427,8,4208,320,4528,13.15
1427,9,4540,361,4901,12.57617728531856
1427,10,4904,234,5138,20.957264957264957
1427,11,5857,52,5909,112.63461538461539
1427,12,5914,83,5997,71.25301204819277
1427,13,6003,59,6062,101.7457627118644
1427,14,6069,64,6133,94.828125
1427,15,6138,57,6195,107.6842105263158
1427,16,6205,56,6261,110.80357142857143
1427,17,6267,62,6329,101.08064516129032
1427,18,6334,61,6395,103.8360655737705
1427,19,6407,66,6473,97.07575757575758
1427,20,6489,64,6553,101.390625
1427,21,6558,76,6634,86.28947368421052
1427,22,6642,72,6714,92.25
1427,23,6720,63,6783,106.66666666666667
1427,24,6792,84,6876,80.85714285714286
1427,25,6890,75,6965,91.86666666666666
1427,26,6970,70,7040,99.57142857142857
1427,27,7046,63,7109,111.84126984126983
1427,28,7125,91,7216,78.2967032967033
1428,1,18,512,530,0.03515625
1429,1,181,38,219,4.7631578947368425
1429,2,2056,617,2673,3.3322528363047
1430,1,11,233,244,0.04721030042918455
1431,1,13,425,438,0.03058823529411765
1431,2,462,344,806,1.3430232558139534
1431,3,837,499,1336,1.6773547094188377
1431,4,1348,619,1967,2.1777059773828755
1431,5,1983,518,2501,3.828185328185328
1432,1,88,840,928,0.10476190476190476
1432,2,934,735,1669,1.2707482993197279
1433,1,27,390,417,0.06923076923076923
1433,2,433,284,717,1.5246478873239437
1433,3,749,264,1013,2.837121212121212
1433,4,1033,323,1356,3.198142414860681
1433,5,1370,240,1610,5.708333333333333
1433,6,1619,54,1673,29.98148148148148
1434,1,14,657,671,0.0213089802130898
1434,2,680,571,1251,1.1908931698774081
1434,3,1268,556,1824,2.2805755395683454
1434,4,1833,971,2804,1.8877445932028836
1434,5,2822,946,3768,2.983086680761099
1434,6,3791,964,4755,3.9325726141078836
1434,7,4777,523,5300,9.133843212237094
1434,8,5309,443,5752,11.984198645598195
1434,9,5811,93,5904,62.483870967741936
1435,1,16,198,214,0.08080808080808081
1435,2,1071,217,1288,4.935483870967742
1435,3,1295,384,1679,3.3723958333333335
1436,1,925,273,1198,3.3882783882783882
1436,2,1212,340,1552,3.5647058823529414
1436,3,1569,245,1814,6.404081632653061
1436,4,1821,281,2102,6.480427046263345
1437,1,52,274,326,0.1897810218978102
1438,1,475,284,759,1.6725352112676057
1438,2,774,416,1190,1.8605769230769231
1439,1,100,715,815,0.13986013986013987
1440,1,32,40,72,0.8
1440,2,518,129,647,4.015503875968992
1440,3,1432,268,1700,5.343283582089552
1440,4,2258,240,2498,9.408333333333333
1440,5,3273,87,3360,37.62068965517241
1440,6,3385,44,3429,76.93181818181819
1440,7,4241,82,4323,51.71951219512195
1440,8,4344,48,4392,90.5
1440,9,4891,94,4985,52.03191489361702
1440,10,5891,105,5996,56.10476190476191
1440,11,6993,3,6996,2331.0
1440,12,7085,268,7353,26.436567164179106
1441,1,21,182,203,0.11538461538461539
1441,2,225,184,409,1.2228260869565217
1441,3,432,197,629,2.1928934010152283
1441,4,653,400,1053,1.6325
1441,5,1066,278,1344,3.8345323741007196
1442,1,90,871,961,0.10332950631458095
1442,2,963,221,1184,4.357466063348416
1442,3,1219,480,1699,2.5395833333333333
1443,1,18,734,752,0.02452316076294278
1444,1,754,341,1095,2.2111436950146626
1445,1,134,946,1080,0.1416490486257928
1445,2,1140,658,1798,1.7325227963525835
1445,3,1882,505,2387,3.726732673267327
1445,4,2430,819,3249,2.967032967032967
1445,5,3291,1035,4326,3.1797101449275362
1446,1,464,266,730,1.744360902255639
1446,2,754,268,1022,2.8134328358208953
1447,1,86,491,577,0.17515274949083504
1447,2,595,880,1475,0.6761363636363636
1447,3,1513,597,2110,2.5343383584589616
1447,4,2167,461,2628,4.700650759219089
1447,5,2630,284,2914,9.26056338028169
1448,1,13,820,833,0.015853658536585366
1448,2,859,438,1297,1.961187214611872
1449,1,33,102,135,0.3235294117647059
1449,2,318,739,1057,0.43031123139377536
1449,3,1067,188,1255,5.675531914893617
1450,1,484,484,968,1.0
1450,2,2424,194,2618,12.494845360824742
1450,3,2676,37,2713,72.32432432432432
1450,4,2716,389,3105,6.982005141388175
1450,5,3490,3,3493,1163.3333333333333
1450,6,3514,3,3517,1171.3333333333333
1451,1,1486,194,1680,7.65979381443299
1451,2,2240,141,2381,15.886524822695035
1451,3,2818,177,2995,15.92090395480226
1451,4,5202,224,5426,23.223214285714285
1452,1,123,61,184,2.0163934426229506
1452,2,2368,307,2675,7.713355048859935
1452,3,4940,219,5159,22.557077625570777
1452,4,7113,186,7299,38.24193548387097
1453,1,12,174,186,0.06896551724137931
1453,2,201,187,388,1.0748663101604279
1453,3,402,147,549,2.7346938775510203
1453,4,585,405,990,1.4444444444444444
1454,1,101,884,985,0.11425339366515837
1454,2,994,263,1257,3.779467680608365
1454,3,1315,206,1521,6.383495145631068
1454,4,1550,238,1788,6.512605042016807
1454,5,1846,326,2172,5.662576687116564
1454,6,2186,576,2762,3.795138888888889
1454,7,2893,642,3535,4.506230529595015
1454,8,3590,592,4182,6.0641891891891895
1455,1,22,79,101,0.27848101265822783
1455,2,108,46,154,2.347826086956522
1455,3,159,93,252,1.7096774193548387
1455,4,261,134,395,1.9477611940298507
1455,5,411,110,521,3.7363636363636363
1455,6,534,180,714,2.966666666666667
1456,1,18,806,824,0.022332506203473945
1456,2,852,692,1544,1.23121387283237
1456,3,1567,436,2003,3.5940366972477062
1457,1,92,567,659,0.16225749559082892
1458,1,146,978,1124,0.1492842535787321
1458,2,1275,1093,2368,1.1665141811527904
1458,3,2408,997,3405,2.415245737211635
1459,1,3829,408,4237,9.384803921568627
1459,2,4295,397,4692,10.818639798488665
1459,3,4695,405,5100,11.592592592592593
1459,4,5103,379,5482,13.464379947229551
1460,1,41,293,334,0.13993174061433447
1460,2,365,696,1061,0.5244252873563219
1460,3,1093,266,1359,4.109022556390977
1460,4,1429,529,1958,2.701323251417769
1460,5,2259,714,2973,3.1638655462184873
1460,6,3079,1102,4181,2.794010889292196
1460,7,4234,1677,5911,2.5247465712581993
1460,8,5974,519,6493,11.510597302504816
1461,1,33,807,840,0.040892193308550186
1462,1,262,112,374,2.3392857142857144
1462,2,1165,196,1361,5.9438775510204085
1462,3,1367,188,1555,7.2712765957446805
1462,4,1561,503,2064,3.10337972166998
1462,5,2070,661,2731,3.1316187594553706
1462,6,2737,837,3574,3.270011947431302
1462,7,3580,477,4057,7.50524109014675
1462,8,4063,978,5041,4.15439672801636
1462,9,5047,721,5768,7.0
1462,10,5774,679,6453,8.503681885125184
1462,11,6459,944,7403,6.842161016949152
1462,12,7409,256,7665,28.94140625
1463,1,16,341,357,0.0469208211143695
1464,1,23,868,891,0.026497695852534562
1464,2,941,981,1922,0.9592252803261978
1464,3,1937,831,2768,2.3309265944645006
1464,4,2811,1037,3848,2.7107039537126325
1464,5,3850,265,4115,14.528301886792454
1464,6,4191,375,4566,11.176
1464,7,4572,110,4682,41.56363636363636
1464,8,4696,1035,5731,4.5371980676328505
1464,9,5734,1076,6810,5.328996282527881
1464,10,6909,467,7376,14.794432548179872
1464,11,7465,230,7695,32.45652173913044
1465,1,236,86,322,2.744186046511628
1465,2,345,99,444,3.484848484848485
1465,3,460,101,561,4.554455445544554
1465,4,585,64,649,9.140625
1465,5,664,72,736,9.222222222222221
1465,6,765,548,1313,1.395985401459854
1465,7,1340,151,1491,8.874172185430464
1465,8,1527,336,1863,4.544642857142857
1465,9,1898,341,2239,5.5659824046920825
1465,10,2252,143,2395,15.748251748251748
1466,1,52,361,413,0.1440443213296399
1466,2,449,206,655,2.179611650485437
1466,3,673,228,901,2.9517543859649122
1466,4,952,276,1228,3.449275362318841
1467,1,21,619,640,0.033925686591276254
1468,1,30,820,850,0.036585365853658534
1468,2,852,591,1443,1.4416243654822336
1468,3,1469,853,2322,1.7221570926143024
1469,1,79,954,1033,0.08280922431865828
1469,2,1046,456,1502,2.293859649122807
1469,3,1519,666,2185,2.280780780780781
1469,4,2224,368,2592,6.043478260869565
1469,5,2621,620,3241,4.22741935483871
1469,6,3288,444,3732,7.405405405405405
1469,7,3864,421,4285,9.178147268408551
1469,8,4341,546,4887,7.950549450549451
1469,9,4955,381,5336,13.005249343832022
1469,10,5375,268,5643,20.05597014925373
1469,11,5759,991,6750,5.81130171543895
1470,1,6,295,301,0.020338983050847456
1470,2,312,522,834,0.5977011494252874
1471,1,159,340,499,0.4676470588235294
1471,2,523,811,1334,0.6448828606658447
1471,3,1350,963,2313,1.4018691588785046
1471,4,2346,962,3308,2.4386694386694385
1471,5,3321,605,3926,5.489256198347108
1471,6,4038,429,4467,9.412587412587413
1471,7,4504,491,4995,9.173116089613035
1471,8,5014,594,5608,8.441077441077441
1471,9,5623,324,5947,17.354938271604937
1471,10,5984,538,6522,11.12267657992565
1472,1,97,27,124,3.5925925925925926
1472,2,131,129,260,1.0155038759689923
1472,3,292,153,445,1.908496732026144
1472,4,451,140,591,3.2214285714285715
1472,5,595,128,723,4.6484375
1472,6,732,135,867,5.4222222222222225
1472,7,877,119,996,7.369747899159663
1472,8,1028,131,1159,7.847328244274809
1472,9,1165,134,1299,8.694029850746269
1472,10,1323,154,1477,8.590909090909092
1472,11,1487,139,1626,10.697841726618705
1472,12,1690,50,1740,33.8
1473,1,19,43,62,0.4418604651162791
1473,2,179,459,638,0.3899782135076253
1473,3,676,436,1112,1.5504587155963303
1473,4,1125,204,1329,5.514705882352941
1473,5,1370,189,1559,7.248677248677248
1474,1,103,144,247,0.7152777777777778
1474,2,259,249,508,1.0401606425702812
1474,3,670,301,971,2.2259136212624586
1474,4,1047,316,1363,3.3132911392405062
1474,5,1389,363,1752,3.8264462809917354
1474,6,1803,397,2200,4.541561712846348
1475,1,24,312,336,0.07692307692307693
1476,1,20,76,96,0.2631578947368421
1476,2,163,124,287,1.314516129032258
1476,3,357,94,451,3.797872340425532
1476,4,540,111,651,4.864864864864865
1476,5,657,145,802,4.531034482758621
1477,1,60,542,602,0.11070110701107011
1477,2,618,181,799,3.414364640883978
1477,3,839,198,1037,4.237373737373737
1477,4,1056,70,1126,15.085714285714285
1478,1,1571,648,2219,2.424382716049383
1478,2,4264,686,4950,6.215743440233236
1478,3,6325,505,6830,12.524752475247524
1479,1,164,1980,2144,0.08282828282828283
1479,2,2208,1515,3723,1.4574257425742574
1479,3,4030,2130,6160,1.892018779342723
1480,1,16,66,82,0.24242424242424243
1480,2,96,238,334,0.40336134453781514
1480,3,418,344,762,1.2151162790697674
1480,4,804,283,1087,2.8409893992932864
1480,5,1111,319,1430,3.4827586206896552
1480,6,1463,379,1842,3.8601583113456464
1480,7,1894,172,2066,11.011627906976743
1480,8,2073,148,2221,14.006756756756756
1480,9,2233,353,2586,6.325779036827195
1480,10,2600,50,2650,52.0
1480,11,2676,395,3071,6.774683544303797
1480,12,3079,92,3171,33.46739130434783
1480,13,3209,321,3530,9.996884735202492
1480,14,3571,293,3864,12.187713310580206
1480,15,3885,151,4036,25.728476821192054
1480,16,4067,186,4253,21.865591397849464
1480,17,4278,50,4328,85.56
1480,18,4347,51,4398,85.23529411764706
1480,19,4427,68,4495,65.1029411764706
1480,20,4507,46,4553,97.97826086956522
1480,21,4583,370,4953,12.386486486486486
1480,22,4978,328,5306,15.176829268292684
1480,23,5508,245,5753,22.481632653061226
1481,1,43,714,757,0.06022408963585434
1481,2,774,527,1301,1.4686907020872866
1481,3,1311,586,1897,2.237201365187713
1481,4,1905,453,2358,4.2052980132450335
1481,5,2365,855,3220,2.7660818713450293
1481,6,3552,182,3734,19.516483516483518
1482,1,19,473,492,0.040169133192389
1482,2,518,460,978,1.126086956521739
1482,3,997,347,1344,2.873198847262248
1482,4,1359,397,1756,3.4231738035264483
1482,5,1783,499,2282,3.5731462925851702
1482,6,2315,599,2914,3.8647746243739567
1482,7,2956,366,3322,8.076502732240437
1482,8,3349,508,3857,6.59251968503937
1483,1,9,163,172,0.05521472392638037
1483,2,182,360,542,0.5055555555555555
1483,3,560,85,645,6.588235294117647
1483,4,661,65,726,10.169230769230769
1483,5,750,68,818,11.029411764705882
1483,6,836,69,905,12.115942028985508
1483,7,936,48,984,19.5
1483,8,1010,67,1077,15.074626865671641
1483,9,1094,111,1205,9.855855855855856
1483,10,1219,93,1312,13.10752688172043
1483,11,1366,103,1469,13.262135922330097
1483,12,1475,3,1478,491.6666666666667
1484,1,29,536,565,0.054104477611940295
1485,1,162,801,963,0.20224719101123595
1485,2,1158,756,1914,1.5317460317460319
1485,3,2171,839,3010,2.5876042908224077
1485,4,3091,580,3671,5.3293103448275865
1485,5,3751,445,4196,8.429213483146068
1485,6,4647,757,5404,6.138705416116248
1485,7,5434,529,5963,10.272211720226844
1485,8,6020,777,6797,7.747747747747748
1485,9,6827,373,7200,18.302949061662197
1485,10,7276,726,8002,10.022038567493112
1486,1,47,434,481,0.10829493087557604
1486,2,495,410,905,1.2073170731707317
1486,3,994,462,1456,2.1515151515151514
1486,4,1484,575,2059,2.5808695652173914
1486,5,2097,101,2198,20.762376237623762
1486,6,2298,178,2476,12.910112359550562
1486,7,2507,453,2960,5.5342163355408385
1486,8,2992,636,3628,4.70440251572327
1486,9,3659,596,4255,6.139261744966443
1486,10,4295,1062,5357,4.044256120527307
1486,11,5387,241,5628,22.352697095435683
1486,12,6729,634,7363,10.613564668769715
1487,1,167,665,832,0.2511278195488722
1487,2,846,651,1497,1.2995391705069124
1487,3,1506,682,2188,2.2082111436950145
1488,1,179,574,753,0.3118466898954704
1488,2,774,601,1375,1.2878535773710482
1489,1,37,760,797,0.04868421052631579
1490,1,28,566,594,0.04946996466431095
1490,2,607,1019,1626,0.5956820412168793
1491,1,88,709,797,0.12411847672778561
1492,1,1169,826,1995,1.4152542372881356
1493,1,14,242,256,0.05785123966942149
1493,2,271,617,888,0.4392220421393841
1494,1,25,365,390,0.0684931506849315
1494,2,423,434,857,0.9746543778801844
1495,1,582,375,957,1.552
1496,1,65,428,493,0.15186915887850466
1496,2,501,358,859,1.399441340782123
1496,3,894,455,1349,1.9648351648351647
1496,4,1386,472,1858,2.9364406779661016
1496,5,1925,373,2298,5.160857908847185
1497,1,38,539,577,0.07050092764378478
1497,2,627,466,1093,1.3454935622317596
1497,3,1129,546,1675,2.067765567765568
1498,1,74,177,251,0.4180790960451977
1498,2,1711,891,2602,1.920314253647587
1498,3,2666,1320,3986,2.0196969696969695
1498,4,3994,1117,5111,3.5756490599820947
1498,5,5227,1205,6432,4.337759336099585
1498,6,6440,775,7215,8.30967741935484
1499,1,557,158,715,3.5253164556962027
1499,2,735,50,785,14.7
1499,3,796,80,876,9.95
1499,4,892,701,1593,1.2724679029957204
1499,5,1621,449,2070,3.6102449888641424
1499,6,2090,764,2854,2.735602094240838
1499,7,2891,816,3707,3.542892156862745
1499,8,3713,910,4623,4.08021978021978
1500,1,63,922,985,0.06832971800433839
1500,2,1059,954,2013,1.110062893081761
1500,3,2039,854,2893,2.3875878220140514
1501,1,41,939,980,0.043663471778487756
1501,2,997,391,1388,2.549872122762148
1501,3,1413,749,2162,1.8865153538050734
1501,4,2221,736,2957,3.0176630434782608
1501,5,3001,908,3909,3.305066079295154
1501,6,3916,939,4855,4.170394036208733
1502,1,54,462,516,0.11688311688311688
1502,2,532,440,972,1.209090909090909
1502,3,997,521,1518,1.9136276391554703
1502,4,1548,201,1749,7.701492537313433
1502,5,1784,403,2187,4.426799007444169
1502,6,2206,215,2421,10.26046511627907
1502,7,2438,178,2616,13.696629213483146
1502,8,2627,339,2966,7.7492625368731565
1502,9,3081,302,3383,10.201986754966887
1502,10,3423,25,3448,136.92
1502,11,3488,212,3700,16.452830188679247
1502,12,3739,265,4004,14.10943396226415
1502,13,4039,262,4301,15.416030534351146
1502,14,4309,303,4612,14.221122112211221
1503,1,1039,715,1754,1.4531468531468532
1503,2,2682,1012,3694,2.650197628458498
1504,1,11,57,68,0.19298245614035087
1505,1,29,915,944,0.03169398907103825
1505,2,946,404,1350,2.3415841584158414
1505,3,1362,917,2279,1.485278080697928
1505,4,2294,766,3060,2.9947780678851177
1505,5,3087,472,3559,6.540254237288136
1506,1,20,115,135,0.17391304347826086
1507,1,376,490,866,0.7673469387755102
1508,1,97,565,662,0.17168141592920355
1508,2,3053,671,3724,4.549925484351714
1508,3,6104,377,6481,16.190981432360743
1509,1,63,436,499,0.1444954128440367
1509,2,516,504,1020,1.0238095238095237
1509,3,1043,253,1296,4.122529644268774
1509,4,1319,698,2017,1.8896848137535818
1509,5,2053,642,2695,3.1978193146417446
1509,6,2735,517,3252,5.290135396518375
1509,7,3290,716,4006,4.594972067039106
1510,1,109,609,718,0.17898193760262726
1511,1,69,2,71,34.5
1511,2,159,11,170,14.454545454545455
1511,3,172,16,188,10.75
1511,4,193,27,220,7.148148148148148
1511,5,228,27,255,8.444444444444445
1511,6,258,22,280,11.727272727272727
1511,7,286,20,306,14.3
1511,8,308,27,335,11.407407407407407
1511,9,346,96,442,3.6041666666666665
1512,1,77,558,635,0.13799283154121864
1512,2,653,326,979,2.003067484662577
1512,3,1010,312,1322,3.2371794871794872
1512,4,1342,265,1607,5.064150943396227
1512,5,1640,417,2057,3.932853717026379
1512,6,2082,458,2540,4.545851528384279
1512,7,2569,385,2954,6.672727272727273
1513,1,47,39,86,1.205128205128205
1514,1,353,292,645,1.2089041095890412
1515,1,39,618,657,0.06310679611650485
1516,1,199,955,1154,0.20837696335078534
1517,1,19,1042,1061,0.018234165067178502
1517,2,1066,429,1495,2.484848484848485
1517,3,1532,855,2387,1.791812865497076
1517,4,2426,768,3194,3.1588541666666665
1517,5,3244,987,4231,3.286727456940223
1517,6,4236,703,4939,6.025604551920342
1517,7,4974,948,5922,5.246835443037975
1517,8,5953,791,6744,7.525916561314792
1517,9,6776,706,7482,9.597733711048159
1518,1,77,429,506,0.1794871794871795
1519,1,91,816,907,0.11151960784313726
1520,1,261,230,491,1.1347826086956523
1520,2,522,233,755,2.240343347639485
1520,3,835,275,1110,3.036363636363636
1520,4,1276,258,1534,4.945736434108527
1520,5,1626,253,1879,6.426877470355731
1520,6,1960,236,2196,8.305084745762711
1521,1,74,505,579,0.14653465346534653
1521,2,619,676,1295,0.915680473372781
1521,3,1346,1005,2351,1.3393034825870647
1521,4,2395,1070,3465,2.2383177570093458
1522,1,4,481,485,0.008316008316008316
1522,2,489,367,856,1.332425068119891
1522,3,867,647,1514,1.3400309119010818
1523,1,18,268,286,0.06716417910447761
1523,2,297,272,569,1.0919117647058822
1523,3,579,325,904,1.7815384615384615
1524,1,242,473,715,0.5116279069767442
1524,2,737,159,896,4.635220125786163
1524,3,911,403,1314,2.260545905707196
1524,4,1345,338,1683,3.9792899408284024
1524,5,1698,311,2009,5.459807073954984
1524,6,2025,316,2341,6.408227848101266
1525,1,158,68,226,2.323529411764706
1525,2,505,71,576,7.112676056338028
1525,3,681,599,1280,1.1368948247078463
1525,4,1376,569,1945,2.4182776801405974
1525,5,2318,747,3065,3.103078982597055
1525,6,3117,623,3740,5.003210272873194
1525,7,3760,475,4235,7.91578947368421
1525,8,4540,511,5051,8.88454011741683
1525,9,5175,575,5750,9.0
1525,10,5817,1041,6858,5.587896253602305
1525,11,6866,414,7280,16.584541062801932
1525,12,7415,502,7917,14.770916334661354
1526,1,20,76,96,0.2631578947368421
1526,2,163,124,287,1.314516129032258
1526,3,357,94,451,3.797872340425532
1527,1,8,3,11,2.6666666666666665
1527,2,16,116,132,0.13793103448275862
1528,1,109,378,487,0.28835978835978837
1528,2,490,383,873,1.279373368146214
1528,3,876,388,1264,2.2577319587628866
1528,4,1267,382,1649,3.316753926701571
1528,5,1652,375,2027,4.405333333333333
1528,6,2030,384,2414,5.286458333333333
1528,7,2417,375,2792,6.445333333333333
1528,8,2795,376,3171,7.433510638297872
1528,9,3174,362,3536,8.767955801104973
1528,10,3539,378,3917,9.362433862433862
1528,11,3920,368,4288,10.652173913043478
1528,12,4291,379,4670,11.321899736147758
1528,13,4673,378,5051,12.362433862433862
1528,14,5054,321,5375,15.744548286604362
1528,15,5378,296,5674,18.16891891891892
1529,1,527,231,758,2.2813852813852815
1529,2,786,560,1346,1.4035714285714285
1529,3,1370,362,1732,3.7845303867403315
1529,4,1749,612,2361,2.857843137254902
1530,1,63,338,401,0.1863905325443787
1530,2,409,340,749,1.2029411764705882
1530,3,757,320,1077,2.365625
1530,4,1085,349,1434,3.108882521489971
1530,5,1442,116,1558,12.431034482758621
1531,1,144,557,701,0.2585278276481149
1531,2,718,546,1264,1.315018315018315
1532,1,31,389,420,0.07969151670951156
1532,2,428,444,872,0.963963963963964
1532,3,880,413,1293,2.1307506053268765
1532,4,1301,312,1613,4.169871794871795
1532,5,1633,750,2383,2.1773333333333333
1533,1,158,305,463,0.5180327868852459
1534,1,19,363,382,0.05234159779614325
1534,2,389,254,643,1.531496062992126
1534,3,721,111,832,6.495495495495495
1534,4,1117,315,1432,3.546031746031746
1534,5,1452,762,2214,1.905511811023622
1534,6,2445,372,2817,6.57258064516129
1534,7,2852,527,3379,5.411764705882353
1534,8,3395,162,3557,20.95679012345679
1534,9,3572,431,4003,8.287703016241299
1534,10,4017,303,4320,13.257425742574258
1534,11,4473,521,4994,8.585412667946256
1534,12,5001,15,5016,333.4
1534,13,5172,400,5572,12.93
1534,14,5582,196,5778,28.479591836734695
1534,15,5800,330,6130,17.575757575757574
1534,16,6156,361,6517,17.05263157894737
1534,17,7109,294,7403,24.18027210884354
1534,18,7413,338,7751,21.931952662721894
1535,1,51,313,364,0.16293929712460065
1536,1,176,843,1019,0.20877817319098457
1536,2,5157,28,5185,184.17857142857142
1536,3,5207,62,5269,83.98387096774194
1536,4,5293,230,5523,23.01304347826087
1537,1,26,464,490,0.05603448275862069
1538,1,16,666,682,0.024024024024024024
1538,2,695,738,1433,0.9417344173441734
1538,3,1496,747,2243,2.002677376171352
1538,4,2281,791,3072,2.8836915297092287
1539,1,19,226,245,0.084070796460177
1539,2,259,304,563,0.8519736842105263
1539,3,603,391,994,1.5421994884910486
1539,4,1003,410,1413,2.446341463414634
1539,5,1467,369,1836,3.975609756097561
1539,6,1942,579,2521,3.35405872193437
1539,7,2534,153,2687,16.562091503267975
1539,8,2774,161,2935,17.229813664596275
1539,9,2977,268,3245,11.10820895522388
1540,1,48,700,748,0.06857142857142857
1540,2,785,793,1578,0.9899117276166457
1540,3,1614,877,2491,1.8403648802736603
1540,4,2542,969,3511,2.6233230134158925
1540,5,3545,743,4288,4.771197846567968
1540,6,4362,100,4462,43.62
1540,7,4546,924,5470,4.91991341991342
1541,1,340,486,826,0.6995884773662552
1542,1,1150,1177,2327,0.9770603228547153
1542,2,2339,809,3148,2.8912237330037085
1542,3,3323,3,3326,1107.6666666666667
1543,1,17,627,644,0.02711323763955343
1543,2,672,503,1175,1.3359840954274353
1543,3,1225,729,1954,1.6803840877914953
1544,1,10,109,119,0.09174311926605505
1544,2,145,202,347,0.7178217821782178
1545,1,56,417,473,0.1342925659472422
1545,2,485,398,883,1.2185929648241205
1545,3,899,703,1602,1.2788051209103841
1545,4,1621,783,2404,2.070242656449553
1545,5,2420,420,2840,5.761904761904762
1545,6,2857,585,3442,4.883760683760684
1545,7,3460,495,3955,6.98989898989899
1545,8,3980,487,4467,8.172484599589323
1545,9,4490,609,5099,7.372742200328407
1545,10,5119,733,5852,6.98362892223738
1545,11,5864,843,6707,6.956109134045077
1545,12,6709,872,7581,7.693807339449541
1546,1,923,1110,2033,0.8315315315315316
1547,1,13,623,636,0.02086677367576244
1547,2,659,380,1039,1.7342105263157894
1547,3,1060,547,1607,1.9378427787934187
1547,4,1617,695,2312,2.3266187050359712
1547,5,2380,740,3120,3.2162162162162162
1547,6,3129,387,3516,8.085271317829458
1547,7,3559,174,3733,20.45402298850575
1547,8,3745,131,3876,28.587786259541986
1547,9,3896,177,4073,22.01129943502825
1548,1,38,329,367,0.11550151975683891
1548,2,377,292,669,1.2910958904109588
1548,3,709,416,1125,1.7043269230769231
1549,1,211,527,738,0.40037950664136623
1549,2,847,354,1201,2.3926553672316384
1549,3,1302,465,1767,2.8
1550,1,80,47,127,1.702127659574468
1550,2,480,43,523,11.162790697674419
1550,3,995,7,1002,142.14285714285714
1550,4,1678,19,1697,88.3157894736842
1550,5,1706,27,1733,63.18518518518518
1550,6,1788,456,2244,3.9210526315789473
1550,7,2296,790,3086,2.9063291139240506
1550,8,3101,514,3615,6.033073929961089
1551,1,394,794,1188,0.49622166246851385
1552,1,262,110,372,2.381818181818182
1552,2,1005,64,1069,15.703125
1552,3,1075,119,1194,9.033613445378151
1552,4,1199,210,1409,5.70952380952381
1552,5,1415,360,1775,3.9305555555555554
1552,6,1781,476,2257,3.741596638655462
1552,7,2262,660,2922,3.4272727272727272
1552,8,2928,671,3599,4.363636363636363
1552,9,3605,382,3987,9.43717277486911
1552,10,3993,533,4526,7.49155722326454
1552,11,4532,295,4827,15.36271186440678
1553,1,1141,860,2001,1.3267441860465117
1553,2,2023,412,2435,4.910194174757281
1554,1,47,93,140,0.5053763440860215
1554,2,156,385,541,0.4051948051948052
1554,3,561,177,738,3.169491525423729
1554,4,762,443,1205,1.7200902934537246
1554,5,1229,717,1946,1.7140864714086472
1554,6,1983,804,2787,2.466417910447761
1554,7,2824,777,3601,3.6344916344916345
1554,8,3639,815,4454,4.465030674846626
1554,9,4488,642,5130,6.990654205607477
1554,10,5189,833,6022,6.229291716686674
1554,11,6079,813,6892,7.477244772447724
1554,12,6954,1007,7961,6.90566037735849
1555,1,139,96,235,1.4479166666666667
1555,2,251,76,327,3.3026315789473686
1555,3,341,116,457,2.939655172413793
1555,4,462,144,606,3.2083333333333335
1555,5,633,138,771,4.586956521739131
1555,6,783,109,892,7.18348623853211
1555,7,905,152,1057,5.953947368421052
1555,8,1076,113,1189,9.52212389380531
1555,9,1201,181,1382,6.6353591160221
1555,10,1393,160,1553,8.70625
1555,11,1569,187,1756,8.390374331550802
1556,1,65,74,139,0.8783783783783784
1556,2,251,181,432,1.3867403314917126
1556,3,527,882,1409,0.5975056689342404
1557,1,2534,826,3360,3.0677966101694913
1557,2,3364,677,4041,4.9689807976366325
1558,1,242,473,715,0.5116279069767442
1558,2,737,159,896,4.635220125786163
1558,3,911,403,1314,2.260545905707196
1558,4,1345,338,1683,3.9792899408284024
1559,1,72,304,376,0.23684210526315788
1559,2,643,818,1461,0.7860635696821516
1559,3,1466,634,2100,2.312302839116719
1559,4,2107,819,2926,2.572649572649573
1559,5,2931,762,3693,3.8464566929133857
1559,6,3725,466,4191,7.993562231759657
1559,7,4364,844,5208,5.170616113744076
1559,8,5213,717,5930,7.270571827057183
1559,9,5951,817,6768,7.283965728274174
1560,1,3933,701,4634,5.61055634807418
1560,2,4679,344,5023,13.601744186046512
1560,3,5072,464,5536,10.931034482758621
1560,4,5615,544,6159,10.321691176470589
1560,5,6233,685,6918,9.0992700729927
1561,1,21,443,464,0.04740406320541761
1561,2,485,525,1010,0.9238095238095239
1561,3,1039,330,1369,3.1484848484848484
1562,1,206,337,543,0.6112759643916914
1563,1,51,366,417,0.13934426229508196
1563,2,425,158,583,2.689873417721519
1564,1,2539,351,2890,7.233618233618234
1564,2,2918,478,3396,6.104602510460251
1564,3,3491,808,4299,4.320544554455446
1564,4,4441,543,4984,8.178637200736649
1565,1,68,907,975,0.07497243660418963
1565,2,985,904,1889,1.0896017699115044
1565,3,1891,891,2782,2.122334455667789
1565,4,2784,949,3733,2.933614330874605
1565,5,3735,952,4687,3.9233193277310923
1565,6,4689,579,5268,8.098445595854923
1566,1,170,635,805,0.2677165354330709
1567,1,13,316,329,0.04113924050632911
1567,2,352,448,800,0.7857142857142857
1567,3,814,341,1155,2.3870967741935485
1567,4,1171,230,1401,5.091304347826087
1567,5,1412,420,1832,3.361904761904762
1567,6,1855,15,1870,123.66666666666667
1568,1,1661,363,2024,4.575757575757576
1568,2,2027,300,2327,6.756666666666667
1568,3,2330,291,2621,8.006872852233677
1568,4,2624,233,2857,11.261802575107296
1568,5,2860,193,3053,14.818652849740932
1568,6,3056,178,3234,17.168539325842698
1568,7,3237,238,3475,13.600840336134453
1568,8,3478,381,3859,9.128608923884514
1568,9,3862,33,3895,117.03030303030303
1568,10,4217,297,4514,14.198653198653199
1568,11,4765,214,4979,22.266355140186917
1569,1,97,411,508,0.2360097323600973
1570,1,159,628,787,0.2531847133757962
1570,2,855,226,1081,3.7831858407079646
1570,3,1353,386,1739,3.505181347150259
1571,1,327,755,1082,0.433112582781457
1571,2,1087,628,1715,1.730891719745223
1571,3,1720,749,2469,2.2963951935914553
1572,1,31,675,706,0.045925925925925926
1572,2,734,264,998,2.7803030303030303
1573,1,43,387,430,0.1111111111111111
1573,2,432,435,867,0.993103448275862
1574,1,651,90,741,7.233333333333333
1574,2,759,30,789,25.3
1574,3,806,24,830,33.583333333333336
1574,4,886,380,1266,2.331578947368421
1574,5,1289,35,1324,36.82857142857143
1574,6,1346,86,1432,15.651162790697674
1574,7,1469,290,1759,5.06551724137931
1574,8,1796,308,2104,5.8311688311688314
1574,9,2168,420,2588,5.161904761904762
1574,10,2634,137,2771,19.226277372262775
1574,11,2829,159,2988,17.79245283018868
1574,12,3008,127,3135,23.68503937007874
1574,13,3151,63,3214,50.01587301587302
1574,14,3310,69,3379,47.971014492753625
1574,15,3400,79,3479,43.037974683544306
1574,16,3574,68,3642,52.55882352941177
1574,17,3657,60,3717,60.95
1575,1,53,836,889,0.06339712918660287
1576,1,532,646,1178,0.8235294117647058
1577,1,69,58,127,1.1896551724137931
1577,2,163,402,565,0.4054726368159204
1577,3,573,192,765,2.984375
1578,1,109,425,534,0.2564705882352941
1578,2,550,581,1131,0.9466437177280551
1578,3,1148,534,1682,2.149812734082397
1578,4,1697,644,2341,2.6350931677018634
1579,1,23,322,345,0.07142857142857142
1579,2,376,465,841,0.8086021505376344
1580,1,12,363,375,0.03305785123966942
1580,2,388,376,764,1.0319148936170213
1580,3,771,362,1133,2.1298342541436464
1581,1,161,47,208,3.425531914893617
1581,2,215,29,244,7.413793103448276
1581,3,623,231,854,2.696969696969697
1581,4,1025,121,1146,8.47107438016529
1581,5,1171,79,1250,14.822784810126583
1581,6,1263,144,1407,8.770833333333334
1581,7,1419,209,1628,6.7894736842105265
1581,8,1654,385,2039,4.296103896103896
1581,9,2058,413,2471,4.983050847457627
1581,10,2495,390,2885,6.397435897435898
1581,11,2890,131,3021,22.061068702290076
1581,12,3060,406,3466,7.536945812807882
1581,13,3484,349,3833,9.982808022922637
1581,14,3882,104,3986,37.32692307692308
1581,15,4081,258,4339,15.817829457364342
1581,16,4404,444,4848,9.91891891891892
1581,17,4895,539,5434,9.081632653061224
1581,18,5470,680,6150,8.044117647058824
1581,19,6173,636,6809,9.705974842767295
1581,20,6850,781,7631,8.770806658130601
1581,21,7652,250,7902,30.608
1582,1,70,61,131,1.1475409836065573
1582,2,143,597,740,0.23953098827470687
1582,3,744,348,1092,2.1379310344827585
1582,4,1121,417,1538,2.6882494004796165
1582,5,1598,152,1750,10.513157894736842
1582,6,1781,351,2132,5.074074074074074
1582,7,2171,409,2580,5.308068459657702
1583,1,157,123,280,1.2764227642276422
1584,1,38,542,580,0.07011070110701106
1584,2,622,652,1274,0.9539877300613497
1584,3,1383,573,1956,2.413612565445026
1584,4,2032,574,2606,3.5400696864111496
1584,5,2665,279,2944,9.551971326164875
1584,6,2975,307,3282,9.690553745928339
1584,7,3556,954,4510,3.7274633123689727
1584,8,4551,666,5217,6.833333333333333
1584,9,5233,374,5607,13.991978609625669
1584,10,5618,712,6330,7.890449438202247
1584,11,6501,878,7379,7.404328018223235
1584,12,7394,217,7611,34.07373271889401
1584,13,7628,86,7714,88.69767441860465
1584,14,7718,29,7747,266.13793103448273
1585,1,1167,196,1363,5.954081632653061
1585,2,1389,17,1406,81.70588235294117
1586,1,536,215,751,2.4930232558139536
1586,2,1349,400,1749,3.3725
1586,3,1778,315,2093,5.644444444444445
1586,4,2107,300,2407,7.023333333333333
1586,5,2702,492,3194,5.491869918699187
1587,1,228,247,475,0.9230769230769231
1587,2,513,520,1033,0.9865384615384616
1587,3,1068,360,1428,2.966666666666667
1587,4,1469,791,2260,1.8571428571428572
1587,5,2293,523,2816,4.384321223709369
1588,1,52,668,720,0.07784431137724551
1588,2,729,977,1706,0.7461617195496417
1588,3,1711,534,2245,3.204119850187266
1588,4,2254,951,3205,2.370136698212408
1588,5,3210,642,3852,5.0
1588,6,3861,995,4856,3.8804020100502514
1588,7,4861,934,5795,5.204496788008566
1588,8,5804,1004,6808,5.780876494023905
1589,1,12,87,99,0.13793103448275862
1589,2,169,174,343,0.9712643678160919
1589,3,393,150,543,2.62
1589,4,631,189,820,3.3386243386243386
1589,5,877,235,1112,3.7319148936170214
1590,1,55,56,111,0.9821428571428571
1590,2,148,609,757,0.24302134646962234
1591,1,25,683,708,0.036603221083455345
1591,2,782,842,1624,0.9287410926365796
1591,3,1633,302,1935,5.4072847682119205
1591,4,2021,844,2865,2.3945497630331753
1591,5,2872,338,3210,8.497041420118343
1591,6,3247,845,4092,3.842603550295858
1591,7,4123,616,4739,6.693181818181818
1591,8,4780,882,5662,5.419501133786848
1591,9,5669,598,6267,9.479933110367893
1591,10,6392,867,7259,7.372549019607843
1592,1,320,140,460,2.2857142857142856
1592,2,489,362,851,1.350828729281768
1592,3,884,359,1243,2.4623955431754876
1592,4,1363,389,1752,3.5038560411311055
1592,5,1754,265,2019,6.618867924528302
1592,6,2187,384,2571,5.6953125
1592,7,2577,156,2733,16.51923076923077
1592,8,2846,370,3216,7.691891891891892
1592,9,3218,307,3525,10.482084690553746
1592,10,3538,235,3773,15.05531914893617
1592,11,3784,232,4016,16.310344827586206
1593,1,38,593,631,0.06408094435075885
1593,2,654,351,1005,1.8632478632478633
1593,3,1072,928,2000,1.1551724137931034
1593,4,2108,496,2604,4.25
1593,5,2630,363,2993,7.245179063360881
1593,6,3004,286,3290,10.503496503496503
1593,7,3344,415,3759,8.057831325301205
1593,8,4015,740,4755,5.425675675675675
1593,9,4883,634,5517,7.701892744479495
1593,10,5540,784,6324,7.066326530612245
1593,11,6444,755,7199,8.535099337748344
1593,12,7214,535,7749,13.48411214953271
1593,13,7761,334,8095,23.236526946107784
1594,1,652,548,1200,1.1897810218978102
1595,1,25,702,727,0.03561253561253561
1595,2,743,225,968,3.3022222222222224
1595,3,1003,414,1417,2.422705314009662
1595,4,1462,704,2166,2.0767045454545454
1595,5,2227,670,2897,3.3238805970149254
1595,6,2930,558,3488,5.250896057347671
1595,7,3530,721,4251,4.895977808599167
1595,8,4309,817,5126,5.274173806609547
1595,9,5162,599,5761,8.617696160267112
1595,10,5804,680,6484,8.535294117647059
1595,11,6515,573,7088,11.369982547993018
1596,1,35,923,958,0.03791982665222102
1597,1,125,288,413,0.4340277777777778
1597,2,660,295,955,2.23728813559322
1597,3,1037,3,1040,345.6666666666667
1598,1,431,270,701,1.5962962962962963
1598,2,753,412,1165,1.8276699029126213
1598,3,1219,391,1610,3.1176470588235294
1598,4,1617,430,2047,3.76046511627907
1598,5,2054,382,2436,5.37696335078534
1598,6,2443,196,2639,12.464285714285714
1599,1,53,508,561,0.10433070866141732
1600,1,41,500,541,0.082
1601,1,96,700,796,0.13714285714285715
1602,1,39,261,300,0.14942528735632185
1602,2,317,479,796,0.6617954070981211
1603,1,23,234,257,0.09829059829059829
1603,2,276,304,580,0.9078947368421053
1603,3,609,269,878,2.2639405204460967
1603,4,908,347,1255,2.61671469740634
1603,5,1283,219,1502,5.858447488584475
1603,6,1515,254,1769,5.964566929133858
1603,7,1788,281,2069,6.362989323843417
1604,1,13,85,98,0.15294117647058825
1604,2,116,347,463,0.33429394812680113
1604,3,477,302,779,1.5794701986754967
1604,4,791,419,1210,1.8878281622911695
1605,1,1710,952,2662,1.796218487394958
1605,2,2664,669,3333,3.9820627802690582
1605,3,3388,975,4363,3.474871794871795
1605,4,4370,715,5085,6.111888111888112
1606,1,26,1105,1131,0.023529411764705882
1607,1,31,80,111,0.3875
1607,2,557,231,788,2.411255411255411
1607,3,810,29,839,27.93103448275862
1607,4,1624,3,1627,541.3333333333334
1607,5,2184,3,2187,728.0
1607,6,2962,3,2965,987.3333333333334
1607,7,2989,33,3022,90.57575757575758
1607,8,3741,3,3744,1247.0
1607,9,3756,159,3915,23.62264150943396
1607,10,5818,3,5821,1939.3333333333333
1607,11,5876,402,6278,14.616915422885572
1607,12,6337,443,6780,14.304740406320542
1607,13,6816,424,7240,16.07547169811321
1607,14,7288,427,7715,17.06791569086651
1608,1,61,784,845,0.0778061224489796
1608,2,848,65,913,13.046153846153846
1608,3,1290,544,1834,2.3713235294117645
1608,4,1879,336,2215,5.592261904761905
1608,5,2266,396,2662,5.722222222222222
1608,6,2713,337,3050,8.050445103857566
1608,7,3091,387,3478,7.987080103359173
1609,1,509,437,946,1.1647597254004576
1609,2,957,446,1403,2.1457399103139014
1609,3,1426,206,1632,6.922330097087379
1609,4,1644,169,1813,9.727810650887575
1609,5,1827,157,1984,11.636942675159236
1609,6,2001,199,2200,10.055276381909549
1609,7,2206,39,2245,56.56410256410256
1610,1,67,168,235,0.39880952380952384
1610,2,262,888,1150,0.29504504504504503
1610,3,1159,492,1651,2.355691056910569
1611,1,1286,193,1479,6.66321243523316
1611,2,1490,116,1606,12.844827586206897
1611,3,1699,213,1912,7.976525821596244
1611,4,1961,293,2254,6.69283276450512
1611,5,2310,396,2706,5.833333333333333
1611,6,2714,250,2964,10.856
1611,7,2972,310,3282,9.587096774193549
1612,1,101,2,103,50.5
1612,2,683,2,685,341.5
1612,3,1406,2,1408,703.0
1612,4,2224,2,2226,1112.0
1612,5,2601,539,3140,4.825602968460111
1612,6,3154,45,3199,70.08888888888889
1612,7,3246,38,3284,85.42105263157895
1612,8,3289,34,3323,96.73529411764706
1612,9,3492,159,3651,21.962264150943398
1612,10,3657,149,3806,24.543624161073826
1612,11,3855,48,3903,80.3125
1612,12,3906,41,3947,95.26829268292683
1612,13,3996,44,4040,90.81818181818181
1612,14,4062,32,4094,126.9375
1613,1,206,733,939,0.2810368349249659
1613,2,1440,108,1548,13.333333333333334
1613,3,2066,181,2247,11.414364640883978
1613,4,2287,325,2612,7.036923076923077
1613,5,2681,392,3073,6.839285714285714
1613,6,3195,337,3532,9.480712166172108
1613,7,3561,389,3950,9.154241645244216
1613,8,4542,273,4815,16.63736263736264
1614,1,17,405,422,0.04197530864197531
1614,2,436,422,858,1.033175355450237
1614,3,882,424,1306,2.080188679245283
1614,4,1318,334,1652,3.946107784431138
1614,5,1735,412,2147,4.211165048543689
1614,6,2203,362,2565,6.085635359116022
1614,7,2591,378,2969,6.854497354497354
1614,8,2992,375,3367,7.978666666666666
1614,9,3421,405,3826,8.446913580246914
1614,10,3835,592,4427,6.47804054054054
1614,11,4467,543,5010,8.226519337016574
1614,12,5027,512,5539,9.818359375
1614,13,5585,536,6121,10.419776119402986
1614,14,6155,496,6651,12.409274193548388
1614,15,6685,529,7214,12.637051039697543
1614,16,7274,472,7746,15.411016949152541
1615,1,89,889,978,0.10011248593925759
1615,2,981,734,1715,1.3365122615803815
1615,3,1736,921,2657,1.8849077090119435
1615,4,2738,954,3692,2.870020964360587
1615,5,3767,914,4681,4.121444201312911
1615,6,4683,512,5195,9.146484375
1615,7,5454,893,6347,6.107502799552072
1615,8,6349,409,6758,15.52322738386308
1616,1,19,683,702,0.027818448023426062
1617,1,118,93,211,1.2688172043010753
1618,1,767,178,945,4.308988764044944
1618,2,1112,345,1457,3.2231884057971016
1618,3,2144,199,2343,10.773869346733669
1618,4,2432,748,3180,3.251336898395722
1618,5,3216,643,3859,5.001555209953343
1618,6,3912,22,3934,177.8181818181818
1618,7,6109,188,6297,32.494680851063826
1618,8,6803,461,7264,14.757049891540131
1618,9,7282,574,7856,12.686411149825783
1619,1,20,336,356,0.05952380952380952
1619,2,367,281,648,1.3060498220640568
1619,3,664,448,1112,1.4821428571428572
1619,4,1129,483,1612,2.3374741200828155
1619,5,1624,120,1744,13.533333333333333
1619,6,1756,604,2360,2.9072847682119205
1619,7,2373,288,2661,8.239583333333334
1619,8,2678,492,3170,5.443089430894309
1619,9,3195,480,3675,6.65625
1619,10,3707,574,4281,6.458188153310105
1619,11,4293,328,4621,13.088414634146341
1619,12,4635,207,4842,22.391304347826086
1619,13,4864,209,5073,23.272727272727273
1619,14,5098,357,5455,14.280112044817928
1619,15,5477,397,5874,13.795969773299747
1619,16,5913,278,6191,21.269784172661872
1619,17,6212,371,6583,16.743935309973047
1619,18,6625,317,6942,20.899053627760253
1619,19,6952,361,7313,19.257617728531855
1619,20,7324,601,7925,12.186356073211314
1620,1,18,41,59,0.43902439024390244
1620,2,62,46,108,1.3478260869565217
1620,3,111,50,161,2.22
1620,4,165,54,219,3.0555555555555554
1620,5,223,64,287,3.484375
1620,6,296,119,415,2.4873949579831933
1620,7,419,72,491,5.819444444444445
1620,8,494,79,573,6.253164556962025
1620,9,577,87,664,6.632183908045977
1620,10,668,96,764,6.958333333333333
1620,11,768,106,874,7.245283018867925
1620,12,877,114,991,7.692982456140351
1620,13,994,122,1116,8.147540983606557
1620,14,1157,48,1205,24.104166666666668
1620,15,1208,22,1230,54.90909090909091
1620,16,1234,24,1258,51.416666666666664
1620,17,1275,96,1371,13.28125
1620,18,1374,23,1397,59.73913043478261
1620,19,1400,25,1425,56.0
1620,20,1432,29,1461,49.37931034482759
1620,21,1465,24,1489,61.041666666666664
1620,22,1493,28,1521,53.32142857142857
1620,23,1525,24,1549,63.541666666666664
1620,24,1553,22,1575,70.5909090909091
1620,25,1578,22,1600,71.72727272727273
1620,26,1603,23,1626,69.69565217391305
1620,27,1630,27,1657,60.370370370370374
1620,28,1661,22,1683,75.5
1620,29,1687,23,1710,73.34782608695652
1620,30,1714,24,1738,71.41666666666667
1620,31,1744,30,1774,58.13333333333333
1620,32,1777,23,1800,77.26086956521739
1620,33,1803,23,1826,78.3913043478261
1620,34,1829,24,1853,76.20833333333333
1620,35,1857,23,1880,80.73913043478261
1620,36,1884,27,1911,69.77777777777777
1620,37,1916,27,1943,70.96296296296296
1620,38,1947,22,1969,88.5
1620,39,1972,22,1994,89.63636363636364
1620,40,1998,23,2021,86.8695652173913
1620,41,2025,24,2049,84.375
1620,42,2053,42,2095,48.88095238095238
1620,43,2107,27,2134,78.03703703703704
1620,44,2139,33,2172,64.81818181818181
1620,45,2177,31,2208,70.2258064516129
1620,46,2211,22,2233,100.5
1620,47,2238,26,2264,86.07692307692308
1620,48,2269,30,2299,75.63333333333334
1620,49,2304,37,2341,62.270270270270274
1620,50,2350,33,2383,71.21212121212122
1620,51,2386,23,2409,103.73913043478261
1620,52,2413,22,2435,109.68181818181819
1620,53,2439,23,2462,106.04347826086956
1620,54,2465,23,2488,107.17391304347827
1620,55,2493,27,2520,92.33333333333333
1620,56,2524,25,2549,100.96
1621,1,128,735,863,0.17414965986394557
1621,2,987,973,1960,1.014388489208633
1621,3,1970,805,2775,2.4472049689440993
1622,1,1063,145,1208,7.3310344827586205
1622,2,1212,154,1366,7.87012987012987
1622,3,1370,158,1528,8.670886075949367
1622,4,1532,151,1683,10.14569536423841
1622,5,1687,137,1824,12.313868613138686
1623,1,90,691,781,0.13024602026049203
1623,2,795,454,1249,1.751101321585903
1623,3,1269,677,1946,1.8744460856720828
1624,1,43,307,350,0.14006514657980457
1624,2,365,93,458,3.924731182795699
1624,3,477,308,785,1.5487012987012987
1625,1,31,330,361,0.09393939393939393
1625,2,368,939,1307,0.3919062832800852
1626,1,18,512,530,0.03515625
1626,2,552,523,1075,1.0554493307839388
1626,3,1089,484,1573,2.25
1627,1,161,901,1062,0.17869034406215317
1627,2,1069,454,1523,2.354625550660793
1628,1,462,832,1294,0.5552884615384616
1628,2,1382,641,2023,2.15600624024961
1628,3,2061,713,2774,2.8906030855539973
1628,4,2786,640,3426,4.353125
1628,5,3462,1056,4518,3.278409090909091
1628,6,4844,695,5539,6.96978417266187
1628,7,5621,686,6307,8.193877551020408
1628,8,6415,211,6626,30.402843601895736
1628,9,6665,164,6829,40.640243902439025
1628,10,6873,692,7565,9.93208092485549
1629,1,37,407,444,0.09090909090909091
1630,1,31,375,406,0.08266666666666667
1630,2,412,306,718,1.34640522875817
1631,1,92,66,158,1.393939393939394
1631,2,425,2,427,212.5
1631,3,944,2,946,472.0
1631,4,1508,2,1510,754.0
1631,5,2035,2,2037,1017.5
1631,6,2503,2,2505,1251.5
1631,7,2959,2,2961,1479.5
1631,8,3464,2,3466,1732.0
1631,9,3949,2,3951,1974.5
1631,10,4357,205,4562,21.253658536585366
1632,1,1112,587,1699,1.8943781942078364
1633,1,9,293,302,0.030716723549488054
1633,2,344,363,707,0.9476584022038568
1633,3,716,436,1152,1.6422018348623852
1633,4,1170,299,1469,3.9130434782608696
1633,5,1481,356,1837,4.160112359550562
1633,6,1846,229,2075,8.06113537117904
1633,7,2106,292,2398,7.212328767123288
1633,8,2409,378,2787,6.373015873015873
1633,9,2799,396,3195,7.068181818181818
1633,10,3241,470,3711,6.895744680851064
1633,11,3715,435,4150,8.540229885057471
1633,12,4155,443,4598,9.37923250564334
1633,13,4604,481,5085,9.571725571725572
1634,1,39,170,209,0.22941176470588234
1634,2,241,105,346,2.295238095238095
1634,3,352,134,486,2.626865671641791
1634,4,530,172,702,3.0813953488372094
1635,1,80,352,432,0.22727272727272727
1635,2,451,472,923,0.9555084745762712
1635,3,935,337,1272,2.7744807121661723
1635,4,1289,335,1624,3.8477611940298506
1635,5,1645,302,1947,5.447019867549669
1635,6,1966,338,2304,5.816568047337278
1635,7,2315,251,2566,9.223107569721115
1635,8,2800,445,3245,6.292134831460674
1635,9,3265,436,3701,7.488532110091743
1635,10,3755,438,4193,8.573059360730594
1635,11,4212,456,4668,9.236842105263158
1635,12,4685,250,4935,18.74
1635,13,5013,456,5469,10.993421052631579
1635,14,5484,435,5919,12.606896551724137
1635,15,5925,248,6173,23.891129032258064
1635,16,6241,391,6632,15.961636828644501
1635,17,6659,489,7148,13.61758691206544
1636,1,130,134,264,0.9701492537313433
1636,2,266,371,637,0.7169811320754716
1636,3,643,384,1027,1.6744791666666667
1636,4,1029,436,1465,2.360091743119266
1636,5,1467,400,1867,3.6675
1637,1,162,290,452,0.5586206896551724
1637,2,459,387,846,1.186046511627907
1637,3,957,876,1833,1.0924657534246576
1637,4,1854,875,2729,2.1188571428571428
1637,5,2749,874,3623,3.145308924485126
1637,6,3694,834,4528,4.429256594724221
1637,7,4570,266,4836,17.18045112781955
1637,8,4918,309,5227,15.915857605177994
1637,9,5279,526,5805,10.036121673003802
1638,1,329,592,921,0.5557432432432432
1638,2,956,727,1683,1.314993122420908
1639,1,29,559,588,0.0518783542039356
1639,2,611,994,1605,0.6146881287726358
1640,1,412,939,1351,0.4387646432374867
1641,1,210,625,835,0.336
1641,2,850,442,1292,1.9230769230769231
1641,3,1307,418,1725,3.126794258373206
1641,4,1740,342,2082,5.087719298245614
1641,5,2097,406,2503,5.165024630541872
1641,6,2518,435,2953,5.788505747126437
1641,7,2968,491,3459,6.044806517311609
1641,8,3474,528,4002,6.579545454545454
1641,9,4017,447,4464,8.986577181208053
1641,10,4479,315,4794,14.219047619047618
1641,11,4809,419,5228,11.477326968973747
1642,1,18,73,91,0.2465753424657534
1642,2,138,169,307,0.8165680473372781
1642,3,344,154,498,2.2337662337662336
1642,4,578,199,777,2.9045226130653266
1642,5,817,132,949,6.1893939393939394
1642,6,975,194,1169,5.025773195876289
1642,7,1254,259,1513,4.841698841698841
1642,8,1530,284,1814,5.387323943661972
1642,9,1908,282,2190,6.76595744680851
1642,10,2247,315,2562,7.133333333333334
1642,11,2589,243,2832,10.654320987654321
1642,12,2886,372,3258,7.758064516129032
1642,13,3307,293,3600,11.286689419795222
1642,14,3636,298,3934,12.201342281879194
1642,15,3996,247,4243,16.178137651821864
1642,16,4311,338,4649,12.754437869822485
1642,17,4708,290,4998,16.23448275862069
1643,1,420,944,1364,0.4449152542372881
1643,2,1366,485,1851,2.816494845360825
1643,3,1876,914,2790,2.052516411378556
1643,4,2792,250,3042,11.168
1643,5,3059,221,3280,13.841628959276019
1643,6,3297,143,3440,23.055944055944057
1643,7,3462,417,3879,8.302158273381295
1643,8,3881,455,4336,8.52967032967033
1643,9,4338,481,4819,9.018711018711018
1644,1,44,953,997,0.046169989506820566
1645,1,357,175,532,2.04
1645,2,896,915,1811,0.9792349726775956
1646,1,32,502,534,0.06374501992031872
1646,2,601,420,1021,1.430952380952381
1646,3,1050,107,1157,9.813084112149532
1646,4,1229,301,1530,4.083056478405315
1646,5,1603,418,2021,3.834928229665072
1646,6,2033,443,2476,4.589164785553048
1646,7,2522,198,2720,12.737373737373737
1646,8,2813,491,3304,5.729124236252546
1646,9,3344,451,3795,7.414634146341464
1647,1,32,577,609,0.05545927209705372
1648,1,17,428,445,0.0397196261682243
1649,1,436,1008,1444,0.43253968253968256
1649,2,1447,603,2050,2.399668325041459
1649,3,2053,497,2550,4.130784708249497
1649,4,2568,736,3304,3.489130434782609
1649,5,3316,28,3344,118.42857142857143
1649,6,3353,499,3852,6.719438877755511
1649,7,3860,729,4589,5.2949245541838135
1650,1,344,1008,1352,0.3412698412698413
1650,2,1365,988,2353,1.381578947368421
1650,3,2366,811,3177,2.917385943279901
1650,4,3189,413,3602,7.721549636803874
1650,5,3627,871,4498,4.164179104477612
1650,6,4522,755,5277,5.989403973509933
1651,1,35,23,58,1.5217391304347827
1651,2,3394,17,3411,199.64705882352942
1651,3,6657,19,6676,350.36842105263156
1652,1,29,581,610,0.04991394148020654
1652,2,627,687,1314,0.9126637554585153
1652,3,1318,571,1889,2.308231173380035
1653,1,7,596,603,0.01174496644295302
1653,2,622,634,1256,0.9810725552050473
1653,3,1270,569,1839,2.231985940246046
1653,4,1858,518,2376,3.586872586872587
1653,5,2391,470,2861,5.087234042553192
1653,6,2876,525,3401,5.478095238095238
1653,7,3432,700,4132,4.902857142857143
1653,8,4140,61,4201,67.8688524590164
1653,9,4214,382,4596,11.031413612565444
1653,10,4608,251,4859,18.358565737051794
1653,11,4877,492,5369,9.91260162601626
1653,12,5398,530,5928,10.184905660377359
1653,13,5940,189,6129,31.428571428571427
1653,14,6148,378,6526,16.264550264550266
1653,15,6559,472,7031,13.896186440677965
1653,16,7037,414,7451,16.997584541062803
1653,17,7467,477,7944,15.654088050314465
1654,1,34,5,39,6.8
1654,2,52,46,98,1.1304347826086956
1654,3,111,25,136,4.44
1654,4,150,14,164,10.714285714285714
1654,5,190,26,216,7.3076923076923075
1655,1,25,528,553,0.04734848484848485
1656,1,344,157,501,2.1910828025477707
1656,2,536,213,749,2.516431924882629
1656,3,775,697,1472,1.1119081779053084
1657,1,51,1234,1285,0.041329011345218804
1657,2,1345,1133,2478,1.1871138570167696
1657,3,2538,1072,3610,2.3675373134328357
1657,4,3878,1021,4899,3.7982370225269344
1657,5,4970,839,5809,5.923718712753278
1658,1,64,34,98,1.8823529411764706
1658,2,103,251,354,0.4103585657370518
1659,1,30,956,986,0.03138075313807531
1659,2,1052,693,1745,1.518037518037518
1659,3,1777,731,2508,2.4309165526675787
1659,4,2535,692,3227,3.663294797687861
1659,5,3258,662,3920,4.921450151057402
1659,6,3936,505,4441,7.794059405940594
1660,1,892,533,1425,1.673545966228893
1660,2,1466,521,1987,2.8138195777351247
1660,3,2053,595,2648,3.450420168067227
1660,4,2761,599,3360,4.609348914858097
1660,5,3371,47,3418,71.72340425531915
1660,6,5396,663,6059,8.138763197586727
1660,7,6445,846,7291,7.618203309692672
1660,8,7351,463,7814,15.876889848812095
1661,1,55,753,808,0.07304116865869854
1661,2,848,702,1550,1.207977207977208
1661,3,1569,552,2121,2.842391304347826
1661,4,2136,364,2500,5.868131868131868
1661,5,2527,1065,3592,2.3727699530516433
1662,1,50,702,752,0.07122507122507123
1662,2,772,879,1651,0.8782707622298066
1662,3,1685,753,2438,2.237715803452855
1662,4,2496,235,2731,10.62127659574468
1662,5,2752,535,3287,5.14392523364486
1662,6,3326,618,3944,5.381877022653722
1662,7,3967,793,4760,5.002522068095838
1662,8,4791,475,5266,10.086315789473684
1662,9,5287,531,5818,9.95668549905838
1662,10,5864,684,6548,8.573099415204679
1662,11,6578,319,6897,20.620689655172413
1662,12,6913,313,7226,22.08626198083067
1662,13,7250,440,7690,16.477272727272727
1662,14,7716,326,8042,23.66871165644172
1663,1,41,59,100,0.6949152542372882
1663,2,460,2,462,230.0
1663,3,743,2,745,371.5
1663,4,951,2,953,475.5
1663,5,1010,813,1823,1.2423124231242313
1663,6,1863,568,2431,3.2799295774647885
1664,1,3667,227,3894,16.154185022026432
1664,2,7636,280,7916,27.271428571428572
1665,1,40,106,146,0.37735849056603776
1666,1,1819,539,2358,3.3747680890538034
1666,2,4081,316,4397,12.914556962025317
1666,3,5853,457,6310,12.807439824945295
1667,1,379,267,646,1.4194756554307115
1668,1,72,12,84,6.0
1668,2,93,9,102,10.333333333333334
1668,3,171,312,483,0.5480769230769231
1668,4,491,37,528,13.27027027027027
1668,5,576,521,1097,1.1055662188099808
1668,6,1144,263,1407,4.349809885931559
1668,7,1435,529,1964,2.712665406427221
1668,8,1967,55,2022,35.763636363636365
1668,9,2032,19,2051,106.94736842105263
1668,10,2158,493,2651,4.377281947261663
1668,11,2766,523,3289,5.288718929254302
1668,12,3347,435,3782,7.694252873563219
1668,13,3804,143,3947,26.6013986013986
1668,14,3979,473,4452,8.412262156448202
1668,15,4484,414,4898,10.830917874396135
1668,16,4974,668,5642,7.446107784431137
1668,17,5658,106,5764,53.37735849056604
1668,18,5766,52,5818,110.88461538461539
1668,19,5936,403,6339,14.72952853598015
1668,20,6528,382,6910,17.089005235602095
1668,21,6932,36,6968,192.55555555555554
1668,22,7030,406,7436,17.31527093596059
1669,1,198,419,617,0.47255369928400953
1669,2,758,341,1099,2.222873900293255
1670,1,1064,202,1266,5.267326732673268
1671,1,23,843,866,0.027283511269276393
1672,1,20,769,789,0.02600780234070221
1673,1,465,891,1356,0.5218855218855218
1674,1,40,942,982,0.04246284501061571
1674,2,1005,474,1479,2.1202531645569622
1674,3,1494,597,2091,2.5025125628140703
1674,4,2101,69,2170,30.44927536231884
1674,5,2199,330,2529,6.663636363636364
1674,6,2552,486,3038,5.251028806584362
1675,1,14,453,467,0.03090507726269316
1676,1,2013,327,2340,6.155963302752293
1676,2,2343,379,2722,6.1820580474934035
1676,3,2725,370,3095,7.364864864864865
1676,4,3098,348,3446,8.902298850574713
1676,5,3455,389,3844,8.881748071979434
1676,6,3847,296,4143,12.996621621621621
1677,1,7,399,406,0.017543859649122806
1677,2,431,797,1228,0.5407779171894604
1678,1,13,300,313,0.043333333333333335
1679,1,58,964,1022,0.06016597510373444
1679,2,1024,180,1204,5.688888888888889
1680,1,126,742,868,0.16981132075471697
1681,1,14,62,76,0.22580645161290322
1681,2,176,373,549,0.4718498659517426
1681,3,572,394,966,1.4517766497461928
1681,4,1258,506,1764,2.486166007905138
1682,1,57,708,765,0.08050847457627118
1683,1,1409,236,1645,5.970338983050848
1683,2,1665,337,2002,4.940652818991098
1684,1,26,368,394,0.07065217391304347
1684,2,406,617,1023,0.6580226904376013
1684,3,1065,717,1782,1.4853556485355648
1684,4,1807,845,2652,2.1384615384615384
1685,1,27,660,687,0.04090909090909091
1686,1,830,71,901,11.690140845070422
1686,2,2127,86,2213,24.732558139534884
1686,3,2307,86,2393,26.825581395348838
1686,4,2413,425,2838,5.6776470588235295
1686,5,2898,622,3520,4.659163987138264
1686,6,3590,660,4250,5.4393939393939394
1686,7,4636,703,5339,6.594594594594595
1686,8,5786,150,5936,38.57333333333333
1686,9,6419,166,6585,38.66867469879518
1686,10,6996,153,7149,45.72549019607843
1686,11,7217,889,8106,8.118110236220472
1687,1,15,486,501,0.030864197530864196
1688,1,184,880,1064,0.20909090909090908
1688,2,1081,185,1266,5.8432432432432435
1689,1,9,64,73,0.140625
1689,2,87,75,162,1.16
1689,3,1246,334,1580,3.730538922155689
1689,4,4802,33,4835,145.5151515151515
1690,1,23,1008,1031,0.022817460317460316
1690,2,1033,521,1554,1.982725527831094
1690,3,1703,699,2402,2.436337625178827
1690,4,2422,638,3060,3.7962382445141065
1690,5,3073,790,3863,3.889873417721519
1690,6,3932,713,4645,5.514726507713885
1690,7,4693,621,5314,7.557165861513687
1690,8,5338,485,5823,11.00618556701031
1691,1,1339,1078,2417,1.2421150278293136
1691,2,2425,1059,3484,2.289896128423041
1691,3,4061,826,4887,4.916464891041162
1691,4,4896,815,5711,6.007361963190184
1691,5,6155,584,6739,10.539383561643836
1691,6,6778,1027,7805,6.599805258033106
1692,1,22,575,597,0.03826086956521739
1692,2,622,660,1282,0.9424242424242424
1692,3,1295,469,1764,2.7611940298507465
1692,4,1818,883,2701,2.0588901472253682
1692,5,2740,842,3582,3.2541567695961997
1692,6,3611,749,4360,4.8210947930574095
1692,7,4410,919,5329,4.7986942328618065
1693,1,57,245,302,0.23265306122448978
1693,2,343,243,586,1.4115226337448559
1693,3,833,291,1124,2.8625429553264605
1693,4,1185,242,1427,4.896694214876033
1693,5,1485,232,1717,6.400862068965517
1693,6,1906,280,2186,6.807142857142857
1693,7,2550,355,2905,7.183098591549296
1693,8,3108,921,4029,3.3745928338762217
1693,9,4267,965,5232,4.421761658031088
1694,1,39,682,721,0.05718475073313783
1695,1,41,687,728,0.05967976710334789
1695,2,730,630,1360,1.1587301587301588
1695,3,1362,572,1934,2.3811188811188813
1696,1,302,75,377,4.026666666666666
1697,1,53,508,561,0.10433070866141732
1698,1,626,477,1103,1.3123689727463312
1699,1,225,806,1031,0.27915632754342434
1699,2,1039,673,1712,1.5438335809806836
1699,3,1892,802,2694,2.3591022443890273
1699,4,2702,809,3511,3.3399258343634117
1699,5,3519,804,4323,4.376865671641791
1699,6,4328,753,5081,5.747675962815405
1699,7,5179,833,6012,6.217286914765906
1699,8,6017,507,6524,11.86785009861933
1699,9,6574,178,6752,36.93258426966292
1699,10,6757,809,7566,8.352286773794809
1699,11,7571,530,8101,14.284905660377358
1700,1,19,283,302,0.06713780918727916
1700,2,331,464,795,0.7133620689655172
1700,3,863,819,1682,1.0537240537240538
1700,4,1785,677,2462,2.636632200886263
1700,5,2612,550,3162,4.749090909090909
1700,6,3222,584,3806,5.517123287671233
1701,1,11,390,401,0.028205128205128206
1701,2,422,571,993,0.7390542907180385
1702,1,26,610,636,0.04262295081967213
1702,2,644,158,802,4.075949367088608
1702,3,809,560,1369,1.4446428571428571
1702,4,1398,693,2091,2.017316017316017
1702,5,2159,989,3148,2.1830131445904954
1702,6,3172,1041,4213,3.047070124879923
1702,7,4468,1012,5480,4.41501976284585
1702,8,5603,1094,6697,5.121572212065813
1702,9,6706,1076,7782,6.232342007434944
1703,1,36,596,632,0.06040268456375839
1703,2,641,672,1313,0.9538690476190477
1703,3,1334,469,1803,2.8443496801705757
1703,4,1815,462,2277,3.9285714285714284
1703,5,2285,479,2764,4.77035490605428
1703,6,2771,503,3274,5.508946322067595
1703,7,3293,358,3651,9.19832402234637
1703,8,3665,479,4144,7.651356993736952
1703,9,4151,488,4639,8.506147540983607
1703,10,4645,479,5124,9.697286012526096
1703,11,5148,542,5690,9.498154981549815
1703,12,5756,982,6738,5.861507128309572
1703,13,6741,364,7105,18.51923076923077
1703,14,7118,605,7723,11.765289256198347
1704,1,88,395,483,0.22278481012658227
1705,1,510,703,1213,0.7254623044096729
1705,2,1378,537,1915,2.5661080074487894
1705,3,1967,238,2205,8.264705882352942
1705,4,2220,639,2859,3.4741784037558685
1705,5,2867,647,3514,4.431221020092735
1705,6,3555,640,4195,5.5546875
1705,7,4236,683,4919,6.202049780380674
1705,8,4979,647,5626,7.695517774343122
1705,9,5653,758,6411,7.45778364116095
1705,10,6478,734,7212,8.825613079019073
1705,11,7228,619,7847,11.676898222940226
1706,1,1729,646,2375,2.676470588235294
1706,2,2505,957,3462,2.6175548589341693
1706,3,3465,496,3961,6.985887096774194
1707,1,150,294,444,0.5102040816326531
1707,2,457,246,703,1.8577235772357723
1708,1,3516,282,3798,12.46808510638298
1709,1,17,235,252,0.07234042553191489
1709,2,272,279,551,0.974910394265233
1709,3,577,383,960,1.5065274151436032
1709,4,989,727,1716,1.360385144429161
1709,5,1738,212,1950,8.19811320754717
1709,6,1966,270,2236,7.281481481481482
1709,7,2266,409,2675,5.540342298288508
1709,8,2690,461,3151,5.835140997830803
1710,1,120,440,560,0.2727272727272727
1710,2,569,221,790,2.574660633484163
1711,1,47,811,858,0.05795314426633785
1711,2,869,699,1568,1.2432045779685266
1711,3,1605,472,2077,3.4004237288135593
1712,1,34,36,70,0.9444444444444444
1712,2,1300,290,1590,4.482758620689655
1712,3,1606,404,2010,3.9752475247524752
1713,1,47,445,492,0.10561797752808989
1713,2,544,672,1216,0.8095238095238095
1713,3,1229,689,1918,1.783744557329463
1714,1,234,391,625,0.59846547314578
1714,2,666,661,1327,1.0075642965204237
1715,1,80,45,125,1.7777777777777777
1715,2,422,4,426,105.5
1715,3,1018,4,1022,254.5
1715,4,3840,4,3844,960.0
1715,5,3846,365,4211,10.536986301369863
1716,1,44,845,889,0.05207100591715976
1716,2,932,1002,1934,0.9301397205588823
1717,1,35,255,290,0.13725490196078433
1718,1,214,674,888,0.31750741839762614
1718,2,972,524,1496,1.8549618320610688
1718,3,1691,640,2331,2.6421875
1718,4,2344,54,2398,43.407407407407405
1718,5,2507,374,2881,6.7032085561497325
1718,6,2995,111,3106,26.98198198198198
1718,7,3266,528,3794,6.1856060606060606
1718,8,3845,662,4507,5.808157099697885
1719,1,87,492,579,0.17682926829268292
1719,2,596,544,1140,1.0955882352941178
1720,1,27,393,420,0.06870229007633588
1721,1,2,24,26,0.08333333333333333
1722,1,28,652,680,0.04294478527607362
1722,2,715,539,1254,1.3265306122448979
1722,3,1284,936,2220,1.3717948717948718
1722,4,2225,59,2284,37.71186440677966
1722,5,2299,38,2337,60.5
1723,1,57,695,752,0.08201438848920864
1723,2,785,557,1342,1.4093357271095153
1724,1,126,860,986,0.14651162790697675
1724,2,994,784,1778,1.2678571428571428
1724,3,1833,855,2688,2.143859649122807
1724,4,2696,510,3206,5.286274509803921
1725,1,3859,97,3956,39.78350515463917
1725,2,3964,55,4019,72.07272727272728
1725,3,4024,258,4282,15.5968992248062
1725,4,4315,466,4781,9.259656652360515
1725,5,4823,352,5175,13.701704545454545
1725,6,5182,92,5274,56.32608695652174
1725,7,5287,533,5820,9.919324577861163
1726,1,451,911,1362,0.4950603732162459
1726,2,1364,388,1752,3.515463917525773
1727,1,87,744,831,0.11693548387096774
1727,2,862,630,1492,1.3682539682539683
1727,3,1517,826,2343,1.8365617433414043
1727,4,2381,413,2794,5.765133171912833
1728,1,49,184,233,0.266304347826087
1728,2,269,623,892,0.4317817014446228
1728,3,949,565,1514,1.679646017699115
1728,4,1602,328,1930,4.884146341463414
1729,1,342,386,728,0.8860103626943006
1729,2,741,402,1143,1.8432835820895523
1729,3,1156,441,1597,2.621315192743764
1729,4,1610,363,1973,4.435261707988981
1729,5,1986,419,2405,4.7398568019093075
1729,6,2418,408,2826,5.926470588235294
1730,1,3013,840,3853,3.586904761904762
1730,2,3871,508,4379,7.6200787401574805
1730,3,6876,513,7389,13.403508771929825
1730,4,7404,679,8083,10.904270986745214
1731,1,38,593,631,0.06408094435075885
1731,2,654,351,1005,1.8632478632478633
1731,3,1072,928,2000,1.1551724137931034
1731,4,2108,496,2604,4.25
1731,5,2630,363,2993,7.245179063360881
1731,6,3004,286,3290,10.503496503496503
1731,7,3344,415,3759,8.057831325301205
1731,8,4015,740,4755,5.425675675675675
1731,9,4883,634,5517,7.701892744479495
1731,10,5540,784,6324,7.066326530612245
1731,11,6444,755,7199,8.535099337748344
1731,12,7214,535,7749,13.48411214953271
1731,13,7761,334,8095,23.236526946107784
1732,1,2219,380,2599,5.839473684210526
1732,2,2608,391,2999,6.670076726342711
1732,3,3001,503,3504,5.966202783300199
1732,4,3506,809,4315,4.333745364647713
1732,5,4317,902,5219,4.786031042128603
1732,6,5221,771,5992,6.7717250324254215
1732,7,5994,869,6863,6.897583429228999
1732,8,6865,724,7589,9.482044198895027
1733,1,1064,692,1756,1.5375722543352601
1733,2,1765,875,2640,2.0171428571428573
1733,3,2673,567,3240,4.714285714285714
1734,1,106,390,496,0.2717948717948718
1734,2,504,403,907,1.250620347394541
1734,3,912,539,1451,1.6920222634508348
1735,1,38,46,84,0.8260869565217391
1735,2,227,585,812,0.38803418803418804
1735,3,911,5,916,182.2
1735,4,1428,5,1433,285.6
1735,5,3160,5,3165,632.0
1735,6,4489,5,4494,897.8
1735,7,6692,5,6697,1338.4
1735,8,8014,5,8019,1602.8
1736,1,69,67,136,1.0298507462686568
1736,2,1348,721,2069,1.869625520110957
1736,3,2215,855,3070,2.590643274853801
1736,4,3229,881,4110,3.6651532349602722
1737,1,64,787,851,0.08132147395171538
1738,1,20,326,346,0.06134969325153374
1738,2,348,314,662,1.10828025477707
1738,3,664,77,741,8.623376623376624
1738,4,1496,149,1645,10.04026845637584
1738,5,1659,77,1736,21.545454545454547
1738,6,1766,106,1872,16.660377358490567
1738,7,1890,74,1964,25.54054054054054
1738,8,1979,43,2022,46.02325581395349
1738,9,2044,71,2115,28.788732394366196
1738,10,2127,102,2229,20.852941176470587
1738,11,2278,680,2958,3.35
1738,12,2965,58,3023,51.12068965517241
1738,13,3041,478,3519,6.361924686192468
1738,14,3522,35,3557,100.62857142857143
1738,15,4470,296,4766,15.10135135135135
1738,16,4783,525,5308,9.11047619047619
1739,1,20,326,346,0.06134969325153374
1739,2,348,314,662,1.10828025477707
1739,3,664,77,741,8.623376623376624
1740,1,1821,820,2641,2.220731707317073
1740,2,2694,961,3655,2.8033298647242457
1740,3,3936,704,4640,5.590909090909091
1740,4,4668,947,5615,4.929250263991552
1740,5,5634,878,6512,6.4168564920273345
1741,1,17,122,139,0.13934426229508196
1741,2,143,320,463,0.446875
1741,3,473,691,1164,0.6845151953690304
1742,1,122,660,782,0.18484848484848485
1742,2,1045,570,1615,1.8333333333333333
1742,3,1674,419,2093,3.9952267303102627
1743,1,13,327,340,0.039755351681957186
1744,1,57,904,961,0.06305309734513274
1744,2,963,447,1410,2.1543624161073827
1744,3,1495,326,1821,4.585889570552148
1744,4,1904,938,2842,2.029850746268657
1744,5,2844,939,3783,3.0287539936102235
1744,6,3843,880,4723,4.367045454545455
1744,7,4725,880,5605,5.369318181818182
1744,8,5667,935,6602,6.060962566844919
1744,9,6604,918,7522,7.193899782135076
1745,1,270,945,1215,0.2857142857142857
1746,1,86,390,476,0.2205128205128205
1746,2,554,147,701,3.7687074829931975
1746,3,1498,864,2362,1.7337962962962963
1746,4,4292,903,5195,4.753045404208195
1747,1,47,383,430,0.1227154046997389
1747,2,453,126,579,3.5952380952380953
1748,1,133,350,483,0.38
1748,2,518,418,936,1.2392344497607655
1749,1,26,907,933,0.02866593164277839
1749,2,943,739,1682,1.2760487144790258
1750,1,230,816,1046,0.2818627450980392
1751,1,72,2595,2667,0.027745664739884393
1752,1,27,440,467,0.06136363636363636
1752,2,497,323,820,1.5386996904024768
1752,3,838,519,1357,1.6146435452793835
1753,1,10,143,153,0.06993006993006994
1753,2,164,452,616,0.36283185840707965
1754,1,852,522,1374,1.632183908045977
1755,1,40,483,523,0.08281573498964803
1756,1,268,658,926,0.4072948328267477
1756,2,944,484,1428,1.9504132231404958
1757,1,19,791,810,0.02402022756005057
1758,1,29,766,795,0.037859007832898174
1759,1,30,330,360,0.09090909090909091
1759,2,373,641,1014,0.5819032761310452
1760,1,26,362,388,0.0718232044198895
1760,2,451,386,837,1.1683937823834196
1760,3,849,380,1229,2.2342105263157896
1761,1,262,109,371,2.403669724770642
1761,2,934,103,1037,9.067961165048544
1761,3,1043,255,1298,4.090196078431372
1761,4,1304,611,1915,2.134206219312602
1761,5,1921,785,2706,2.4471337579617836
1761,6,2712,705,3417,3.8468085106382977
1761,7,3423,962,4385,3.558212058212058
1761,8,4391,649,5040,6.765793528505393
1761,9,5046,874,5920,5.773455377574371
1761,10,5926,759,6685,7.80764163372859
1761,11,6691,997,7688,6.711133400200602
1761,12,7694,319,8013,24.11912225705329
1762,1,38,287,325,0.13240418118466898
1762,2,563,757,1320,0.7437252311756936
1762,3,1360,438,1798,3.105022831050228
1762,4,1819,459,2278,3.962962962962963
1763,1,315,550,865,0.5727272727272728
1763,2,884,586,1470,1.5085324232081911
1763,3,1516,481,1997,3.1517671517671517
1763,4,2030,531,2561,3.822975517890772
1764,1,141,535,676,0.2635514018691589
1764,2,746,1028,1774,0.72568093385214
1764,3,1825,1163,2988,1.5692175408426483
1764,4,3055,1087,4142,2.81048758049678
1764,5,4189,1223,5412,3.4251839738348324
1764,6,5484,1183,6667,4.635672020287405
1764,7,6687,766,7453,8.72976501305483
1765,1,601,508,1109,1.1830708661417322
1766,1,93,477,570,0.1949685534591195
1766,2,699,359,1058,1.947075208913649
1766,3,1089,344,1433,3.1656976744186047
1766,4,1469,619,2088,2.373182552504039
1766,5,2098,46,2144,45.608695652173914
1767,1,37,2,39,18.5
1767,2,202,158,360,1.2784810126582278
1767,3,445,50,495,8.9
1767,4,531,154,685,3.448051948051948
1767,5,697,527,1224,1.3225806451612903
1767,6,1238,160,1398,7.7375
1768,1,365,156,521,2.33974358974359
1768,2,887,215,1102,4.125581395348838
1768,3,1743,161,1904,10.826086956521738
1768,4,2544,162,2706,15.703703703703704
1768,5,3363,178,3541,18.89325842696629
1768,6,4181,192,4373,21.776041666666668
1769,1,380,463,843,0.8207343412526998
1770,1,115,163,278,0.7055214723926381
1770,2,300,156,456,1.9230769230769231
1771,1,32,302,334,0.10596026490066225
1771,2,348,366,714,0.9508196721311475
1771,3,758,326,1084,2.3251533742331287
1771,4,1089,304,1393,3.5822368421052633
1771,5,1398,245,1643,5.706122448979592
1771,6,1656,104,1760,15.923076923076923
1771,7,1788,374,2162,4.780748663101604
1771,8,2167,257,2424,8.431906614785992
1771,9,2452,296,2748,8.283783783783784
1771,10,2762,299,3061,9.237458193979933
1771,11,3088,348,3436,8.873563218390805
1771,12,3441,312,3753,11.028846153846153
1771,13,3788,362,4150,10.464088397790055
1771,14,4155,241,4396,17.240663900414937
1772,1,806,59,865,13.661016949152541
1772,2,1671,1039,2710,1.6082771896053898
1773,1,213,779,992,0.2734274711168164
1773,2,1035,739,1774,1.4005412719891746
1774,1,17,875,892,0.019428571428571427
1774,2,959,896,1855,1.0703125
1774,3,1888,892,2780,2.116591928251121
1774,4,2791,86,2877,32.45348837209303
1774,5,2909,260,3169,11.188461538461539
1774,6,3177,375,3552,8.472
1775,1,166,326,492,0.50920245398773
1775,2,511,241,752,2.120331950207469
1775,3,803,283,1086,2.8374558303886928
1775,4,1199,548,1747,2.187956204379562
1775,5,1796,529,2325,3.395085066162571
1775,6,2512,532,3044,4.7218045112781954
1775,7,3158,546,3704,5.783882783882784
1775,8,3751,436,4187,8.603211009174313
1775,9,4210,607,4817,6.9357495881383855
1775,10,5020,310,5330,16.193548387096776
1776,1,987,66,1053,14.954545454545455
1777,1,30,598,628,0.05016722408026756
1777,2,649,491,1140,1.3217922606924644
1778,1,273,764,1037,0.35732984293193715
1778,2,1051,341,1392,3.0821114369501466
1778,3,1457,306,1763,4.761437908496732
1778,4,1828,321,2149,5.694704049844237
1778,5,2289,344,2633,6.65406976744186
1778,6,2747,393,3140,6.989821882951654
1778,7,3249,431,3680,7.538283062645012
1778,8,3708,292,4000,12.698630136986301
1778,9,4067,292,4359,13.928082191780822
1778,10,4362,287,4649,15.198606271777004
1778,11,4652,147,4799,31.64625850340136
1779,1,86,89,175,0.9662921348314607
1779,2,182,80,262,2.275
1779,3,270,74,344,3.6486486486486487
1779,4,590,142,732,4.154929577464789
1779,5,947,338,1285,2.801775147928994
1779,6,1323,342,1665,3.8684210526315788
1779,7,1909,504,2413,3.7876984126984126
1779,8,2498,792,3290,3.154040404040404
1779,9,3309,329,3638,10.05775075987842
1779,10,3696,24,3720,154.0
1779,11,3923,123,4046,31.89430894308943
1779,12,4290,226,4516,18.98230088495575
1779,13,4755,481,5236,9.885654885654885
1779,14,5332,103,5435,51.76699029126213
1779,15,5531,120,5651,46.09166666666667
1779,16,5740,215,5955,26.697674418604652
1779,17,6059,142,6201,42.66901408450704
1779,18,6365,131,6496,48.587786259541986
1780,1,27,827,854,0.032648125755743655
1780,2,865,400,1265,2.1625
1780,3,1289,635,1924,2.02992125984252
1780,4,2020,869,2889,2.324510932105869
1780,5,2968,795,3763,3.7333333333333334
1780,6,3915,762,4677,5.137795275590551
1780,7,4782,601,5383,7.956738768718802
1780,8,5398,721,6119,7.486823855755895
1780,9,6193,544,6737,11.384191176470589
1780,10,6756,736,7492,9.179347826086957
1781,1,50,842,892,0.05938242280285035
1782,1,8,541,549,0.014787430683918669
1782,2,559,248,807,2.254032258064516
1782,3,874,553,1427,1.5804701627486437
1782,4,1443,532,1975,2.712406015037594
1783,1,230,619,849,0.3715670436187399
1783,2,907,715,1622,1.2685314685314686
1784,1,42,557,599,0.07540394973070018
1785,1,34,568,602,0.05985915492957746
1785,2,629,960,1589,0.6552083333333333
1786,1,320,410,730,0.7804878048780488
1786,2,764,352,1116,2.1704545454545454
1786,3,1158,250,1408,4.632
1787,1,22,557,579,0.03949730700179533
1787,2,644,532,1176,1.2105263157894737
1787,3,1196,367,1563,3.258855585831063
1787,4,1866,705,2571,2.646808510638298
1787,5,2602,635,3237,4.097637795275591
1787,6,3300,671,3971,4.918032786885246
1787,7,4299,893,5192,4.814109742441209
1787,8,5205,815,6020,6.386503067484663
1787,9,6032,144,6176,41.888888888888886
1787,10,6191,895,7086,6.91731843575419
1787,11,7264,583,7847,12.459691252144083
1788,1,532,951,1483,0.5594111461619348
1788,2,1495,269,1764,5.557620817843866
1788,3,1818,471,2289,3.859872611464968
1788,4,2302,642,2944,3.5856697819314642
1788,5,3083,508,3591,6.068897637795276
1788,6,3725,503,4228,7.405566600397615
1788,7,4391,525,4916,8.363809523809524
1788,8,5037,455,5492,11.07032967032967
1788,9,5539,311,5850,17.810289389067524
1788,10,5885,308,6193,19.107142857142858
1788,11,6314,506,6820,12.478260869565217
1788,12,6849,299,7148,22.906354515050168
1788,13,7197,467,7664,15.411134903640257
1789,1,1089,749,1838,1.4539385847797062
1790,1,30,115,145,0.2608695652173913
1790,2,148,30,178,4.933333333333334
1790,3,184,22,206,8.363636363636363
1790,4,208,14,222,14.857142857142858
1790,5,492,77,569,6.3896103896103895
1790,6,592,31,623,19.096774193548388
1790,7,1010,29,1039,34.827586206896555
1790,8,1413,34,1447,41.55882352941177
1790,9,1720,34,1754,50.588235294117645
1790,10,2123,30,2153,70.76666666666667
1790,11,2416,27,2443,89.48148148148148
1790,12,2456,197,2653,12.467005076142131
1790,13,3011,30,3041,100.36666666666666
1790,14,3059,302,3361,10.129139072847682
1790,15,3374,344,3718,9.80813953488372
1790,16,3736,253,3989,14.766798418972332
1790,17,4014,391,4405,10.265984654731458
1790,18,4443,438,4881,10.143835616438356
1790,19,4895,381,5276,12.847769028871392
1791,1,120,407,527,0.29484029484029484
1792,1,113,435,548,0.2597701149425287
1792,2,550,502,1052,1.095617529880478
1792,3,1107,904,2011,1.2245575221238938
1792,4,2034,679,2713,2.995581737849779
1792,5,2750,197,2947,13.959390862944163
1792,6,2966,162,3128,18.308641975308642
1792,7,3136,167,3303,18.778443113772454
1792,8,3312,406,3718,8.157635467980295
1792,9,3778,734,4512,5.147138964577657
1792,10,4536,763,5299,5.944954128440367
1792,11,5351,63,5414,84.93650793650794
1792,12,5493,35,5528,156.94285714285715
1793,1,10,444,454,0.02252252252252252
1793,2,469,611,1080,0.7675941080196399
1793,3,1095,493,1588,2.2210953346855984
1793,4,1593,599,2192,2.659432387312187
1793,5,2199,734,2933,2.9959128065395095
1793,6,2938,195,3133,15.066666666666666
1793,7,3141,374,3515,8.398395721925134
1793,8,3522,710,4232,4.96056338028169
1793,9,4241,591,4832,7.175972927241963
1793,10,4840,714,5554,6.778711484593837
1793,11,5562,878,6440,6.334851936218679
1793,12,6444,404,6848,15.950495049504951
1793,13,6876,621,7497,11.072463768115941
1793,14,7513,534,8047,14.069288389513108
1794,1,47,632,679,0.07436708860759493
1795,1,18,279,297,0.06451612903225806
1795,2,312,270,582,1.1555555555555554
1796,1,41,519,560,0.0789980732177264
1796,2,656,115,771,5.7043478260869565
1797,1,36,503,539,0.07157057654075547
1798,1,2262,394,2656,5.741116751269035
1798,2,2664,428,3092,6.224299065420561
1798,3,3100,446,3546,6.95067264573991
1798,4,3554,475,4029,7.482105263157894
1798,5,4102,498,4600,8.236947791164658
1798,6,4608,475,5083,9.701052631578948
1798,7,5091,424,5515,12.007075471698114
1798,8,5661,1253,6914,4.517956903431764
1798,9,6922,926,7848,7.475161987041036
1799,1,50,361,411,0.13850415512465375
1799,2,447,477,924,0.9371069182389937
1800,1,18,887,905,0.020293122886133032
1800,2,1390,439,1829,3.1662870159453305
1800,3,1847,868,2715,2.127880184331797
1800,4,2796,257,3053,10.879377431906615
1800,5,3075,237,3312,12.974683544303797
1800,6,3326,456,3782,7.293859649122807
1801,1,17,167,184,0.10179640718562874
1801,2,204,219,423,0.9315068493150684
1801,3,523,310,833,1.6870967741935483
1801,4,859,277,1136,3.101083032490975
1801,5,1143,410,1553,2.7878048780487803
1801,6,1572,204,1776,7.705882352941177
1801,7,1850,418,2268,4.425837320574162
1801,8,2327,303,2630,7.67986798679868
1801,9,2653,326,2979,8.13803680981595
1801,10,3064,368,3432,8.326086956521738
1801,11,3542,295,3837,12.00677966101695
1801,12,3866,308,4174,12.551948051948052
1801,13,4200,262,4462,16.03053435114504
1801,14,4522,331,4853,13.661631419939576
1801,15,4895,317,5212,15.441640378548897
1801,16,5245,215,5460,24.3953488372093
1801,17,5475,207,5682,26.44927536231884
1801,18,5747,231,5978,24.87878787878788
1801,19,5995,347,6342,17.276657060518733
1801,20,6447,333,6780,19.36036036036036
1801,21,6786,50,6836,135.72
1801,22,6850,66,6916,103.78787878787878
1802,1,10,370,380,0.02702702702702703
1802,2,513,402,915,1.2761194029850746
1802,3,923,393,1316,2.3486005089058524
1803,1,22,340,362,0.06470588235294118
1804,1,51,158,209,0.3227848101265823
1804,2,843,733,1576,1.150068212824011
1804,3,1844,727,2571,2.5364511691884455
1804,4,2598,718,3316,3.618384401114206
1805,1,130,532,662,0.24436090225563908
1806,1,172,359,531,0.479108635097493
1806,2,646,566,1212,1.1413427561837455
1806,3,1229,183,1412,6.715846994535519
1806,4,1660,537,2197,3.091247672253259
1806,5,2202,353,2555,6.237960339943343
1806,6,2570,639,3209,4.021909233176839
1806,7,3227,289,3516,11.166089965397925
1806,8,3523,319,3842,11.043887147335424
1806,9,3850,480,4330,8.020833333333334
1806,10,4335,188,4523,23.05851063829787
1806,11,4531,429,4960,10.561771561771561
1807,1,63,508,571,0.12401574803149606
1807,2,682,480,1162,1.4208333333333334
1807,3,1263,410,1673,3.080487804878049
1807,4,1770,425,2195,4.1647058823529415
1807,5,2216,80,2296,27.7
1807,6,2432,530,2962,4.588679245283019
1807,7,3081,475,3556,6.486315789473684
1807,8,3581,436,4017,8.213302752293577
1807,9,4061,450,4511,9.024444444444445
1807,10,4537,178,4715,25.48876404494382
1807,11,4738,330,5068,14.357575757575757
1807,12,5089,415,5504,12.26265060240964
1807,13,5536,367,5903,15.084468664850137
1807,14,6530,311,6841,20.9967845659164
1807,15,6877,243,7120,28.300411522633745
1807,16,7123,66,7189,107.92424242424242
1807,17,7259,179,7438,40.55307262569833
1808,1,485,3,488,161.66666666666666
1809,1,374,989,1363,0.378159757330637
1809,2,1415,467,1882,3.0299785867237685
1809,3,1993,1023,3016,1.9481915933528837
1809,4,3086,1002,4088,3.0798403193612773
1810,1,231,597,828,0.3869346733668342
1810,2,906,776,1682,1.1675257731958764
1810,3,1742,787,2529,2.2134688691232527
1810,4,2534,647,3181,3.9165378670788256
1810,5,3277,708,3985,4.628531073446328
1810,6,4080,645,4725,6.325581395348837
1810,7,4915,779,5694,6.309370988446727
1810,8,5746,555,6301,10.353153153153153
1811,1,242,479,721,0.5052192066805845
1811,2,742,703,1445,1.0554765291607398
1811,3,1467,249,1716,5.891566265060241
1811,4,1764,707,2471,2.495049504950495
1811,5,2509,1008,3517,2.4890873015873014
1811,6,3622,866,4488,4.182448036951501
1812,1,1938,1061,2999,1.826578699340245
1812,2,3004,385,3389,7.802597402597403
1813,1,171,89,260,1.9213483146067416
1813,2,1929,379,2308,5.089709762532982
1813,3,2310,207,2517,11.159420289855072
1813,4,2519,201,2720,12.532338308457712
1813,5,2897,222,3119,13.04954954954955
1813,6,3259,388,3647,8.399484536082474
1814,1,101,447,548,0.22595078299776286
1815,1,21,513,534,0.04093567251461988
1815,2,549,501,1050,1.095808383233533
1815,3,1064,285,1349,3.7333333333333334
1815,4,1369,373,1742,3.670241286863271
1815,5,1752,265,2017,6.611320754716981
1816,1,21,553,574,0.0379746835443038
1816,2,824,980,1804,0.8408163265306122
1816,3,5076,741,5817,6.850202429149798
1817,1,312,15,327,20.8
1817,2,655,98,753,6.683673469387755
1817,3,1083,780,1863,1.3884615384615384
1817,4,1884,780,2664,2.4153846153846152
1817,5,2683,448,3131,5.988839285714286
1817,6,3179,275,3454,11.56
1817,7,3494,332,3826,10.524096385542169
1817,8,3934,425,4359,9.256470588235294
1817,9,4385,647,5032,6.777434312210201
1817,10,5121,891,6012,5.747474747474747
1817,11,6021,18,6039,334.5
1817,12,6052,877,6929,6.900798175598632
1817,13,6935,870,7805,7.971264367816092
1818,1,923,11,934,83.9090909090909
1818,2,994,51,1045,19.49019607843137
1818,3,2035,31,2066,65.64516129032258
1818,4,3455,49,3504,70.51020408163265
1818,5,3530,238,3768,14.831932773109244
1818,6,3871,777,4648,4.981981981981982
1818,7,4697,501,5198,9.375249500998004
1818,8,5248,269,5517,19.509293680297397
1818,9,5539,619,6158,8.948303715670436
1818,10,6179,876,7055,7.05365296803653
1818,11,7080,962,8042,7.35966735966736
1819,1,655,437,1092,1.4988558352402745
1819,2,1094,432,1526,2.5324074074074074
1820,1,22,818,840,0.02689486552567237
1821,1,87,516,603,0.1686046511627907
1821,2,2010,463,2473,4.341252699784017
1821,3,2497,476,2973,5.245798319327731
1821,4,2997,651,3648,4.6036866359447
1821,5,3735,553,4288,6.754068716094032
1822,1,206,23,229,8.956521739130435
1822,2,336,530,866,0.6339622641509434
1822,3,872,564,1436,1.5460992907801419
1822,4,1442,540,1982,2.6703703703703705
1822,5,1989,556,2545,3.577338129496403
1822,6,2552,542,3094,4.708487084870849
1822,7,3101,561,3662,5.527629233511586
1822,8,3669,544,4213,6.744485294117647
1822,9,4220,553,4773,7.631103074141048
1822,10,4780,553,5333,8.64376130198915
1822,11,5340,536,5876,9.962686567164178
1823,1,39,862,901,0.04524361948955916
1823,2,903,705,1608,1.2808510638297872
1824,1,163,420,583,0.3880952380952381
1824,2,599,130,729,4.607692307692307
1825,1,18,588,606,0.030612244897959183
1825,2,621,695,1316,0.8935251798561151
1825,3,1339,833,2172,1.6074429771908763
1825,4,2187,1026,3213,2.1315789473684212
1825,5,3233,736,3969,4.392663043478261
1825,6,3995,875,4870,4.565714285714286
1825,7,4909,583,5492,8.420240137221269
1825,8,5531,629,6160,8.793322734499204
1826,1,1056,595,1651,1.7747899159663865
1826,2,1690,955,2645,1.7696335078534031
1826,3,2672,180,2852,14.844444444444445
1826,4,2862,895,3757,3.1977653631284917
1826,5,3781,930,4711,4.065591397849462
1826,6,4714,188,4902,25.074468085106382
1826,7,4973,261,5234,19.053639846743295
1826,8,5251,169,5420,31.071005917159763
1826,9,5460,215,5675,25.3953488372093
1826,10,5696,296,5992,19.243243243243242
1826,11,6036,344,6380,17.546511627906977
1826,12,6413,317,6730,20.230283911671926
1826,13,7020,515,7535,13.631067961165048
1826,14,7583,140,7723,54.16428571428571
1827,1,98,548,646,0.17883211678832117
1827,2,793,534,1327,1.4850187265917603
1827,3,1453,527,1980,2.757115749525617
1827,4,2028,490,2518,4.1387755102040815
1827,5,2667,518,3185,5.148648648648648
1827,6,3355,426,3781,7.875586854460094
1827,7,3867,190,4057,20.352631578947367
1827,8,4074,194,4268,21.0
1827,9,4299,121,4420,35.52892561983471
1827,10,4433,243,4676,18.242798353909464
1828,1,43,404,447,0.10643564356435643
1828,2,470,598,1068,0.7859531772575251
1828,3,1086,568,1654,1.9119718309859155
1828,4,1670,662,2332,2.5226586102719035
1828,5,2358,769,3127,3.0663198959687907
1829,1,12,706,718,0.0169971671388102
1829,2,733,813,1546,0.9015990159901599
1829,3,1564,604,2168,2.589403973509934
1830,1,1331,343,1674,3.880466472303207
1830,2,1680,115,1795,14.608695652173912
1830,3,1803,233,2036,7.738197424892704
1830,4,2044,170,2214,12.023529411764706
1830,5,2223,191,2414,11.638743455497382
1830,6,4006,279,4285,14.3584229390681
1830,7,4333,189,4522,22.925925925925927
1830,8,4536,160,4696,28.35
1830,9,4715,179,4894,26.34078212290503
1830,10,4913,185,5098,26.556756756756755
1830,11,5138,167,5305,30.766467065868262
1830,12,5411,64,5475,84.546875
1830,13,5482,134,5616,40.91044776119403
1830,14,5654,160,5814,35.3375
1830,15,7015,451,7466,15.554323725055433
1830,16,7501,198,7699,37.88383838383838
1830,17,7768,221,7989,35.14932126696833
1831,1,32,1075,1107,0.029767441860465118
1832,1,408,414,822,0.9855072463768116
1832,2,831,344,1175,2.4156976744186047
1833,1,13,364,377,0.03571428571428571
1833,2,389,76,465,5.118421052631579
1833,3,471,70,541,6.728571428571429
1833,4,545,178,723,3.061797752808989
1834,1,21,475,496,0.04421052631578947
1835,1,192,377,569,0.5092838196286472
1835,2,798,645,1443,1.2372093023255815
1836,1,56,426,482,0.13145539906103287
1836,2,491,202,693,2.4306930693069306
1837,1,51,314,365,0.1624203821656051
1837,2,417,420,837,0.9928571428571429
1838,1,156,928,1084,0.16810344827586207
1838,2,1117,660,1777,1.6924242424242424
1838,3,1964,947,2911,2.073917634635692
1838,4,2964,794,3758,3.7329974811083124
1838,5,3780,894,4674,4.228187919463087
1839,1,9,878,887,0.010250569476082005
1839,2,923,669,1592,1.3796711509715993
1840,1,7,149,156,0.04697986577181208
1840,2,199,267,466,0.7453183520599251
1840,3,492,267,759,1.8426966292134832
1840,4,816,193,1009,4.227979274611399
1840,5,1056,346,1402,3.052023121387283
1840,6,1472,264,1736,5.575757575757576
1840,7,1752,205,1957,8.546341463414635
1841,1,80,8,88,10.0
1841,2,280,866,1146,0.3233256351039261
1841,3,1168,201,1369,5.810945273631841
1841,4,1401,231,1632,6.064935064935065
1841,5,1648,867,2515,1.9008073817762399
1842,1,206,46,252,4.478260869565218
1842,2,953,906,1859,1.0518763796909492
1842,3,1867,611,2478,3.055646481178396
1843,1,816,695,1511,1.1741007194244604
1844,1,65,207,272,0.3140096618357488
1844,2,295,292,587,1.0102739726027397
1844,3,617,317,934,1.946372239747634
1845,1,546,408,954,1.338235294117647
1845,2,956,159,1115,6.012578616352202
1845,3,1138,343,1481,3.317784256559767
1845,4,1483,348,1831,4.261494252873563
1846,1,26,205,231,0.12682926829268293
1846,2,240,562,802,0.42704626334519574
1846,3,814,418,1232,1.9473684210526316
1846,4,1245,695,1940,1.79136690647482
1846,5,1956,160,2116,12.225
1846,6,2132,268,2400,7.955223880597015
1847,1,57,254,311,0.22440944881889763
1848,1,119,436,555,0.27293577981651373
1848,2,663,426,1089,1.556338028169014
1848,3,1201,427,1628,2.812646370023419
1848,4,1694,488,2182,3.471311475409836
1848,5,2218,522,2740,4.24904214559387
1848,6,2757,511,3268,5.395303326810176
1848,7,3391,467,3858,7.2612419700214135
1848,8,3886,115,4001,33.791304347826085
1848,9,4052,856,4908,4.733644859813084
1848,10,4968,729,5697,6.814814814814815
1848,11,5745,993,6738,5.785498489425982
1848,12,6740,383,7123,17.597911227154047
1848,13,7140,489,7629,14.60122699386503
1849,1,13,465,478,0.02795698924731183
1849,2,528,632,1160,0.8354430379746836
1849,3,1205,558,1763,2.1594982078853047
1849,4,1826,1056,2882,1.7291666666666667
1849,5,2900,1046,3946,2.7724665391969405
1849,6,3954,156,4110,25.346153846153847
1849,7,4157,1062,5219,3.914312617702448
1849,8,5227,152,5379,34.38815789473684
1850,1,570,733,1303,0.7776261937244202
1851,1,141,1024,1165,0.1376953125
1851,2,1219,765,1984,1.5934640522875816
1851,3,2024,897,2921,2.2564102564102564
1852,1,49,148,197,0.3310810810810811
1852,2,206,312,518,0.6602564102564102
1852,3,534,253,787,2.110671936758893
1852,4,798,264,1062,3.022727272727273
1852,5,1070,124,1194,8.629032258064516
1852,6,1204,310,1514,3.8838709677419354
1852,7,1554,316,1870,4.917721518987341
1852,8,1896,324,2220,5.851851851851852
1852,9,2265,301,2566,7.524916943521594
1852,10,2572,164,2736,15.682926829268293
1852,11,2752,120,2872,22.933333333333334
1852,12,2938,111,3049,26.46846846846847
1853,1,13,689,702,0.018867924528301886
1853,2,707,783,1490,0.9029374201787995
1853,3,1501,632,2133,2.375
1853,4,2142,638,2780,3.3573667711598745
1854,1,985,275,1260,3.581818181818182
1854,2,1930,187,2117,10.320855614973262
1854,3,3301,250,3551,13.204
1855,1,5,996,1001,0.0050200803212851405
1856,1,66,294,360,0.22448979591836735
1856,2,386,409,795,0.9437652811735942
1856,3,837,204,1041,4.102941176470588
1856,4,1133,176,1309,6.4375
1856,5,1355,258,1613,5.251937984496124
1856,6,1710,438,2148,3.904109589041096
1856,7,2166,369,2535,5.869918699186992
1857,1,19,802,821,0.02369077306733167
1858,1,34,339,373,0.10029498525073746
1858,2,430,789,1219,0.5449936628643853
1858,3,1229,117,1346,10.504273504273504
1858,4,1358,72,1430,18.86111111111111
1858,5,1490,72,1562,20.694444444444443
1858,6,1625,258,1883,6.2984496124031
1858,7,1948,252,2200,7.73015873015873
1858,8,2287,350,2637,6.534285714285715
1858,9,2705,141,2846,19.18439716312057
1858,10,2859,24,2883,119.125
1859,1,37,811,848,0.04562268803945746
1859,2,855,1019,1874,0.8390578999018645
1860,1,15,208,223,0.07211538461538461
1860,2,237,320,557,0.740625
1860,3,605,400,1005,1.5125
1860,4,1223,502,1725,2.4362549800796813
1860,5,1838,521,2359,3.5278310940499042
1860,6,2413,470,2883,5.134042553191489
1860,7,2897,200,3097,14.485
1860,8,3160,257,3417,12.295719844357977
1860,9,3468,540,4008,6.4222222222222225
1860,10,4144,967,5111,4.285418821096174
1860,11,6094,537,6631,11.348230912476723
1861,1,30,191,221,0.15706806282722513
1862,1,846,17,863,49.76470588235294
1863,1,22,702,724,0.03133903133903134
1863,2,761,771,1532,0.9870298313878081
1863,3,1578,581,2159,2.7160068846815837
1863,4,2183,871,3054,2.5063145809414467
1863,5,3102,931,4033,3.3319011815252417
1863,6,4066,561,4627,7.24777183600713
1863,7,4633,447,5080,10.364653243847874
1863,8,5096,591,5687,8.622673434856177
1864,1,94,140,234,0.6714285714285714
1864,2,263,835,1098,0.3149700598802395
1864,3,1168,1001,2169,1.1668331668331668
1864,4,2174,534,2708,4.071161048689139
1864,5,2712,122,2834,22.229508196721312
1864,6,2902,849,3751,3.4181389870435805
1864,7,3822,967,4789,3.952430196483971
1864,8,4860,859,5719,5.657741559953434
1864,9,5761,893,6654,6.451287793952967
1864,10,6709,893,7602,7.512877939529675
1865,1,47,58,105,0.8103448275862069
1865,2,2568,3,2571,856.0
1865,3,2582,2,2584,1291.0
1865,4,3066,3,3069,1022.0
1865,5,3080,2,3082,1540.0
1865,6,3722,3,3725,1240.6666666666667
1865,7,4851,3,4854,1617.0
1865,8,5230,3,5233,1743.3333333333333
1865,9,6468,3,6471,2156.0
1865,10,6588,781,7369,8.435339308578746
1865,11,7432,676,8108,10.994082840236686
1866,1,18,7,25,2.5714285714285716
1866,2,30,99,129,0.30303030303030304
1867,1,31,47,78,0.6595744680851063
1867,2,99,50,149,1.98
1867,3,963,683,1646,1.4099560761346999
1867,4,1815,341,2156,5.32258064516129
1867,5,2174,503,2677,4.3220675944334
1867,6,2714,126,2840,21.53968253968254
1867,7,2860,550,3410,5.2
1867,8,3421,207,3628,16.52657004830918
1867,9,3635,384,4019,9.466145833333334
1867,10,4054,350,4404,11.582857142857144
1867,11,4420,473,4893,9.3446088794926
1867,12,4906,572,5478,8.576923076923077
1867,13,5500,76,5576,72.36842105263158
1867,14,5599,89,5688,62.91011235955056
1867,15,5705,123,5828,46.38211382113821
1867,16,5836,60,5896,97.26666666666667
1867,17,5907,157,6064,37.62420382165605
1867,18,6074,234,6308,25.957264957264957
1867,19,6321,169,6490,37.40236686390533
1867,20,6518,657,7175,9.920852359208524
1868,1,409,521,930,0.7850287907869482
1869,1,139,421,560,0.33016627078384797
1870,1,254,900,1154,0.2822222222222222
1870,2,1166,401,1567,2.907730673316708
1871,1,668,549,1217,1.2167577413479054
1871,2,1333,656,1989,2.0320121951219514
1871,3,2264,822,3086,2.7542579075425793
1872,1,138,987,1125,0.1398176291793313
1872,2,1131,512,1643,2.208984375
1872,3,1675,661,2336,2.534039334341906
1872,4,2358,995,3353,2.369849246231156
1872,5,3361,617,3978,5.447325769854133
1872,6,4027,960,4987,4.194791666666666
1873,1,30,643,673,0.04665629860031104
1873,2,696,609,1305,1.1428571428571428
1873,3,1340,881,2221,1.5209988649262203
1873,4,2259,930,3189,2.4290322580645163
1873,5,3214,1037,4251,3.0993249758919963
1873,6,4300,464,4764,9.267241379310345
1873,7,4862,501,5363,9.704590818363274
1873,8,5365,751,6116,7.143808255659121
1874,1,328,375,703,0.8746666666666667
1874,2,706,358,1064,1.9720670391061452
1874,3,1067,251,1318,4.250996015936255
1875,1,36,699,735,0.05150214592274678
1875,2,739,394,1133,1.8756345177664975
1875,3,1151,710,1861,1.6211267605633803
1875,4,1865,580,2445,3.2155172413793105
1876,1,62,358,420,0.17318435754189945
1877,1,51,53,104,0.9622641509433962
1877,2,116,167,283,0.6946107784431138
1877,3,302,286,588,1.055944055944056
1877,4,690,310,1000,2.225806451612903
1877,5,1013,278,1291,3.643884892086331
1877,6,1323,85,1408,15.564705882352941
1877,7,1456,818,2274,1.7799511002444988
1877,8,2286,47,2333,48.638297872340424
1877,9,2378,319,2697,7.454545454545454
1877,10,2714,48,2762,56.541666666666664
1877,11,2793,318,3111,8.783018867924529
1877,12,3133,54,3187,58.01851851851852
1877,13,3191,30,3221,106.36666666666666
1878,1,41,194,235,0.211340206185567
1879,1,79,844,923,0.09360189573459715
1879,2,934,638,1572,1.463949843260188
1880,1,644,391,1035,1.6470588235294117
1881,1,3529,2,3531,1764.5
1881,2,3614,123,3737,29.382113821138212
1882,1,155,571,726,0.2714535901926445
1883,1,21,506,527,0.041501976284584984
1883,2,2646,1055,3701,2.5080568720379146
1883,3,3722,791,4513,4.70543615676359
1884,1,52,444,496,0.11711711711711711
1885,1,679,40,719,16.975
1886,1,85,460,545,0.18478260869565216
1886,2,760,776,1536,0.979381443298969
1887,1,28,212,240,0.1320754716981132
1888,1,41,179,220,0.22905027932960895
1888,2,275,246,521,1.1178861788617886
1889,1,253,281,534,0.900355871886121
1890,1,16,857,873,0.01866977829638273
1890,2,880,342,1222,2.573099415204678
1890,3,1227,471,1698,2.605095541401274
1891,1,220,145,365,1.5172413793103448
1891,2,375,79,454,4.746835443037975
1892,1,109,378,487,0.28835978835978837
1892,2,490,383,873,1.279373368146214
1892,3,876,388,1264,2.2577319587628866
1892,4,1267,382,1649,3.316753926701571
1892,5,1652,375,2027,4.405333333333333
1892,6,2030,384,2414,5.286458333333333
1892,7,2417,375,2792,6.445333333333333
1892,8,2795,376,3171,7.433510638297872
1892,9,3174,362,3536,8.767955801104973
1892,10,3539,378,3917,9.362433862433862
1892,11,3920,368,4288,10.652173913043478
1892,12,4291,379,4670,11.321899736147758
1892,13,4673,378,5051,12.362433862433862
1892,14,5054,321,5375,15.744548286604362
1892,15,5378,296,5674,18.16891891891892
1893,1,27,580,607,0.04655172413793104
1893,2,616,536,1152,1.1492537313432836
1893,3,1163,558,1721,2.0842293906810037
1893,4,1751,570,2321,3.0719298245614035
1893,5,2327,766,3093,3.037859007832898
1893,6,3163,811,3974,3.900123304562269
1893,7,3984,771,4755,5.167315175097277
1893,8,4792,50,4842,95.84
1893,9,4849,548,5397,8.848540145985401
1893,10,5413,46,5459,117.67391304347827
1893,11,5479,297,5776,18.447811447811446
1894,1,97,657,754,0.1476407914764079
1894,2,825,520,1345,1.5865384615384615
1894,3,1357,327,1684,4.149847094801223
1895,1,93,575,668,0.1617391304347826
1895,2,685,662,1347,1.0347432024169185
1895,3,1352,586,1938,2.3071672354948807
1895,4,1947,512,2459,3.802734375
1895,5,2475,674,3149,3.672106824925816
1895,6,3178,713,3891,4.457223001402524
1896,1,70,141,211,0.49645390070921985
1896,2,289,790,1079,0.3658227848101266
1897,1,527,86,613,6.127906976744186
1898,1,88,356,444,0.24719101123595505
1898,2,451,292,743,1.5445205479452055
1898,3,2142,342,2484,6.2631578947368425
1899,1,32,496,528,0.06451612903225806
1900,1,15,419,434,0.03579952267303103
1900,2,452,582,1034,0.7766323024054983
1901,1,50,579,629,0.08635578583765112
1902,1,10,561,571,0.017825311942959002
1903,1,9,86,95,0.10465116279069768
1903,2,104,285,389,0.3649122807017544
1903,3,406,451,857,0.9002217294900222
1903,4,864,385,1249,2.244155844155844
1903,5,1264,539,1803,2.345083487940631
1903,6,1808,945,2753,1.9132275132275132
1904,1,72,56,128,1.2857142857142858
1904,2,131,54,185,2.425925925925926
1904,3,192,68,260,2.823529411764706
1904,4,262,65,327,4.030769230769231
1904,5,329,65,394,5.061538461538461
1904,6,440,82,522,5.365853658536586
1905,1,27,711,738,0.0379746835443038
1905,2,755,284,1039,2.658450704225352
1905,3,1057,398,1455,2.6557788944723617
1906,1,97,906,1003,0.10706401766004416
1906,2,1024,194,1218,5.278350515463917
1906,3,1231,1071,2302,1.149393090569561
1906,4,2305,265,2570,8.69811320754717
1906,5,2601,412,3013,6.313106796116505
1906,6,3036,248,3284,12.241935483870968
1907,1,130,71,201,1.8309859154929577
1907,2,219,103,322,2.1262135922330097
1908,1,231,481,712,0.4802494802494803
1908,2,734,395,1129,1.8582278481012657
1908,3,1137,415,1552,2.7397590361445783
1909,1,78,687,765,0.11353711790393013
1910,1,172,453,625,0.37969094922737306
1910,2,628,429,1057,1.4638694638694638
1910,3,1060,382,1442,2.774869109947644
1910,4,1445,378,1823,3.822751322751323
1910,5,1826,350,2176,5.217142857142857
1910,6,2222,330,2552,6.733333333333333
1910,7,2555,255,2810,10.019607843137255
1910,8,2813,395,3208,7.121518987341772
1910,9,3211,365,3576,8.797260273972602
1910,10,3599,374,3973,9.622994652406417
1910,11,3976,421,4397,9.44418052256532
1910,12,4400,350,4750,12.571428571428571
1910,13,4753,383,5136,12.409921671018276
1910,14,5184,321,5505,16.149532710280372
1910,15,5508,381,5889,14.456692913385826
1910,16,5892,365,6257,16.14246575342466
1910,17,6260,360,6620,17.38888888888889
1910,18,6623,426,7049,15.546948356807512
1910,19,7090,261,7351,27.164750957854405
1910,20,7393,259,7652,28.544401544401545
1910,21,7655,375,8030,20.413333333333334
1911,1,1029,88,1117,11.693181818181818
1912,1,47,750,797,0.06266666666666666
1912,2,816,728,1544,1.120879120879121
1913,1,18,455,473,0.03956043956043956
1914,1,949,1009,1958,0.9405351833498513
1914,2,2162,990,3152,2.183838383838384
1914,3,3175,985,4160,3.2233502538071064
1914,4,4286,254,4540,16.874015748031496
1914,5,4682,106,4788,44.16981132075472
1914,6,4800,364,5164,13.186813186813186
1914,7,5209,343,5552,15.186588921282798
1914,8,5624,696,6320,8.080459770114942
1914,9,6418,678,7096,9.466076696165192
1914,10,7120,300,7420,23.733333333333334
1915,1,35,53,88,0.660377358490566
1915,2,376,464,840,0.8103448275862069
1916,1,15,212,227,0.07075471698113207
1916,2,240,435,675,0.5517241379310345
1916,3,687,478,1165,1.4372384937238494
1917,1,12,579,591,0.02072538860103627
1917,2,607,553,1160,1.0976491862567812
1917,3,1220,868,2088,1.4055299539170507
1917,4,2172,644,2816,3.372670807453416
1918,1,9,452,461,0.01991150442477876
1918,2,481,571,1052,0.8423817863397548
1918,3,1070,451,1521,2.3725055432372506
1918,4,1577,510,2087,3.092156862745098
1919,1,671,436,1107,1.5389908256880733
1920,1,46,466,512,0.09871244635193133
1921,1,555,464,1019,1.1961206896551724
1921,2,1507,50,1557,30.14
1921,3,2027,153,2180,13.248366013071895
1921,4,2671,181,2852,14.756906077348066
1921,5,3301,245,3546,13.473469387755102
1921,6,4187,319,4506,13.12539184952978
1922,1,94,513,607,0.18323586744639375
1922,2,639,283,922,2.2579505300353357
1922,3,943,643,1586,1.4665629860031104
1922,4,1591,269,1860,5.91449814126394
1922,5,1873,541,2414,3.4621072088724585
1922,6,2428,375,2803,6.474666666666667
1923,1,148,1058,1206,0.13988657844990549
1923,2,1255,528,1783,2.3768939393939394
1923,3,1844,567,2411,3.252204585537919
1923,4,2445,385,2830,6.35064935064935
1923,5,2875,410,3285,7.012195121951219
1923,6,3530,299,3829,11.806020066889632
1923,7,3870,1054,4924,3.6717267552182165
1923,8,4944,1030,5974,4.8
1923,9,6025,1051,7076,5.732635585156993
1924,1,42,42,84,1.0
1924,2,119,45,164,2.6444444444444444
1924,3,413,474,887,0.8713080168776371
1924,4,1172,535,1707,2.1906542056074767
1924,5,2115,747,2862,2.8313253012048194
1924,6,3258,726,3984,4.487603305785124
1925,1,156,388,544,0.4020618556701031
1925,2,592,372,964,1.5913978494623655
1926,1,217,35,252,6.2
1926,2,321,36,357,8.916666666666666
1926,3,383,35,418,10.942857142857143
1926,4,456,37,493,12.324324324324325
1926,5,606,129,735,4.6976744186046515
1926,6,769,41,810,18.75609756097561
1926,7,836,33,869,25.333333333333332
1926,8,895,37,932,24.18918918918919
1926,9,1004,98,1102,10.244897959183673
1927,1,794,2,796,397.0
1927,2,1563,2,1565,781.5
1927,3,3257,2,3259,1628.5
1927,4,5015,2,5017,2507.5
1927,5,6691,2,6693,3345.5
1927,6,8141,2,8143,4070.5
1928,1,189,513,702,0.3684210526315789
1928,2,717,851,1568,0.8425381903642774
1929,1,13,416,429,0.03125
1930,1,735,386,1121,1.9041450777202074
1930,2,1137,201,1338,5.656716417910448
1930,3,1346,160,1506,8.4125
1930,4,1518,249,1767,6.096385542168675
1930,5,1784,257,2041,6.941634241245136
1930,6,2063,390,2453,5.28974358974359
1930,7,2467,263,2730,9.38022813688213
1930,8,4137,370,4507,11.18108108108108
1930,9,4523,153,4676,29.562091503267975
1930,10,4688,205,4893,22.86829268292683
1930,11,4930,198,5128,24.8989898989899
1930,12,5188,203,5391,25.55665024630542
1930,13,5424,173,5597,31.352601156069365
1930,14,5616,168,5784,33.42857142857143
1930,15,5839,247,6086,23.639676113360323
1930,16,6103,325,6428,18.77846153846154
1930,17,6479,212,6691,30.56132075471698
1930,18,6703,246,6949,27.247967479674795
1931,1,879,343,1222,2.56268221574344
1931,2,1246,427,1673,2.918032786885246
1931,3,1699,548,2247,3.1003649635036497
1931,4,2277,748,3025,3.0441176470588234
1931,5,3056,918,3974,3.3289760348583877
1931,6,4006,434,4440,9.23041474654378
1931,7,4458,577,5035,7.726169844020797
1931,8,5100,685,5785,7.445255474452555
1931,9,5816,491,6307,11.84521384928717
1931,10,6320,240,6560,26.333333333333332
1931,11,6610,355,6965,18.619718309859156
1931,12,7023,320,7343,21.946875
1932,1,28,597,625,0.04690117252931323
1932,2,641,381,1022,1.6824146981627297
1932,3,1042,721,1763,1.4452149791955617
1932,4,1771,266,2037,6.657894736842105
1933,1,175,6,181,29.166666666666668
1933,2,695,943,1638,0.7370095440084835
1933,3,1674,1136,2810,1.4735915492957747
1933,4,2822,883,3705,3.1959229898074746
1933,5,3754,1153,4907,3.2558542931483085
1933,6,4919,525,5444,9.369523809523809
1934,1,46,661,707,0.06959152798789713
1935,1,260,101,361,2.5742574257425743
1936,1,109,501,610,0.21756487025948104
1936,2,629,429,1058,1.4662004662004662
1936,3,1183,506,1689,2.3379446640316206
1936,4,1723,424,2147,4.063679245283019
1936,5,2163,450,2613,4.806666666666667
1937,1,31,80,111,0.3875
1937,2,557,231,788,2.411255411255411
1937,3,810,29,839,27.93103448275862
1937,4,1624,3,1627,541.3333333333334
1937,5,2184,3,2187,728.0
1937,6,2962,3,2965,987.3333333333334
1937,7,2989,33,3022,90.57575757575758
1937,8,3741,3,3744,1247.0
1937,9,3756,159,3915,23.62264150943396
1937,10,5818,3,5821,1939.3333333333333
1937,11,5876,402,6278,14.616915422885572
1937,12,6337,443,6780,14.304740406320542
1938,1,11,470,481,0.023404255319148935
1939,1,126,161,287,0.782608695652174
1940,1,10,55,65,0.18181818181818182
1940,2,644,307,951,2.0977198697068404
1940,3,1012,173,1185,5.8497109826589595
1940,4,3259,152,3411,21.44078947368421
1940,5,3570,311,3881,11.479099678456592
1940,6,3893,387,4280,10.059431524547804
1941,1,139,927,1066,0.1499460625674218
1941,2,1096,860,1956,1.2744186046511627
1941,3,2258,596,2854,3.7885906040268456
1941,4,2880,469,3349,6.140724946695096
1941,5,3406,582,3988,5.852233676975945
1941,6,4008,973,4981,4.1192189105858175
1941,7,4983,193,5176,25.818652849740932
1941,8,5191,983,6174,5.280773143438454
1941,9,6177,775,6952,7.970322580645162
1941,10,7433,226,7659,32.889380530973455
1942,1,55,499,554,0.11022044088176353
1942,2,582,484,1066,1.2024793388429753
1943,1,111,641,752,0.1731669266770671
1944,1,203,908,1111,0.22356828193832598
1944,2,1119,609,1728,1.8374384236453203
1944,3,2511,912,3423,2.7532894736842106
1944,4,3431,884,4315,3.8812217194570136
1944,5,4321,855,5176,5.053801169590643
1944,6,5392,909,6301,5.931793179317932
1944,7,6309,958,7267,6.585594989561587
1945,1,12,361,373,0.0332409972299169
1945,2,409,458,867,0.8930131004366813
1945,3,894,476,1370,1.8781512605042017
1946,1,11,503,514,0.02186878727634195
1946,2,527,420,947,1.2547619047619047
1946,3,962,291,1253,3.3058419243986252
1946,4,1299,373,1672,3.482573726541555
1946,5,1815,591,2406,3.0710659898477157
1947,1,251,326,577,0.7699386503067485
1948,1,40,619,659,0.06462035541195477
1948,2,699,623,1322,1.1219903691813804
1949,1,1132,65,1197,17.415384615384614
1949,2,1819,553,2372,3.2893309222423146
1949,3,2383,122,2505,19.5327868852459
1949,4,3430,473,3903,7.251585623678647
1950,1,20,522,542,0.038314176245210725
1950,2,570,714,1284,0.7983193277310925
1950,3,1293,667,1960,1.9385307346326837
1951,1,1199,418,1617,2.8684210526315788
1951,2,1653,536,2189,3.083955223880597
1951,3,2206,469,2675,4.70362473347548
1951,4,2692,478,3170,5.631799163179917
1951,5,3187,487,3674,6.544147843942505
1951,6,3691,489,4180,7.548057259713701
1951,7,4197,548,4745,7.658759124087592
1951,8,4762,558,5320,8.53405017921147
1951,9,5337,671,6008,7.9538002980625935
1951,10,6025,453,6478,13.300220750551876
1951,11,6514,585,7099,11.135042735042735
1951,12,7144,550,7694,12.989090909090908
1952,1,141,224,365,0.6294642857142857
1952,2,534,337,871,1.5845697329376855
1952,3,1016,561,1577,1.8110516934046346
1952,4,1684,567,2251,2.9700176366843034
1953,1,14,871,885,0.016073478760045924
1953,2,898,837,1735,1.0728793309438471
1953,3,1743,1038,2781,1.6791907514450868
1953,4,2789,477,3266,5.846960167714885
1954,1,19,194,213,0.0979381443298969
1954,2,251,541,792,0.46395563770794823
1954,3,820,688,1508,1.191860465116279
1955,1,217,469,686,0.4626865671641791
1955,2,693,696,1389,0.9956896551724138
1955,3,1396,706,2102,1.9773371104815864
1955,4,2109,716,2825,2.945530726256983
1956,1,27,853,880,0.031652989449003514
1956,2,907,867,1774,1.0461361014994233
1956,3,2503,499,3002,5.0160320641282565
1956,4,3028,874,3902,3.4645308924485128
1956,5,3948,1025,4973,3.8517073170731706
1956,6,5562,935,6497,5.948663101604278
1956,7,6513,909,7422,7.1650165016501655
1957,1,66,885,951,0.07457627118644068
1958,1,257,317,574,0.8107255520504731
1958,2,656,354,1010,1.8531073446327684
1958,3,1015,369,1384,2.7506775067750677
1958,4,1469,287,1756,5.118466898954704
1958,5,1768,381,2149,4.640419947506562
1958,6,2241,374,2615,5.991978609625669
1958,7,2654,327,2981,8.116207951070336
1959,1,664,478,1142,1.389121338912134
1959,2,1161,308,1469,3.7694805194805197
1960,1,34,323,357,0.10526315789473684
1960,2,367,474,841,0.7742616033755274
1960,3,857,876,1733,0.978310502283105
1960,4,1769,632,2401,2.7990506329113924
1960,5,2421,957,3378,2.529780564263323
1960,6,3396,1000,4396,3.396
1960,7,4405,419,4824,10.513126491646778
1960,8,4830,489,5319,9.877300613496933
1960,9,5339,338,5677,15.79585798816568
1960,10,5703,972,6675,5.867283950617284
1960,11,6700,360,7060,18.61111111111111
1960,12,7075,669,7744,10.575485799701047
1961,1,18,734,752,0.02452316076294278
1962,1,111,684,795,0.16228070175438597
1962,2,815,289,1104,2.820069204152249
1963,1,3084,357,3441,8.638655462184873
1963,2,3444,467,3911,7.374732334047109
1963,3,3914,363,4277,10.782369146005509
1963,4,4280,184,4464,23.26086956521739
1964,1,18,105,123,0.17142857142857143
1964,2,146,490,636,0.2979591836734694
1964,3,713,435,1148,1.639080459770115
1964,4,1179,70,1249,16.84285714285714
1964,5,1282,431,1713,2.9744779582366587
1964,6,1759,994,2753,1.7696177062374245
1964,7,2774,372,3146,7.456989247311828
1964,8,3171,316,3487,10.034810126582279
1964,9,3538,954,4492,3.708595387840671
1964,10,4517,252,4769,17.924603174603174
1964,11,4791,307,5098,15.60586319218241
1965,1,273,523,796,0.5219885277246654
1966,1,236,567,803,0.41622574955908287
1966,2,864,643,1507,1.343701399688958
1966,3,1516,83,1599,18.265060240963855
1966,4,1612,248,1860,6.5
1967,1,39,30,69,1.3
1967,2,98,716,814,0.13687150837988826
1967,3,832,525,1357,1.5847619047619048
1967,4,1371,983,2354,1.3947100712105798
1967,5,2368,351,2719,6.746438746438747
1967,6,2731,1041,3772,2.623439000960615
1967,7,3784,270,4054,14.014814814814814
1967,8,4067,1057,5124,3.847682119205298
1967,9,5140,1070,6210,4.803738317757009
1967,10,6221,1074,7295,5.792364990689013
1968,1,3025,596,3621,5.075503355704698
1968,2,3684,172,3856,21.41860465116279
1968,3,4038,154,4192,26.22077922077922
1968,4,4305,299,4604,14.397993311036789
1968,5,4625,130,4755,35.57692307692308
1968,6,5548,333,5881,16.66066066066066
1968,7,5913,217,6130,27.24884792626728
1968,8,6147,303,6450,20.287128712871286
1968,9,6746,281,7027,24.00711743772242
1969,1,32,56,88,0.5714285714285714
1969,2,110,113,223,0.9734513274336283
1969,3,233,54,287,4.314814814814815
1969,4,294,336,630,0.875
1969,5,642,300,942,2.14
1969,6,955,43,998,22.209302325581394
1969,7,1011,88,1099,11.488636363636363
1969,8,1113,445,1558,2.501123595505618
1969,9,1574,591,2165,2.6632825719120135
1969,10,2179,55,2234,39.61818181818182
1969,11,2246,68,2314,33.029411764705884
1969,12,2328,54,2382,43.111111111111114
1969,13,2404,176,2580,13.659090909090908
1969,14,2592,529,3121,4.8998109640831755
1969,15,3125,39,3164,80.12820512820512
1969,16,3174,427,3601,7.433255269320843
1969,17,3606,151,3757,23.880794701986755
1969,18,3770,125,3895,30.16
1969,19,3908,218,4126,17.926605504587155
1969,20,4142,106,4248,39.075471698113205
1969,21,4267,108,4375,39.50925925925926
1969,22,4385,118,4503,37.16101694915254
1969,23,4512,48,4560,94.0
1969,24,4612,531,5143,8.685499058380413
1969,25,5155,449,5604,11.481069042316259
1969,26,5617,179,5796,31.379888268156424
1969,27,5808,209,6017,27.789473684210527
1969,28,6025,483,6508,12.474120082815736
1970,1,16,364,380,0.04395604395604396
1971,1,27,153,180,0.17647058823529413
1972,1,18,333,351,0.05405405405405406
1972,2,370,231,601,1.6017316017316017
1972,3,632,467,1099,1.3533190578158458
1973,1,81,176,257,0.4602272727272727
1973,2,348,621,969,0.5603864734299517
1973,3,985,539,1524,1.8274582560296846
1973,4,1545,587,2132,2.6320272572402046
1974,1,209,659,868,0.3171471927162367
1975,1,1050,367,1417,2.861035422343324
1976,1,35,691,726,0.05065123010130246
1976,2,779,372,1151,2.0940860215053765
1976,3,1170,274,1444,4.2700729927007295
1976,4,1447,388,1835,3.729381443298969
1976,5,1838,478,2316,3.8451882845188283
1976,6,2321,15,2336,154.73333333333332
1976,7,2347,463,2810,5.069114470842333
1976,8,2834,296,3130,9.574324324324325
1976,9,3133,226,3359,13.86283185840708
1976,10,3389,373,3762,9.085790884718499
1976,11,3766,55,3821,68.47272727272727
1976,12,3883,35,3918,110.94285714285714
1976,13,3963,270,4233,14.677777777777777
1976,14,4238,255,4493,16.619607843137256
1976,15,4499,128,4627,35.1484375
1976,16,4863,280,5143,17.367857142857144
1976,17,5154,228,5382,22.605263157894736
1976,18,5388,487,5875,11.063655030800822
1976,19,5885,25,5910,235.4
1976,20,5915,172,6087,34.38953488372093
1976,21,6096,193,6289,31.585492227979273
1976,22,6311,526,6837,11.99809885931559
1976,23,6865,424,7289,16.191037735849058
1976,24,7306,35,7341,208.74285714285713
1977,1,105,882,987,0.11904761904761904
1977,2,1022,498,1520,2.0522088353413657
1977,3,1528,811,2339,1.8840937114673242
1978,1,16,549,565,0.029143897996357013
1978,2,578,537,1115,1.0763500931098697
1979,1,160,1102,1262,0.14519056261343014
1979,2,1509,1086,2595,1.3895027624309393
1979,3,2602,774,3376,3.3617571059431524
1979,4,3506,1100,4606,3.1872727272727275
1979,5,4613,676,5289,6.82396449704142
1980,1,22,405,427,0.05432098765432099
1981,1,39,371,410,0.10512129380053908
1982,1,31,893,924,0.03471444568868981
1982,2,987,1031,2018,0.9573229873908826
1982,3,2086,1008,3094,2.0694444444444446
1983,1,129,640,769,0.2015625
1983,2,798,137,935,5.824817518248175
1983,3,1034,450,1484,2.2977777777777777
1983,4,1627,130,1757,12.515384615384615
1983,5,1810,401,2211,4.513715710723192
1983,6,2438,406,2844,6.004926108374384
1983,7,2858,681,3539,4.196769456681351
1983,8,3600,609,4209,5.911330049261084
1983,9,4219,1080,5299,3.9064814814814817
1983,10,5310,485,5795,10.948453608247423
1983,11,5812,705,6517,8.243971631205675
1984,1,14,437,451,0.032036613272311214
1984,2,480,425,905,1.1294117647058823
1984,3,908,282,1190,3.219858156028369
1985,1,185,513,698,0.36062378167641324
1985,2,709,851,1560,0.8331374853113983
1986,1,65,40,105,1.625
1986,2,116,51,167,2.2745098039215685
1986,3,179,15,194,11.933333333333334
1986,4,197,31,228,6.354838709677419
1987,1,60,151,211,0.3973509933774834
1987,2,224,144,368,1.5555555555555556
1987,3,377,156,533,2.4166666666666665
1987,4,570,155,725,3.6774193548387095
1987,5,746,168,914,4.440476190476191
1987,6,934,42,976,22.238095238095237
1987,7,985,275,1260,3.581818181818182
1987,8,1279,268,1547,4.772388059701493
1988,1,154,579,733,0.2659758203799655
1988,2,743,526,1269,1.4125475285171103
1988,3,1296,542,1838,2.3911439114391144
1988,4,1863,554,2417,3.362815884476534
1989,1,28,22,50,1.2727272727272727
1989,2,2410,339,2749,7.109144542772861
1989,3,2752,349,3101,7.885386819484241
1989,4,3123,322,3445,9.698757763975156
1990,1,81,751,832,0.10785619174434088
1990,2,896,828,1724,1.0821256038647342
1990,3,1752,824,2576,2.1262135922330097
1990,4,2588,620,3208,4.174193548387096
1991,1,80,736,816,0.10869565217391304
1992,1,23,586,609,0.03924914675767918
1993,1,89,628,717,0.14171974522292993
1994,1,38,865,903,0.04393063583815029
1994,2,916,926,1842,0.9892008639308856
1995,1,71,70,141,1.0142857142857142
1995,2,335,523,858,0.6405353728489483
1995,3,888,505,1393,1.7584158415841584
1995,4,1437,819,2256,1.7545787545787546
1995,5,2301,951,3252,2.419558359621451
1996,1,66,178,244,0.3707865168539326
1996,2,266,582,848,0.4570446735395189
1997,1,758,672,1430,1.1279761904761905
1997,2,1449,86,1535,16.848837209302324
1997,3,1547,257,1804,6.019455252918288
1997,4,1818,136,1954,13.367647058823529
1997,5,1965,124,2089,15.846774193548388
1997,6,2098,108,2206,19.425925925925927
1997,7,2219,105,2324,21.133333333333333
1997,8,2334,348,2682,6.706896551724138
1997,9,2709,366,3075,7.401639344262295
1997,10,3113,449,3562,6.933184855233853
1997,11,3574,168,3742,21.273809523809526
1997,12,3771,308,4079,12.243506493506494
1997,13,4093,284,4377,14.411971830985916
1997,14,4396,241,4637,18.240663900414937
1997,15,4661,342,5003,13.628654970760234
1997,16,5042,313,5355,16.108626198083066
1997,17,5387,556,5943,9.68884892086331
1997,18,5958,508,6466,11.728346456692913
1997,19,6482,373,6855,17.378016085790886
1997,20,6896,349,7245,19.759312320916905
1997,21,7255,319,7574,22.74294670846395
1997,22,7585,219,7804,34.63470319634703
1998,1,532,827,1359,0.6432889963724304
1998,2,1374,664,2038,2.069277108433735
1999,1,1334,896,2230,1.4888392857142858
1999,2,2232,589,2821,3.789473684210526
1999,3,2823,420,3243,6.7214285714285715
2000,1,583,537,1120,1.085661080074488
2001,1,270,945,1215,0.2857142857142857
2001,2,1244,467,1711,2.663811563169165
2002,1,495,569,1064,0.8699472759226714
2003,1,41,534,575,0.07677902621722846
2003,2,591,541,1132,1.0924214417744917
2003,3,1176,624,1800,1.8846153846153846
2003,4,1818,485,2303,3.7484536082474227
2003,5,2316,693,3009,3.341991341991342
2003,6,3035,510,3545,5.950980392156863
2003,7,3560,722,4282,4.930747922437673
2003,8,4296,769,5065,5.586475942782835
2003,9,5082,573,5655,8.86910994764398
2003,10,5670,475,6145,11.936842105263159
2003,11,6161,523,6684,11.780114722753346
2004,1,435,23,458,18.91304347826087
2004,2,552,453,1005,1.218543046357616
2004,3,1214,709,1923,1.7122708039492243
2004,4,1931,737,2668,2.620081411126187
2004,5,2730,544,3274,5.018382352941177
2004,6,3282,449,3731,7.309576837416481
2004,7,3739,841,4580,4.44589774078478
2005,1,143,738,881,0.1937669376693767
2005,2,912,778,1690,1.1722365038560412
2005,3,1720,34,1754,50.588235294117645
2005,4,1776,766,2542,2.318537859007833
2006,1,378,945,1323,0.4
2006,2,1339,912,2251,1.468201754385965
2006,3,2267,714,2981,3.1750700280112043
2007,1,24,536,560,0.04477611940298507
2007,2,579,524,1103,1.1049618320610688
2008,1,1214,524,1738,2.316793893129771
2008,2,1762,210,1972,8.39047619047619
2008,3,2064,321,2385,6.429906542056075
2008,4,2415,288,2703,8.385416666666666
2008,5,3115,475,3590,6.557894736842106
2008,6,3608,293,3901,12.313993174061434
2008,7,3916,113,4029,34.65486725663717
2008,8,4054,471,4525,8.607218683651805
2008,9,4546,536,5082,8.48134328358209
2008,10,5112,285,5397,17.936842105263157
2008,11,5431,495,5926,10.971717171717172
2008,12,5957,461,6418,12.921908893709327
2008,13,6436,634,7070,10.151419558359622
2008,14,7546,424,7970,17.797169811320753
2009,1,64,737,801,0.08683853459972862
2009,2,847,354,1201,2.3926553672316384
2009,3,1221,428,1649,2.852803738317757
2010,1,213,335,548,0.6358208955223881
2010,2,557,314,871,1.7738853503184713
2011,1,102,877,979,0.11630558722919042
2011,2,987,773,1760,1.2768434670116429
2012,1,34,495,529,0.06868686868686869
2012,2,540,323,863,1.671826625386997
2012,3,869,471,1340,1.8450106157112527
2013,1,4694,199,4893,23.587939698492463
2013,2,7663,72,7735,106.43055555555556
2014,1,41,438,479,0.09360730593607305
2014,2,494,70,564,7.057142857142857
2014,3,589,110,699,5.3545454545454545
2014,4,708,80,788,8.85
2014,5,797,150,947,5.3133333333333335
2014,6,968,342,1310,2.8304093567251463
2015,1,806,391,1197,2.061381074168798
2015,2,1302,406,1708,3.206896551724138
2015,3,1710,417,2127,4.100719424460432
2015,4,2137,224,2361,9.540178571428571
2015,5,2363,202,2565,11.698019801980198
2015,6,2567,198,2765,12.964646464646465
2015,7,2767,210,2977,13.176190476190476
2015,8,2979,166,3145,17.94578313253012
2015,9,3163,345,3508,9.168115942028985
2015,10,3510,346,3856,10.144508670520231
2015,11,3868,180,4048,21.488888888888887
2015,12,4072,137,4209,29.722627737226276
2015,13,4211,17,4228,247.7058823529412
2016,1,20,401,421,0.04987531172069826
2016,2,436,458,894,0.9519650655021834
2016,3,910,714,1624,1.2745098039215685
2016,4,1636,904,2540,1.8097345132743363
2016,5,2542,532,3074,4.7781954887218046
2017,1,142,89,231,1.595505617977528
2017,2,316,510,826,0.6196078431372549
2017,3,880,389,1269,2.2622107969151672
2017,4,1516,723,2239,2.0968188105117567
2018,1,2679,1117,3796,2.3983885407341092
2019,1,69,67,136,1.0298507462686568
2019,2,1348,721,2069,1.869625520110957
2019,3,2215,855,3070,2.590643274853801
2019,4,3229,881,4110,3.6651532349602722
2019,5,4119,701,4820,5.875891583452211
2019,6,4995,996,5991,5.015060240963855
2019,7,6011,753,6764,7.98273572377158
2019,8,6786,502,7288,13.51792828685259
2019,9,7300,597,7897,12.22780569514238
2020,1,58,332,390,0.1746987951807229
2020,2,410,3,413,136.66666666666666
2021,1,2130,1015,3145,2.0985221674876846
2022,1,28,705,733,0.03971631205673759
2022,2,767,505,1272,1.5188118811881188
2022,3,1312,554,1866,2.368231046931408
2022,4,1936,461,2397,4.199566160520607
2022,5,2427,354,2781,6.8559322033898304
2023,1,115,989,1104,0.11627906976744186
2023,2,1109,438,1547,2.5319634703196345
2024,1,50,415,465,0.12048192771084337
2025,1,101,753,854,0.1341301460823373
2025,2,985,628,1613,1.5684713375796178
2025,3,1633,231,1864,7.06926406926407
2026,1,9,55,64,0.16363636363636364
2026,2,133,73,206,1.821917808219178
2026,3,208,80,288,2.6
2026,4,324,104,428,3.1153846153846154
2026,5,500,55,555,9.090909090909092
2026,6,557,39,596,14.282051282051283
2026,7,598,41,639,14.585365853658537
2026,8,687,78,765,8.807692307692308
2026,9,789,61,850,12.934426229508198
2026,10,860,143,1003,6.013986013986014
2026,11,1154,89,1243,12.96629213483146
2026,12,1314,256,1570,5.1328125
2026,13,1578,143,1721,11.034965034965035
2026,14,1804,49,1853,36.816326530612244
2026,15,1904,62,1966,30.70967741935484
2026,16,2075,53,2128,39.15094339622642
2026,17,2183,385,2568,5.67012987012987
2026,18,2580,55,2635,46.90909090909091
2026,19,2670,71,2741,37.605633802816904
2026,20,2816,163,2979,17.2760736196319
2026,21,3044,477,3521,6.381551362683438
2026,22,3531,149,3680,23.697986577181208
2026,23,3691,32,3723,115.34375
2026,24,3733,32,3765,116.65625
2026,25,3812,181,3993,21.060773480662984
2026,26,4003,28,4031,142.96428571428572
2026,27,4044,66,4110,61.27272727272727
2026,28,4118,515,4633,7.996116504854369
2026,29,4660,525,5185,8.876190476190477
2026,30,5198,86,5284,60.44186046511628
2026,31,5294,109,5403,48.56880733944954
2026,32,5424,315,5739,17.21904761904762
2026,33,5763,299,6062,19.274247491638796
2026,34,6074,180,6254,33.74444444444445
2027,1,116,397,513,0.29219143576826195
2027,2,515,352,867,1.4630681818181819
2027,3,869,302,1171,2.877483443708609
2027,4,1182,227,1409,5.20704845814978
2027,5,1491,351,1842,4.247863247863248
2027,6,1865,517,2382,3.607350096711799
2027,7,2412,403,2815,5.9851116625310175
2028,1,21,631,652,0.03328050713153724
2028,2,687,588,1275,1.1683673469387754
2028,3,1355,569,1924,2.381370826010545
2028,4,1951,710,2661,2.747887323943662
2028,5,2684,505,3189,5.314851485148515
2028,6,3294,666,3960,4.945945945945946
2028,7,4159,599,4758,6.943238731218698
2029,1,50,692,742,0.07225433526011561
2029,2,775,788,1563,0.983502538071066
2029,3,1583,421,2004,3.7600950118764844
2029,4,2021,403,2424,5.0148883374689825
2030,1,163,420,583,0.3880952380952381
2031,1,71,916,987,0.07751091703056769
2031,2,1033,611,1644,1.690671031096563
2031,3,1692,817,2509,2.0709914320685434
2031,4,2546,826,3372,3.082324455205811
2031,5,3409,645,4054,5.285271317829458
2032,1,18,856,874,0.02102803738317757
2032,2,882,399,1281,2.210526315789474
2032,3,1309,886,2195,1.4774266365688487
2032,4,2218,400,2618,5.545
2032,5,2641,599,3240,4.409015025041736
2032,6,3254,865,4119,3.7618497109826587
2033,1,26,842,868,0.030878859857482184
2034,1,12,353,365,0.0339943342776204
2034,2,367,259,626,1.416988416988417
2034,3,645,209,854,3.0861244019138754
2034,4,867,80,947,10.8375
2034,5,959,205,1164,4.678048780487805
2035,1,21,378,399,0.05555555555555555
2035,2,401,352,753,1.1392045454545454
2035,3,755,159,914,4.748427672955975
2035,4,960,377,1337,2.546419098143236
2035,5,1339,167,1506,8.017964071856287
2035,6,1513,339,1852,4.463126843657817
2035,7,1854,172,2026,10.779069767441861
2036,1,113,435,548,0.2597701149425287
2036,2,550,502,1052,1.095617529880478
2036,3,1107,904,2011,1.2245575221238938
2037,1,796,485,1281,1.6412371134020618
2037,2,1360,627,1987,2.1690590111642742
2038,1,777,249,1026,3.1204819277108435
2039,1,18,53,71,0.33962264150943394
2039,2,540,1085,1625,0.4976958525345622
2039,3,1633,1055,2688,1.5478672985781992
2039,4,2696,1107,3803,2.435411020776874
2039,5,3811,574,4385,6.639372822299651
2039,6,4454,955,5409,4.663874345549738
2039,7,5422,1094,6516,4.956124314442413
2039,8,6524,653,7177,9.990811638591119
2040,1,49,681,730,0.07195301027900147
2040,2,819,373,1192,2.195710455764075
2040,3,1325,322,1647,4.114906832298137
2040,4,1763,275,2038,6.410909090909091
2040,5,2155,22,2177,97.95454545454545
2040,6,2411,771,3182,3.127107652399481
2040,7,3229,938,4167,3.4424307036247335
2040,8,4170,519,4689,8.034682080924856
2040,9,4731,877,5608,5.394526795895097
2040,10,5611,857,6468,6.5472578763127185
2040,11,6471,342,6813,18.92105263157895
2040,12,6855,866,7721,7.915704387990762
2041,1,2010,900,2910,2.2333333333333334
2041,2,2912,593,3505,4.9106239460370995
2042,1,239,315,554,0.7587301587301587
2042,2,584,609,1193,0.9589490968801314
2042,3,1211,632,1843,1.9161392405063291
2042,4,1860,723,2583,2.5726141078838176
2043,1,24,276,300,0.08695652173913043
2043,2,396,322,718,1.2298136645962734
2043,3,726,337,1063,2.1543026706231454
2043,4,1071,340,1411,3.15
2043,5,1419,323,1742,4.393188854489164
2043,6,1750,329,2079,5.319148936170213
2043,7,2087,328,2415,6.362804878048781
2043,8,2423,236,2659,10.266949152542374
2043,9,2887,313,3200,9.223642172523961
2043,10,3208,281,3489,11.416370106761565
2043,11,3497,284,3781,12.31338028169014
2044,1,33,102,135,0.3235294117647059
2044,2,310,774,1084,0.4005167958656331
2044,3,1094,152,1246,7.197368421052632
2045,1,17,210,227,0.08095238095238096
2045,2,235,157,392,1.4968152866242037
2045,3,417,438,855,0.952054794520548
2046,1,153,1043,1196,0.14669223394055608
2046,2,1250,547,1797,2.2851919561243146
2046,3,1859,471,2330,3.94692144373673
2046,4,2371,1075,3446,2.2055813953488372
2046,5,3470,665,4135,5.2180451127819545
2046,6,4188,1112,5300,3.7661870503597124
2046,7,5332,54,5386,98.74074074074075
2046,8,5412,530,5942,10.211320754716981
2046,9,7391,212,7603,34.863207547169814
2047,1,8,233,241,0.034334763948497854
2047,2,254,285,539,0.8912280701754386
2047,3,548,396,944,1.3838383838383839
2047,4,965,430,1395,2.244186046511628
2047,5,1418,443,1861,3.200902934537246
2047,6,1872,500,2372,3.744
2047,7,2390,271,2661,8.819188191881919
2047,8,2714,147,2861,18.462585034013607
2047,9,2886,119,3005,24.252100840336134
2047,10,3038,85,3123,35.741176470588236
2047,11,3177,622,3799,5.107717041800643
2047,12,3822,654,4476,5.844036697247707
2047,13,4498,617,5115,7.290113452188007
2047,14,5256,883,6139,5.9524348810872025
2047,15,6141,704,6845,8.723011363636363
2047,16,6875,869,7744,7.9113924050632916
2048,1,167,32,199,5.21875
2048,2,237,157,394,1.5095541401273886
2049,1,8,20,28,0.4
2049,2,174,209,383,0.8325358851674641
2049,3,444,199,643,2.2311557788944723
2050,1,161,57,218,2.824561403508772
2050,2,3611,16,3627,225.6875
2051,1,66,2446,2512,0.02698282910874898
2052,1,354,1015,1369,0.34876847290640395
2053,1,229,479,708,0.4780793319415449
2054,1,26,524,550,0.04961832061068702
2054,2,562,435,997,1.2919540229885058
2055,1,16,332,348,0.04819277108433735
2056,1,79,944,1023,0.0836864406779661
2057,1,106,106,212,1.0
2057,2,225,223,448,1.0089686098654709
2057,3,455,429,884,1.0606060606060606
2057,4,888,377,1265,2.3554376657824934
2057,5,1285,202,1487,6.361386138613861
2057,6,1505,333,1838,4.51951951951952
2057,7,1852,957,2809,1.93521421107628
2057,8,2812,775,3587,3.6283870967741936
2057,9,3590,571,4161,6.287215411558669
2057,10,4175,245,4420,17.040816326530614
2057,11,4426,319,4745,13.87460815047022
2057,12,4816,401,5217,12.00997506234414
2057,13,5241,110,5351,47.64545454545455
2057,14,5354,372,5726,14.39247311827957
2057,15,5730,486,6216,11.790123456790123
2057,16,6221,537,6758,11.584729981378025
2057,17,6772,264,7036,25.651515151515152
2057,18,7070,472,7542,14.978813559322035
2057,19,7545,356,7901,21.1938202247191
2058,1,5,53,58,0.09433962264150944
2058,2,98,679,777,0.14432989690721648
2058,3,861,778,1639,1.1066838046272494
2058,4,1676,789,2465,2.124207858048162
2058,5,2588,832,3420,3.110576923076923
2058,6,3557,888,4445,4.00563063063063
2058,7,4463,563,5026,7.927175843694494
2058,8,5035,22,5057,228.86363636363637
2058,9,5065,40,5105,126.625
2058,10,6020,617,6637,9.756888168557536
2059,1,73,614,687,0.11889250814332247
2059,2,728,433,1161,1.6812933025404158
2059,3,1187,522,1709,2.2739463601532566
2059,4,1752,575,2327,3.0469565217391303
2059,5,2346,738,3084,3.178861788617886
2059,6,3107,552,3659,5.628623188405797
2059,7,3676,517,4193,7.110251450676983
2059,8,4214,583,4797,7.2281303602058316
2059,9,4831,805,5636,6.0012422360248445
2059,10,5651,864,6515,6.5405092592592595
2059,11,6538,438,6976,14.926940639269406
2059,12,6985,511,7496,13.669275929549903
2059,13,7518,423,7941,17.77304964539007
2060,1,10,382,392,0.02617801047120419
2060,2,457,407,864,1.1228501228501229
2061,1,318,305,623,1.042622950819672
2061,2,634,379,1013,1.6728232189973615
2061,3,1024,367,1391,2.790190735694823
2061,4,1402,345,1747,4.063768115942029
2061,5,1758,143,1901,12.293706293706293
2061,6,1915,96,2011,19.947916666666668
2061,7,2037,284,2321,7.172535211267606
2061,8,2352,267,2619,8.808988764044944
2061,9,2634,114,2748,23.105263157894736
2061,10,2875,338,3213,8.505917159763314
2061,11,3224,342,3566,9.426900584795321
2061,12,3577,274,3851,13.054744525547445
2061,13,3868,331,4199,11.685800604229607
2061,14,4210,345,4555,12.202898550724637
2061,15,4597,312,4909,14.73397435897436
2061,16,4920,278,5198,17.697841726618705
2061,17,5201,369,5570,14.094850948509485
2062,1,54,5,59,10.8
2062,2,129,9,138,14.333333333333334
2062,3,159,39,198,4.076923076923077
2062,4,223,7,230,31.857142857142858
2062,5,247,48,295,5.145833333333333
2063,1,118,396,514,0.29797979797979796
2063,2,536,503,1039,1.065606361829026
2063,3,1052,374,1426,2.8128342245989306
2063,4,1457,387,1844,3.764857881136951
2064,1,125,55,180,2.272727272727273
2064,2,192,29,221,6.620689655172414
2064,3,484,706,1190,0.6855524079320113
2064,4,1329,620,1949,2.143548387096774
2064,5,1984,52,2036,38.15384615384615
2064,6,2136,772,2908,2.766839378238342
2064,7,2952,736,3688,4.010869565217392
2065,1,368,56,424,6.571428571428571
2065,2,3702,491,4193,7.539714867617108
2065,3,4208,531,4739,7.9246704331450095
2065,4,4742,519,5261,9.136801541425818
2065,5,5336,246,5582,21.691056910569106
2065,6,5750,438,6188,13.127853881278538
2065,7,6205,398,6603,15.590452261306533
2065,8,6619,867,7486,7.6343713956170705
2066,1,57,859,916,0.06635622817229336
2067,1,218,717,935,0.30404463040446306
2067,2,1095,522,1617,2.0977011494252875
2067,3,1659,650,2309,2.5523076923076924
2067,4,2673,780,3453,3.4269230769230767
2067,5,3650,1040,4690,3.5096153846153846
2067,6,4724,656,5380,7.201219512195122
2067,7,5406,837,6243,6.458781362007168
2067,8,6353,1060,7413,5.993396226415094
2068,1,142,89,231,1.595505617977528
2068,2,316,510,826,0.6196078431372549
2068,3,880,389,1269,2.2622107969151672
2068,4,1669,502,2171,3.3247011952191237
2069,1,25,535,560,0.04672897196261682
2069,2,575,150,725,3.8333333333333335
2069,3,731,523,1254,1.3977055449330784
2069,4,1277,804,2081,1.5883084577114428
2070,1,91,2637,2728,0.03450891164201744
2071,1,10,442,452,0.02262443438914027
2071,2,467,607,1074,0.7693574958813838
2071,3,1089,489,1578,2.226993865030675
2071,4,1583,599,2182,2.642737896494157
2071,5,2189,734,2923,2.982288828337875
2071,6,2928,191,3119,15.329842931937172
2071,7,3127,374,3501,8.36096256684492
2071,8,3508,710,4218,4.940845070422535
2071,9,4227,591,4818,7.152284263959391
2071,10,4826,714,5540,6.759103641456583
2071,11,5548,878,6426,6.318906605922551
2071,12,6430,404,6834,15.915841584158416
2072,1,4613,1216,5829,3.7935855263157894
2072,2,5837,1235,7072,4.726315789473684
2073,1,87,726,813,0.11983471074380166
2073,2,876,595,1471,1.4722689075630253
2073,3,1521,991,2512,1.5348133198789102
2073,4,2548,596,3144,4.275167785234899
2074,1,384,669,1053,0.5739910313901345
2074,2,1216,692,1908,1.7572254335260116
2074,3,2077,787,2864,2.639135959339263
2074,4,3001,834,3835,3.5983213429256593
2074,5,3875,746,4621,5.194369973190349
2074,6,4718,468,5186,10.081196581196581
2074,7,5534,822,6356,6.732360097323601
2074,8,6833,698,7531,9.789398280802292
2075,1,377,392,769,0.9617346938775511
2075,2,786,193,979,4.072538860103627
2076,1,1362,958,2320,1.4217118997912317
2076,2,2334,472,2806,4.944915254237288
2076,3,2827,691,3518,4.091172214182344
2076,4,3604,761,4365,4.735873850197109
2076,5,4377,756,5133,5.7896825396825395
2077,1,889,481,1370,1.8482328482328483
2078,1,22,339,361,0.06489675516224189
2078,2,428,380,808,1.1263157894736842
2078,3,821,276,1097,2.9746376811594204
2078,4,1119,480,1599,2.33125
2078,5,1627,455,2082,3.575824175824176
2079,1,154,736,890,0.20923913043478262
2080,1,421,888,1309,0.4740990990990991
2081,1,560,525,1085,1.0666666666666667
2081,2,1140,635,1775,1.795275590551181
2082,1,752,4,756,188.0
2082,2,845,876,1721,0.9646118721461188
2082,3,1727,763,2490,2.2634338138925294
2082,4,2604,866,3470,3.0069284064665127
2082,5,3476,412,3888,8.436893203883495
2083,1,175,292,467,0.5993150684931506
2083,2,469,345,814,1.3594202898550725
2083,3,816,347,1163,2.351585014409222
2083,4,1165,239,1404,4.874476987447698
2083,5,1418,296,1714,4.79054054054054
2083,6,1716,358,2074,4.793296089385475
2083,7,2076,201,2277,10.328358208955224
2083,8,2299,327,2626,7.030581039755352
2083,9,2628,384,3012,6.84375
2083,10,3029,3,3032,1009.6666666666666
2084,1,32,616,648,0.05194805194805195
2084,2,716,751,1467,0.9533954727030626
2084,3,1504,652,2156,2.3067484662576687
2084,4,2249,18,2267,124.94444444444444
2084,5,2277,17,2294,133.94117647058823
2084,6,2380,738,3118,3.2249322493224932
2084,7,3178,54,3232,58.851851851851855
2084,8,3255,289,3544,11.262975778546712
2084,9,3654,605,4259,6.039669421487603
2085,1,800,1038,1838,0.7707129094412332
2085,2,1841,549,2390,3.3533697632058286
2085,3,2420,419,2839,5.7756563245823385
2085,4,2899,616,3515,4.7061688311688314
2085,5,3552,670,4222,5.3014925373134325
2085,6,4306,867,5173,4.966551326412918
2086,1,20,727,747,0.027510316368638238
2086,2,824,642,1466,1.2834890965732086
2087,1,23,855,878,0.026900584795321637
2087,2,880,460,1340,1.9130434782608696
2088,1,1132,940,2072,1.2042553191489362
2089,1,13,501,514,0.02594810379241517
2089,2,524,880,1404,0.5954545454545455
2090,1,115,804,919,0.14303482587064675
2090,2,927,792,1719,1.1704545454545454
2090,3,1727,817,2544,2.1138310893512853
2090,4,2552,293,2845,8.709897610921502
2090,5,2965,763,3728,3.885976408912189
2090,6,3736,617,4353,6.055105348460292
2090,7,4477,799,5276,5.603254067584481
2090,8,5284,554,5838,9.537906137184116
2090,9,5964,813,6777,7.3357933579335795
2090,10,6785,524,7309,12.948473282442748
2091,1,132,291,423,0.4536082474226804
2091,2,429,350,779,1.2257142857142858
2091,3,793,223,1016,3.5560538116591927
2092,1,2612,563,3175,4.63943161634103
2093,1,46,594,640,0.07744107744107744
2094,1,140,58,198,2.413793103448276
2094,2,203,40,243,5.075
2094,3,2304,76,2380,30.31578947368421
2094,4,3346,67,3413,49.940298507462686
2094,5,6280,80,6360,78.5
2094,6,7794,2,7796,3897.0
2095,1,54,169,223,0.31952662721893493
2095,2,254,251,505,1.0119521912350598
2095,3,528,256,784,2.0625
2095,4,820,985,1805,0.8324873096446701
2095,5,1806,53,1859,34.075471698113205
2095,6,1912,970,2882,1.9711340206185568
2095,7,2949,668,3617,4.414670658682635
2096,1,997,253,1250,3.940711462450593
2096,2,1300,335,1635,3.8805970149253732
2096,3,1703,387,2090,4.4005167958656335
2096,4,2135,280,2415,7.625
2096,5,2451,588,3039,4.168367346938775
2096,6,3584,315,3899,11.377777777777778
2096,7,3937,135,4072,29.16296296296296
2096,8,4111,671,4782,6.126676602086438
2096,9,4828,316,5144,15.278481012658228
2096,10,5193,415,5608,12.513253012048192
2096,11,6518,112,6630,58.19642857142857
2096,12,6679,494,7173,13.520242914979757
2096,13,7215,174,7389,41.46551724137931
2096,14,7434,161,7595,46.17391304347826
2097,1,31,653,684,0.04747320061255743
2097,2,734,707,1441,1.0381895332390383
2097,3,1465,465,1930,3.150537634408602
2097,4,1944,417,2361,4.661870503597123
2097,5,2387,501,2888,4.764471057884232
2097,6,2896,524,3420,5.526717557251908
2097,7,3432,577,4009,5.948006932409013
2097,8,4083,946,5029,4.3160676532769555
2098,1,107,331,438,0.32326283987915405
2098,2,453,293,746,1.546075085324232
2098,3,799,316,1115,2.528481012658228
2098,4,1139,251,1390,4.53784860557769
2099,1,76,603,679,0.12603648424543948
2099,2,813,567,1380,1.433862433862434
2099,3,1393,619,2012,2.250403877221325
2099,4,2070,530,2600,3.9056603773584904
2099,5,2613,629,3242,4.154213036565978
2099,6,3255,459,3714,7.091503267973856
2099,7,3726,619,4345,6.019386106623586
2099,8,4358,490,4848,8.893877551020408
2099,9,4861,544,5405,8.935661764705882
2100,1,152,54,206,2.814814814814815
2100,2,227,588,815,0.38605442176870747
2100,3,834,75,909,11.12
2100,4,947,471,1418,2.010615711252654
2101,1,458,364,822,1.2582417582417582
2102,1,54,755,809,0.07152317880794702
2102,2,845,475,1320,1.7789473684210526
2102,3,1346,894,2240,1.505592841163311
2103,1,27,325,352,0.08307692307692308
2103,2,387,426,813,0.9084507042253521
2103,3,844,350,1194,2.4114285714285715
2103,4,1202,278,1480,4.323741007194244
2103,5,1512,3,1515,504.0
2104,1,481,674,1155,0.7136498516320475
2104,2,1170,406,1576,2.8817733990147785
2104,3,1614,217,1831,7.43778801843318
2105,1,25,342,367,0.07309941520467836
2105,2,389,273,662,1.424908424908425
2105,3,679,553,1232,1.2278481012658229
2105,4,1250,352,1602,3.5511363636363638
2105,5,1614,710,2324,2.2732394366197184
2105,6,2351,343,2694,6.854227405247814
2105,7,2704,89,2793,30.382022471910112
2106,1,1009,2,1011,504.5
2106,2,2198,2,2200,1099.0
2106,3,3387,2,3389,1693.5
2106,4,4576,2,4578,2288.0
2106,5,6520,2,6522,3260.0
2106,6,6531,293,6824,22.2901023890785
2106,7,6885,395,7280,17.430379746835442
2106,8,7305,726,8031,10.061983471074381
2107,1,254,354,608,0.7175141242937854
2107,2,616,358,974,1.7206703910614525
2107,3,982,323,1305,3.040247678018576
2107,4,1313,247,1560,5.315789473684211
2107,5,1568,284,1852,5.52112676056338
2107,6,1860,340,2200,5.470588235294118
2108,1,101,963,1064,0.10488058151609553
2108,2,1140,423,1563,2.6950354609929077
2109,1,9,312,321,0.028846153846153848
2109,2,325,154,479,2.1103896103896105
2109,3,498,187,685,2.663101604278075
2109,4,692,405,1097,1.708641975308642
2109,5,1170,467,1637,2.5053533190578157
2109,6,1672,789,2461,2.1191381495564006
2109,7,2492,989,3481,2.519716885743175
2109,8,3496,224,3720,15.607142857142858
2109,9,3774,961,4735,3.927159209157128
2110,1,606,904,1510,0.6703539823008849
2110,2,1518,498,2016,3.0481927710843375
2110,3,2596,921,3517,2.818675352877307
2110,4,3956,958,4914,4.129436325678497
2110,5,4922,844,5766,5.831753554502369
2110,6,5779,191,5970,30.2565445026178
2110,7,6141,762,6903,8.059055118110237
2110,8,7139,699,7838,10.213161659513592
2111,1,186,243,429,0.7654320987654321
2111,2,448,233,681,1.9227467811158798
2111,3,706,295,1001,2.393220338983051
2111,4,1038,443,1481,2.3431151241534987
2112,1,21,717,738,0.029288702928870293
2112,2,758,126,884,6.015873015873016
2112,3,903,637,1540,1.4175824175824177
2112,4,1563,644,2207,2.4270186335403725
2113,1,123,470,593,0.26170212765957446
2113,2,629,518,1147,1.2142857142857142
2113,3,1159,783,1942,1.4802043422733078
2113,4,1969,989,2958,1.9908998988877655
2113,5,2977,629,3606,4.732909379968204
2113,6,3628,905,4533,4.008839779005525
2114,1,11,72,83,0.1527777777777778
2114,2,93,228,321,0.40789473684210525
2114,3,343,189,532,1.8148148148148149
2114,4,557,198,755,2.813131313131313
2114,5,818,455,1273,1.7978021978021979
2114,6,1340,439,1779,3.052391799544419
2114,7,1792,173,1965,10.358381502890174
2114,8,2004,319,2323,6.282131661442007
2114,9,2408,520,2928,4.630769230769231
2114,10,2966,210,3176,14.123809523809523
2114,11,3188,197,3385,16.18274111675127
2115,1,48,882,930,0.05442176870748299
2116,1,378,1230,1608,0.3073170731707317
2116,2,1663,1192,2855,1.3951342281879195
2117,1,251,191,442,1.3141361256544504
2117,2,506,454,960,1.1145374449339207
2117,3,962,455,1417,2.1142857142857143
2117,4,1438,607,2045,2.3690280065897857
2117,5,2055,421,2476,4.881235154394299
2118,1,41,163,204,0.25153374233128833
2118,2,224,194,418,1.1546391752577319
2119,1,14,1036,1050,0.013513513513513514
2119,2,1072,1048,2120,1.0229007633587786
2119,3,2141,706,2847,3.0325779036827196
2119,4,2870,860,3730,3.3372093023255816
2119,5,3744,855,4599,4.378947368421053
2119,6,4611,880,5491,5.239772727272728
2119,7,5503,957,6460,5.750261233019854
2119,8,6486,983,7469,6.598168870803662
2120,1,96,579,675,0.16580310880829016
2120,2,694,201,895,3.4527363184079602
2120,3,906,299,1205,3.0301003344481607
2120,4,1214,232,1446,5.232758620689655
2121,1,2398,483,2881,4.9648033126294
2121,2,2894,753,3647,3.8432934926958833
2121,3,3660,582,4242,6.288659793814433
2121,4,4254,482,4736,8.825726141078839
2122,1,40,781,821,0.05121638924455826
2123,1,79,378,457,0.20899470899470898
2124,1,247,178,425,1.3876404494382022
2124,2,444,175,619,2.537142857142857
2124,3,905,191,1096,4.738219895287958
2124,4,1136,32,1168,35.5
2124,5,1251,41,1292,30.51219512195122
2124,6,1309,43,1352,30.441860465116278
2124,7,1373,12,1385,114.41666666666667
2124,8,1393,13,1406,107.15384615384616
2124,9,1443,25,1468,57.72
2124,10,1477,25,1502,59.08
2124,11,1517,32,1549,47.40625
2124,12,1555,32,1587,48.59375
2124,13,1613,326,1939,4.947852760736196
2124,14,1965,253,2218,7.766798418972332
2124,15,2456,112,2568,21.928571428571427
2124,16,2606,13,2619,200.46153846153845
2125,1,18,333,351,0.05405405405405406
2125,2,370,231,601,1.6017316017316017
2125,3,632,467,1099,1.3533190578158458
2125,4,1123,1017,2140,1.104228121927237
2125,5,2176,567,2743,3.837742504409171
2125,6,2777,1014,3791,2.7386587771203157
2125,7,3837,345,4182,11.121739130434783
2126,1,588,1116,1704,0.5268817204301075
2126,2,1830,357,2187,5.126050420168068
2126,3,2236,582,2818,3.8419243986254297
2127,1,85,66,151,1.2878787878787878
2127,2,176,627,803,0.2807017543859649
2128,1,384,348,732,1.103448275862069
2128,2,735,390,1125,1.8846153846153846
2128,3,1128,226,1354,4.991150442477876
2129,1,78,858,936,0.09090909090909091
2129,2,981,574,1555,1.7090592334494774
2129,3,1564,1003,2567,1.5593220338983051
2129,4,3018,1008,4026,2.994047619047619
2129,5,4048,412,4460,9.825242718446601
2129,6,4483,642,5125,6.982866043613707
2129,7,5140,352,5492,14.602272727272727
2129,8,5501,414,5915,13.28743961352657
2129,9,5939,470,6409,12.636170212765958
2129,10,6455,862,7317,7.4883990719257545
2130,1,239,283,522,0.8445229681978799
2130,2,528,303,831,1.7425742574257426
2130,3,837,322,1159,2.599378881987578
2131,1,99,758,857,0.13060686015831136
2131,2,912,637,1549,1.4317111459968603
2132,1,432,383,815,1.1279373368146215
2132,2,820,357,1177,2.2969187675070026
2132,3,1182,386,1568,3.062176165803109
2132,4,1586,334,1920,4.748502994011976
2132,5,1927,283,2210,6.809187279151944
2132,6,2350,349,2699,6.73352435530086
2132,7,2706,330,3036,8.2
2132,8,3100,352,3452,8.806818181818182
2132,9,3479,25,3504,139.16
2132,10,3625,378,4003,9.58994708994709
2132,11,4008,290,4298,13.820689655172414
2132,12,4308,384,4692,11.21875
2132,13,4694,215,4909,21.832558139534882
2132,14,5348,409,5757,13.075794621026894
2132,15,5770,332,6102,17.379518072289155
2133,1,17,539,556,0.03153988868274583
2134,1,3003,211,3214,14.23222748815166
2134,2,6828,266,7094,25.669172932330827
2135,1,19,185,204,0.10270270270270271
2135,2,260,564,824,0.46099290780141844
2136,1,152,291,443,0.5223367697594502
2136,2,599,454,1053,1.3193832599118942
2136,3,1216,122,1338,9.967213114754099
2136,4,1503,93,1596,16.161290322580644
2136,5,1758,45,1803,39.06666666666667
2136,6,1967,454,2421,4.332599118942731
2136,7,2596,587,3183,4.4224872231686545
2136,8,3380,528,3908,6.401515151515151
2136,9,4109,596,4705,6.894295302013423
2136,10,4913,596,5509,8.243288590604028
2136,11,5719,396,6115,14.441919191919192
2136,12,6145,929,7074,6.614639397201292
2136,13,7103,580,7683,12.24655172413793
2137,1,148,1058,1206,0.13988657844990549
2137,2,1255,528,1783,2.3768939393939394
2137,3,1844,567,2411,3.252204585537919
2137,4,2445,385,2830,6.35064935064935
2137,5,2875,410,3285,7.012195121951219
2137,6,3530,299,3829,11.806020066889632
2137,7,3870,1054,4924,3.6717267552182165
2137,8,4944,1030,5974,4.8
2137,9,6025,1051,7076,5.732635585156993
2138,1,3933,701,4634,5.61055634807418
2139,1,1160,558,1718,2.078853046594982
2139,2,1740,585,2325,2.9743589743589745
2139,3,2365,799,3164,2.959949937421777
2139,4,4017,996,5013,4.033132530120482
2140,1,714,803,1517,0.8891656288916563
2140,2,1532,24,1556,63.833333333333336
2140,3,1660,624,2284,2.66025641025641
2140,4,2436,704,3140,3.460227272727273
2140,5,3158,80,3238,39.475
2140,6,3244,86,3330,37.72093023255814
2140,7,3362,69,3431,48.72463768115942
2140,8,3463,587,4050,5.899488926746167
2140,9,4065,56,4121,72.58928571428571
2140,10,4138,67,4205,61.76119402985075
2141,1,88,1246,1334,0.07062600321027288
2141,2,1339,675,2014,1.9837037037037037
2141,3,2019,62,2081,32.564516129032256
2142,1,22,122,144,0.18032786885245902
2142,2,163,514,677,0.31712062256809337
2142,3,730,512,1242,1.42578125
2142,4,1245,602,1847,2.068106312292359
2142,5,1868,884,2752,2.1131221719457014
2142,6,2780,798,3578,3.4837092731829573
2143,1,5542,174,5716,31.850574712643677
2143,2,5749,447,6196,12.861297539149888
2143,3,6212,767,6979,8.099087353324641
2143,4,6991,668,7659,10.465568862275449
2144,1,29,168,197,0.17261904761904762
2144,2,494,504,998,0.9801587301587301
2145,1,13,342,355,0.038011695906432746
2145,2,382,601,983,0.6356073211314476
2146,1,20,470,490,0.0425531914893617
2146,2,500,557,1057,0.8976660682226212
2146,3,1080,597,1677,1.8090452261306533
2147,1,46,466,512,0.09871244635193133
2147,2,548,461,1009,1.1887201735357917
2148,1,51,336,387,0.15178571428571427
2148,2,1464,481,1945,3.043659043659044
2148,3,2948,314,3262,9.388535031847134
2148,4,3671,329,4000,11.158054711246201
2148,5,4039,295,4334,13.691525423728814
2148,6,4497,330,4827,13.627272727272727
2148,7,4895,284,5179,17.235915492957748
2148,8,5224,439,5663,11.899772209567198
2148,9,5891,409,6300,14.403422982885086
2148,10,6343,306,6649,20.72875816993464
2148,11,6677,217,6894,30.76958525345622
2148,12,6993,317,7310,22.05993690851735
2148,13,7361,357,7718,20.61904761904762
2149,1,60,61,121,0.9836065573770492
2149,2,288,364,652,0.7912087912087912
2150,1,980,506,1486,1.9367588932806323
2151,1,296,374,670,0.7914438502673797
2151,2,684,319,1003,2.1442006269592477
2151,3,1022,392,1414,2.607142857142857
2151,4,1589,362,1951,4.389502762430939
2151,5,1961,504,2465,3.890873015873016
2151,6,2475,531,3006,4.661016949152542
2151,7,3041,593,3634,5.128161888701518
2151,8,3748,243,3991,15.423868312757202
2151,9,4049,182,4231,22.247252747252748
2151,10,4250,362,4612,11.740331491712707
2151,11,4666,270,4936,17.28148148148148
2151,12,4944,291,5235,16.989690721649485
2151,13,5244,470,5714,11.157446808510638
2151,14,5768,236,6004,24.440677966101696
2151,15,6017,389,6406,15.467866323907455
2151,16,6446,543,6989,11.871086556169429
2151,17,7011,431,7442,16.26682134570766
2151,18,7559,346,7905,21.846820809248555
2152,1,33,863,896,0.038238702201622246
2152,2,976,762,1738,1.2808398950131235
2153,1,35,271,306,0.12915129151291513
2154,1,1547,1070,2617,1.4457943925233645
2154,2,2619,430,3049,6.090697674418605
2154,3,3068,682,3750,4.4985337243401755
2154,4,3759,11,3770,341.72727272727275
2154,5,3811,681,4492,5.596182085168869
2154,6,4509,672,5181,6.709821428571429
2154,7,5194,677,5871,7.672082717872969
2154,8,5898,752,6650,7.843085106382978
2154,9,6659,628,7287,10.603503184713375
2154,10,7289,15,7304,485.93333333333334
2154,11,7468,5,7473,1493.6
2155,1,20,286,306,0.06993006993006994
2155,2,342,999,1341,0.34234234234234234
2156,1,678,525,1203,1.2914285714285714
2156,2,1302,171,1473,7.614035087719298
2156,3,1668,343,2011,4.862973760932944
2156,4,2107,401,2508,5.254364089775561
2156,5,2703,87,2790,31.06896551724138
2157,1,788,75,863,10.506666666666666
2157,2,876,109,985,8.036697247706423
2157,3,1037,308,1345,3.366883116883117
2157,4,1355,284,1639,4.77112676056338
2157,5,1642,317,1959,5.17981072555205
2158,1,258,562,820,0.45907473309608543
2158,2,830,610,1440,1.360655737704918
2159,1,58,387,445,0.14987080103359174
2159,2,461,206,667,2.237864077669903
2159,3,696,572,1268,1.2167832167832169
2159,4,1290,429,1719,3.006993006993007
2159,5,1744,490,2234,3.559183673469388
2159,6,2249,577,2826,3.897746967071057
2159,7,2837,619,3456,4.583198707592892
2160,1,24,629,653,0.03815580286168521
2161,1,1061,357,1418,2.9719887955182074
2161,2,4444,260,4704,17.092307692307692
2161,3,5364,396,5760,13.545454545454545
2161,4,5766,513,6279,11.239766081871345
2162,1,128,72,200,1.7777777777777777
2162,2,215,70,285,3.0714285714285716
2162,3,289,64,353,4.515625
2162,4,357,236,593,1.5127118644067796
2163,1,15,665,680,0.022556390977443608
2164,1,103,729,832,0.1412894375857339
2164,2,840,610,1450,1.3770491803278688
2164,3,1591,818,2409,1.9449877750611246
2164,4,2417,259,2676,9.332046332046332
2164,5,2823,879,3702,3.21160409556314
2164,6,3710,463,4173,8.012958963282937
2164,7,4313,827,5140,5.215235792019347
2164,8,5148,260,5408,19.8
2164,9,5550,858,6408,6.468531468531468
2164,10,6416,469,6885,13.680170575692964
2164,11,7036,828,7864,8.497584541062801
2165,1,56,283,339,0.1978798586572438
2165,2,1396,1265,2661,1.1035573122529645
2166,1,162,409,571,0.3960880195599022
2167,1,453,446,899,1.015695067264574
2167,2,901,242,1143,3.7231404958677685
2167,3,1189,601,1790,1.978369384359401
2168,1,95,538,633,0.17657992565055763
2168,2,728,537,1265,1.355679702048417
2168,3,1362,590,1952,2.3084745762711862
2168,4,1989,919,2908,2.1643090315560394
2168,5,2947,810,3757,3.6382716049382715
2168,6,3811,824,4635,4.625
2168,7,4744,1011,5755,4.692383778437191
2168,8,5864,1015,6879,5.777339901477832
2169,1,906,488,1394,1.8565573770491803
2169,2,2302,100,2402,23.02
2169,3,3324,1091,4415,3.0467461044912922
2169,4,5333,321,5654,16.613707165109034
2169,5,6582,292,6874,22.541095890410958
2170,1,120,433,553,0.27713625866050806
2170,2,564,635,1199,0.8881889763779528
2170,3,1223,675,1898,1.8118518518518518
2170,4,1963,554,2517,3.5433212996389893
2170,5,2530,282,2812,8.97163120567376
2170,6,2826,627,3453,4.507177033492823
2170,7,3501,151,3652,23.185430463576157
2170,8,3684,259,3943,14.223938223938225
2170,9,3977,235,4212,16.92340425531915
2171,1,162,290,452,0.5586206896551724
2171,2,459,387,846,1.186046511627907
2171,3,957,876,1833,1.0924657534246576
2171,4,1854,875,2729,2.1188571428571428
2172,1,20,338,358,0.05917159763313609
2172,2,393,165,558,2.381818181818182
2172,3,585,32,617,18.28125
2172,4,632,79,711,8.0
2172,5,728,56,784,13.0
2172,6,799,158,957,5.056962025316456
2172,7,999,330,1329,3.0272727272727273
2172,8,1351,140,1491,9.65
2172,9,1523,361,1884,4.218836565096953
2172,10,1906,146,2052,13.054794520547945
2173,1,36,290,326,0.12413793103448276
2173,2,338,326,664,1.0368098159509203
2173,3,666,28,694,23.785714285714285
2174,1,47,961,1008,0.04890738813735692
2174,2,1016,608,1624,1.6710526315789473
2174,3,1778,970,2748,1.8329896907216494
2174,4,2858,954,3812,2.9958071278825997
2174,5,3820,505,4325,7.564356435643564
2175,1,60,88,148,0.6818181818181818
2175,2,231,76,307,3.039473684210526
2175,3,343,58,401,5.913793103448276
2176,1,403,433,836,0.930715935334873
2176,2,1547,682,2229,2.268328445747801
2176,3,2596,955,3551,2.718324607329843
2176,4,3658,1226,4884,2.9836867862969005
2176,5,4918,317,5235,15.514195583596214
2176,6,5345,1215,6560,4.399176954732511
2177,1,32,190,222,0.16842105263157894
2178,1,49,738,787,0.06639566395663957
2178,2,839,398,1237,2.108040201005025
2179,1,33,309,342,0.10679611650485436
2179,2,360,286,646,1.2587412587412588
2180,1,17,251,268,0.06772908366533864
2181,1,26,534,560,0.04868913857677903
2181,2,587,126,713,4.658730158730159
2181,3,1458,363,1821,4.016528925619835
2181,4,2627,344,2971,7.636627906976744
2181,5,3267,391,3658,8.35549872122762
2181,6,4389,287,4676,15.292682926829269
2181,7,4757,184,4941,25.85326086956522
2181,8,4970,449,5419,11.069042316258352
2181,9,5440,362,5802,15.027624309392266
2181,10,5826,244,6070,23.87704918032787
2181,11,6093,516,6609,11.80813953488372
2181,12,6711,566,7277,11.856890459363958
2181,13,7319,484,7803,15.12190082644628
2182,1,79,165,244,0.47878787878787876
2182,2,252,689,941,0.36574746008708275
2182,3,962,395,1357,2.4354430379746836
2183,1,22,504,526,0.04365079365079365
2183,2,543,921,1464,0.5895765472312704
2183,3,1484,1010,2494,1.4693069306930693
2183,4,2517,1076,3593,2.3392193308550184
2183,5,3621,812,4433,4.45935960591133
2183,6,4452,684,5136,6.508771929824562
2183,7,5157,1035,6192,4.982608695652174
2183,8,6240,1018,7258,6.129666011787819
2184,1,11,696,707,0.015804597701149427
2185,1,123,653,776,0.1883614088820827
2185,2,811,957,1768,0.8474399164054337
2185,3,1882,706,2588,2.6657223796033995
2186,1,2302,1077,3379,2.1374187558031568
2186,2,3387,600,3987,5.645
2186,3,5756,570,6326,10.098245614035088
2186,4,6384,639,7023,9.990610328638498
2186,5,7280,820,8100,8.878048780487806
2187,1,45,81,126,0.5555555555555556
2187,2,155,639,794,0.24256651017214398
2188,1,241,694,935,0.3472622478386167
2188,2,954,685,1639,1.3927007299270073
2189,1,1580,318,1898,4.968553459119497
2189,2,1932,647,2579,2.9860896445131377
2189,3,2642,706,3348,3.7422096317280453
2189,4,3428,873,4301,3.926689576174112
2189,5,4304,307,4611,14.019543973941367
2189,6,4648,700,5348,6.64
2189,7,5363,668,6031,8.028443113772456
2189,8,6053,874,6927,6.925629290617849
2189,9,6930,630,7560,11.0
2190,1,157,16,173,9.8125
2190,2,248,133,381,1.8646616541353382
2190,3,487,84,571,5.7976190476190474
2190,4,2306,146,2452,15.794520547945206
2190,5,2456,50,2506,49.12
2190,6,3224,174,3398,18.528735632183906
2190,7,3503,161,3664,21.757763975155278
2191,1,34,495,529,0.06868686868686869
2191,2,540,323,863,1.671826625386997
2191,3,869,471,1340,1.8450106157112527
2191,4,1348,147,1495,9.170068027210885
2191,5,1508,429,1937,3.515151515151515
2191,6,1962,631,2593,3.109350237717908
2192,1,51,933,984,0.05466237942122187
2192,2,1059,802,1861,1.3204488778054864
2192,3,1900,978,2878,1.9427402862985685
2192,4,3045,649,3694,4.691833590138675
2192,5,4005,993,4998,4.033232628398792
2192,6,5186,1150,6336,4.509565217391304
2192,7,6438,442,6880,14.565610859728507
2192,8,6954,256,7210,27.1640625
2193,1,64,682,746,0.093841642228739
2193,2,776,385,1161,2.0155844155844154
2193,3,1446,640,2086,2.259375
2193,4,3064,856,3920,3.5794392523364484
2194,1,1509,261,1770,5.781609195402299
2194,2,1775,338,2113,5.2514792899408285
2194,3,2118,255,2373,8.305882352941177
2194,4,2412,230,2642,10.486956521739131
2194,5,2657,310,2967,8.570967741935483
2194,6,3418,311,3729,10.990353697749196
2194,7,3734,311,4045,12.006430868167202
2194,8,4050,311,4361,13.02250803858521
2194,9,4366,323,4689,13.51702786377709
2194,10,4694,279,4973,16.82437275985663
2194,11,5071,302,5373,16.79139072847682
2194,12,5378,275,5653,19.556363636363635
2194,13,5658,225,5883,25.14666666666667
2194,14,5960,356,6316,16.741573033707866
2194,15,6321,324,6645,19.50925925925926
2195,1,1468,62,1530,23.677419354838708
2195,2,1566,700,2266,2.237142857142857
2196,1,1723,139,1862,12.39568345323741
2196,2,1872,208,2080,9.0
2197,1,8,15,23,0.5333333333333333
2197,2,532,984,1516,0.540650406504065
2197,3,1518,241,1759,6.2987551867219915
2197,4,1775,992,2767,1.7893145161290323
2197,5,2769,220,2989,12.586363636363636
2198,1,20,984,1004,0.02032520325203252
2198,2,1013,562,1575,1.802491103202847
2198,3,1683,965,2648,1.744041450777202
2199,1,20,338,358,0.05917159763313609
2199,2,393,165,558,2.381818181818182
2200,1,284,1008,1292,0.28174603174603174
2200,2,1300,993,2293,1.309164149043303
2200,3,2346,752,3098,3.11968085106383
2200,4,3126,521,3647,6.0
2200,5,3655,1031,4686,3.545101842870999
2200,6,4694,462,5156,10.16017316017316
2200,7,5190,765,5955,6.784313725490196
2200,8,5995,765,6760,7.836601307189542
2200,9,6800,939,7739,7.24174653887114
2201,1,35,398,433,0.08793969849246232
2201,2,480,571,1051,0.840630472854641
2201,3,1087,763,1850,1.4246395806028833
2202,1,33,188,221,0.17553191489361702
2202,2,249,137,386,1.8175182481751824
2202,3,419,403,822,1.0397022332506203
2202,4,827,386,1213,2.1424870466321244
2203,1,556,233,789,2.3862660944206007
2203,2,857,407,1264,2.1056511056511056
2203,3,1283,379,1662,3.3852242744063323
2203,4,1695,293,1988,5.784982935153583
2203,5,2017,272,2289,7.415441176470588
2203,6,2306,392,2698,5.88265306122449
2203,7,2715,858,3573,3.164335664335664
2203,8,3612,761,4373,4.746386333771354
2203,9,4382,810,5192,5.409876543209877
2203,10,5208,97,5305,53.69072164948454
2203,11,5309,922,6231,5.758134490238612
2203,12,6243,662,6905,9.430513595166163
2204,1,664,654,1318,1.0152905198776758
2204,2,1385,461,1846,3.004338394793926
2204,3,1858,474,2332,3.919831223628692
2205,1,554,696,1250,0.7959770114942529
2205,2,1324,328,1652,4.036585365853658
2205,3,1748,842,2590,2.0760095011876483
2205,4,2593,84,2677,30.86904761904762
2206,1,41,790,831,0.05189873417721519
2206,2,858,443,1301,1.9367945823927766
2206,3,1326,414,1740,3.2028985507246377
2206,4,1763,412,2175,4.279126213592233
2206,5,2196,449,2645,4.89086859688196
2206,6,2711,390,3101,6.9512820512820515
2206,7,3118,576,3694,5.413194444444445
2206,8,3801,547,4348,6.948811700182816
2206,9,4384,461,4845,9.509761388286334
2206,10,4913,958,5871,5.12839248434238
2206,11,5886,493,6379,11.939148073022313
2206,12,6395,343,6738,18.644314868804663
2206,13,6752,678,7430,9.958702064896755
2207,1,106,22,128,4.818181818181818
2207,2,233,330,563,0.706060606060606
2207,3,576,225,801,2.56
2207,4,842,341,1183,2.469208211143695
2207,5,1192,244,1436,4.885245901639344
2207,6,1700,322,2022,5.279503105590062
2207,7,2029,312,2341,6.503205128205129
2207,8,2344,309,2653,7.585760517799352
2207,9,2666,89,2755,29.95505617977528
2207,10,2762,13,2775,212.46153846153845
2208,1,14,191,205,0.07329842931937172
2208,2,229,136,365,1.6838235294117647
2209,1,145,105,250,1.380952380952381
2209,2,253,89,342,2.842696629213483
2209,3,345,67,412,5.149253731343284
2209,4,415,79,494,5.253164556962025
2209,5,497,74,571,6.716216216216216
2209,6,574,173,747,3.3179190751445087
2209,7,766,115,881,6.660869565217391
2209,8,884,50,934,17.68
2209,9,949,90,1039,10.544444444444444
2209,10,1042,65,1107,16.03076923076923
2209,11,1129,96,1225,11.760416666666666
2209,12,1228,53,1281,23.169811320754718
2209,13,1295,87,1382,14.885057471264368
2209,14,1385,48,1433,28.854166666666668
2209,15,1435,75,1510,19.133333333333333
2209,16,1521,87,1608,17.482758620689655
2209,17,1631,215,1846,7.586046511627907
2209,18,1871,135,2006,13.85925925925926
2209,19,2024,288,2312,7.027777777777778
2210,1,13,715,728,0.01818181818181818
2210,2,755,560,1315,1.3482142857142858
2210,3,1331,1101,2432,1.2089009990917348
2210,4,2435,1036,3471,2.3503861003861
2210,5,3474,584,4058,5.948630136986301
2211,1,6,93,99,0.06451612903225806
2211,2,133,403,536,0.33002481389578164
2212,1,351,603,954,0.582089552238806
2212,2,967,590,1557,1.6389830508474577
2212,3,1575,689,2264,2.285921625544267
2212,4,3364,567,3931,5.932980599647267
2212,5,3948,843,4791,4.683274021352313
2213,1,87,906,993,0.09602649006622517
2214,1,897,279,1176,3.21505376344086
2214,2,2343,245,2588,9.56326530612245
2214,3,3599,311,3910,11.572347266881028
2214,4,4452,481,4933,9.255717255717256
2214,5,4983,652,5635,7.642638036809816
2214,6,6008,336,6344,17.88095238095238
2214,7,7194,707,7901,10.175388967468175
2215,1,149,1234,1383,0.12074554294975688
2215,2,1392,900,2292,1.5466666666666666
2215,3,2398,813,3211,2.949569495694957
2216,1,30,745,775,0.040268456375838924
2217,1,83,988,1071,0.0840080971659919
2217,2,1079,500,1579,2.158
2218,1,191,586,777,0.32593856655290104
2218,2,810,767,1577,1.0560625814863103
2218,3,1624,726,2350,2.236914600550964
2218,4,2398,947,3345,2.53220696937698
2218,5,3475,892,4367,3.8957399103139014
2218,6,4388,440,4828,9.972727272727273
2218,7,4864,436,5300,11.155963302752294
2219,1,36,802,838,0.04488778054862843
2220,1,90,781,871,0.11523687580025609
2220,2,882,485,1367,1.8185567010309278
2221,1,3,16,19,0.1875
2221,2,29,44,73,0.6590909090909091
2221,3,82,70,152,1.1714285714285715
2221,4,710,505,1215,1.4059405940594059
2221,5,1218,223,1441,5.461883408071749
2221,6,1444,492,1936,2.934959349593496
2221,7,1986,105,2091,18.914285714285715
2221,8,2677,874,3551,3.062929061784897
2222,1,60,52,112,1.1538461538461537
2222,2,118,96,214,1.2291666666666667
2222,3,223,215,438,1.0372093023255815
2222,4,444,276,720,1.608695652173913
2222,5,727,278,1005,2.615107913669065
2222,6,1012,195,1207,5.18974358974359
2222,7,1222,387,1609,3.157622739018088
2222,8,1621,467,2088,3.4710920770877944
2222,9,2112,563,2675,3.7513321492007106
2223,1,29,523,552,0.055449330783938815
2223,2,601,751,1352,0.800266311584554
2223,3,1377,668,2045,2.061377245508982
2223,4,2067,452,2519,4.573008849557522
2223,5,2545,600,3145,4.241666666666666
2224,1,301,55,356,5.472727272727273
2224,2,374,76,450,4.921052631578948
2224,3,459,70,529,6.557142857142857
2224,4,538,73,611,7.36986301369863
2224,5,620,78,698,7.948717948717949
2224,6,706,73,779,9.67123287671233
2224,7,787,89,876,8.842696629213483
2224,8,985,72,1057,13.680555555555555
2224,9,1066,79,1145,13.49367088607595
2224,10,1169,79,1248,14.79746835443038
2224,11,1256,73,1329,17.205479452054796
2224,12,1337,70,1407,19.1
2224,13,1415,73,1488,19.383561643835616
2224,14,1496,73,1569,20.493150684931507
2224,15,1577,73,1650,21.602739726027398
2224,16,1658,89,1747,18.629213483146067
2225,1,126,596,722,0.21140939597315436
2225,2,743,307,1050,2.420195439739414
2225,3,1077,627,1704,1.7177033492822966
2225,4,1715,589,2304,2.9117147707979627
2225,5,2332,778,3110,2.9974293059125965
2225,6,3116,49,3165,63.59183673469388
2226,1,15,191,206,0.07853403141361257
2227,1,43,429,472,0.10023310023310024
2227,2,491,458,949,1.0720524017467248
2228,1,374,1001,1375,0.37362637362637363
2228,2,1402,931,2333,1.5059076262083781
2229,1,114,32,146,3.5625
2229,2,818,304,1122,2.6907894736842106
2229,3,1154,275,1429,4.196363636363636
2229,4,1656,351,2007,4.717948717948718
2229,5,2019,28,2047,72.10714285714286
2229,6,2668,404,3072,6.603960396039604
2229,7,3092,393,3485,7.867684478371501
2229,8,3510,468,3978,7.5
2229,9,4021,431,4452,9.329466357308585
2229,10,4479,416,4895,10.766826923076923
2229,11,5198,442,5640,11.760180995475114
2229,12,5689,495,6184,11.492929292929293
2229,13,6198,49,6247,126.48979591836735
2230,1,10,265,275,0.03773584905660377
2231,1,689,764,1453,0.9018324607329843
2231,2,2142,82,2224,26.121951219512194
2231,3,2533,391,2924,6.478260869565218
2231,4,2963,160,3123,18.51875
2231,5,3134,440,3574,7.122727272727273
2231,6,4158,30,4188,138.6
2231,7,4222,751,4973,5.621837549933422
2231,8,4990,488,5478,10.225409836065573
2231,9,5487,632,6119,8.681962025316455
2231,10,6134,938,7072,6.539445628997868
2231,11,7083,187,7270,37.87700534759358
2232,1,21,631,652,0.03328050713153724
2232,2,687,588,1275,1.1683673469387754
2232,3,1355,569,1924,2.381370826010545
2232,4,1951,710,2661,2.747887323943662
2232,5,2684,505,3189,5.314851485148515
2233,1,19,456,475,0.041666666666666664
2233,2,520,440,960,1.1818181818181819
2234,1,102,389,491,0.2622107969151671
2235,1,13,370,383,0.03513513513513514
2235,2,403,8,411,50.375
2235,3,417,302,719,1.380794701986755
2235,4,733,106,839,6.915094339622642
2235,5,846,372,1218,2.274193548387097
2235,6,1221,299,1520,4.083612040133779
2236,1,617,4,621,154.25
2236,2,1211,529,1740,2.2892249527410207
2236,3,1822,308,2130,5.915584415584416
2236,4,2178,75,2253,29.04
2236,5,2424,443,2867,5.471783295711061
2237,1,55,509,564,0.10805500982318271
2237,2,648,510,1158,1.2705882352941176
2238,1,60,73,133,0.821917808219178
2238,2,556,547,1103,1.016453382084095
2239,1,32,61,93,0.5245901639344263
2239,2,133,515,648,0.258252427184466
2239,3,730,661,1391,1.1043872919818456
2239,4,2576,954,3530,2.70020964360587
2239,5,3545,518,4063,6.843629343629344
2239,6,4086,198,4284,20.636363636363637
2239,7,4305,989,5294,4.3528816986855405
2239,8,5316,340,5656,15.635294117647058
2239,9,5713,175,5888,32.645714285714284
2239,10,5950,616,6566,9.659090909090908
2239,11,6594,483,7077,13.652173913043478
2239,12,7108,501,7609,14.187624750499001
2239,13,7622,434,8056,17.56221198156682
2240,1,24,636,660,0.03773584905660377
2240,2,691,687,1378,1.0058224163027656
2240,3,1408,582,1990,2.4192439862542954
2240,4,2006,240,2246,8.358333333333333
2240,5,2272,532,2804,4.2706766917293235
2240,6,2826,740,3566,3.8189189189189188
2240,7,3574,390,3964,9.164102564102564
2240,8,3987,274,4261,14.55109489051095
2240,9,5059,305,5364,16.58688524590164
2240,10,5383,137,5520,39.29197080291971
2240,11,6170,85,6255,72.58823529411765
2240,12,6272,130,6402,48.246153846153845
2240,13,6453,225,6678,28.68
2240,14,6698,229,6927,29.24890829694323
2240,15,6963,183,7146,38.049180327868854
2240,16,7174,170,7344,42.2
2240,17,7360,179,7539,41.11731843575419
2241,1,9,610,619,0.014754098360655738
2241,2,639,607,1246,1.0527182866556837
2241,3,1257,429,1686,2.93006993006993
2241,4,3997,533,4530,7.49906191369606
2241,5,7439,480,7919,15.497916666666667
2242,1,47,405,452,0.11604938271604938
2243,1,72,147,219,0.4897959183673469
2243,2,226,80,306,2.825
2243,3,312,194,506,1.6082474226804124
2243,4,1381,189,1570,7.306878306878307
2243,5,1594,202,1796,7.891089108910891
2244,1,144,466,610,0.3090128755364807
2244,2,645,411,1056,1.5693430656934306
2245,1,125,446,571,0.2802690582959641
2246,1,43,861,904,0.04994192799070848
2246,2,922,724,1646,1.2734806629834254
2247,1,72,79,151,0.9113924050632911
2247,2,904,363,1267,2.490358126721763
2247,3,1287,65,1352,19.8
2247,4,3034,351,3385,8.643874643874645
2247,5,3404,53,3457,64.22641509433963
2248,1,12,267,279,0.0449438202247191
2248,2,306,413,719,0.7409200968523002
2248,3,774,439,1213,1.7630979498861048
2248,4,1255,557,1812,2.253141831238779
2248,5,1874,422,2296,4.440758293838862
2248,6,2320,780,3100,2.9743589743589745
2248,7,3143,596,3739,5.273489932885906
2248,8,3801,545,4346,6.9743119266055045
2248,9,4370,427,4797,10.234192037470725
2248,10,4843,229,5072,21.148471615720524
2249,1,25,565,590,0.04424778761061947
2249,2,606,380,986,1.5947368421052632
2249,3,991,440,1431,2.2522727272727274
2250,1,84,709,793,0.11847672778561354
2250,2,934,471,1405,1.9830148619957537
2250,3,1408,452,1860,3.1150442477876106
2250,4,2052,582,2634,3.5257731958762886
2250,5,2741,596,3337,4.598993288590604
2250,6,3450,427,3877,8.079625292740047
2250,7,3880,308,4188,12.597402597402597
2250,8,4290,630,4920,6.809523809523809
2250,9,5022,640,5662,7.846875
2250,10,5760,645,6405,8.930232558139535
2250,11,6490,555,7045,11.693693693693694
2250,12,7156,617,7773,11.598055105348461
2251,1,41,855,896,0.047953216374269005
2251,2,909,11,920,82.63636363636364
2251,3,1546,766,2312,2.0182767624020888
2252,1,172,403,575,0.4267990074441687
2253,1,34,290,324,0.11724137931034483
2253,2,356,620,976,0.5741935483870968
2253,3,1004,583,1587,1.7221269296740995
2254,1,31,769,800,0.04031209362808843
2254,2,812,240,1052,3.3833333333333333
2254,3,1071,574,1645,1.8658536585365855
2255,1,85,58,143,1.4655172413793103
2255,2,2480,904,3384,2.743362831858407
2255,3,3396,592,3988,5.736486486486487
2255,4,4003,634,4637,6.313880126182966
2255,5,5198,1021,6219,5.091087169441724
2256,1,180,364,544,0.4945054945054945
2256,2,546,84,630,6.5
2256,3,644,163,807,3.950920245398773
2256,4,822,165,987,4.9818181818181815
2256,5,1011,377,1388,2.6816976127320955
2257,1,17,393,410,0.043256997455470736
2257,2,422,529,951,0.7977315689981096
2257,3,962,584,1546,1.6472602739726028
2258,1,418,56,474,7.464285714285714
2259,1,512,365,877,1.4027397260273973
2259,2,927,403,1330,2.300248138957816
2259,3,1352,380,1732,3.557894736842105
2260,1,233,822,1055,0.28345498783454987
2260,2,1073,503,1576,2.1332007952286283
2260,3,1595,430,2025,3.7093023255813953
2260,4,2041,642,2683,3.1791277258566977
2260,5,2698,1041,3739,2.5917387127761766
2260,6,3742,571,4313,6.553415061295972
2261,1,67,831,898,0.08062575210589651
2261,2,946,926,1872,1.0215982721382288
2261,3,1916,718,2634,2.668523676880223
2261,4,2688,1300,3988,2.0676923076923077
2261,5,4000,918,4918,4.357298474945534
2261,6,4938,898,5836,5.498886414253898
2261,7,5945,1346,7291,4.416790490341754
2262,1,33,565,598,0.0584070796460177
2262,2,648,1036,1684,0.6254826254826255
2263,1,72,318,390,0.22641509433962265
2263,2,405,287,692,1.411149825783972
2263,3,707,249,956,2.8393574297188753
2263,4,1078,323,1401,3.3374613003095974
2263,5,1416,311,1727,4.553054662379421
2263,6,1799,322,2121,5.586956521739131
2263,7,2136,342,2478,6.245614035087719
2263,8,2493,94,2587,26.52127659574468
2263,9,2847,275,3122,10.352727272727273
2263,10,3137,270,3407,11.618518518518519
2263,11,3489,242,3731,14.417355371900827
2263,12,3741,320,4061,11.690625
2263,13,4322,162,4484,26.679012345679013
2263,14,4532,147,4679,30.829931972789115
2263,15,5113,329,5442,15.541033434650457
2263,16,5452,204,5656,26.725490196078432
2263,17,5910,292,6202,20.23972602739726
2263,18,6212,163,6375,38.11042944785276
2263,19,6409,50,6459,128.18
2263,20,6620,289,6909,22.906574394463668
2263,21,6919,146,7065,47.39041095890411
2263,22,7161,303,7464,23.633663366336634
2263,23,7626,304,7930,25.085526315789473
2264,1,50,971,1021,0.05149330587023687
2264,2,1035,987,2022,1.0486322188449848
2265,1,17,402,419,0.04228855721393035
2265,2,435,482,917,0.9024896265560166
2265,3,932,502,1434,1.8565737051792828
2265,4,1445,548,1993,2.636861313868613
2265,5,2014,624,2638,3.2275641025641026
2266,1,75,1095,1170,0.0684931506849315
2266,2,1192,418,1610,2.851674641148325
2266,3,1652,485,2137,3.406185567010309
2266,4,2230,703,2933,3.1721194879089616
2266,5,2953,1046,3999,2.823135755258126
2266,6,4046,1021,5067,3.962781586679726
2266,7,5088,1000,6088,5.088
2266,8,6118,1019,7137,6.003925417075564
2267,1,36,322,358,0.11180124223602485
2267,2,369,214,583,1.7242990654205608
2268,1,5,26,31,0.19230769230769232
2268,2,90,786,876,0.11450381679389313
2268,3,893,967,1860,0.9234746639089969
2268,4,1915,529,2444,3.620037807183365
2268,5,2471,386,2857,6.401554404145077
2268,6,2891,417,3308,6.932853717026379
2269,1,90,747,837,0.12048192771084337
2270,1,355,916,1271,0.3875545851528384
2271,1,19,332,351,0.0572289156626506
2271,2,409,1017,1426,0.40216322517207476
2271,3,1528,728,2256,2.098901098901099
2271,4,2389,624,3013,3.828525641025641
2272,1,148,1031,1179,0.14354995150339475
2272,2,1190,534,1724,2.2284644194756553
2273,1,3539,2,3541,1769.5
2273,2,3602,256,3858,14.0703125
2273,3,3931,278,4209,14.140287769784173
2273,4,4281,8,4289,535.125
2273,5,4366,199,4565,21.939698492462313
2273,6,4638,8,4646,579.75
2273,7,4711,211,4922,22.327014218009477
2274,1,24,973,997,0.024665981500513873
2275,1,56,699,755,0.08011444921316166
2276,1,2782,366,3148,7.601092896174864
2277,1,17,852,869,0.01995305164319249
2277,2,902,20,922,45.1
2278,1,91,113,204,0.8053097345132744
2278,2,321,513,834,0.6257309941520468
2278,3,871,513,1384,1.6978557504873295
2279,1,419,623,1042,0.6725521669341894
2279,2,1059,616,1675,1.719155844155844
2279,3,1701,536,2237,3.173507462686567
2279,4,2279,636,2915,3.5833333333333335
2279,5,2950,584,3534,5.051369863013699
2279,6,3566,537,4103,6.640595903165735
2279,7,4131,496,4627,8.328629032258064
2279,8,4657,616,5273,7.560064935064935
2279,9,5287,378,5665,13.986772486772487
2279,10,5670,562,6232,10.088967971530248
2279,11,6281,502,6783,12.51195219123506
2279,12,6799,483,7282,14.076604554865424
2279,13,7332,610,7942,12.01967213114754
2280,1,17,30,47,0.5666666666666667
2280,2,204,309,513,0.6601941747572816
2280,3,548,305,853,1.79672131147541
2280,4,860,343,1203,2.507288629737609
2280,5,1241,313,1554,3.9648562300319488
2280,6,1564,377,1941,4.1485411140583555
2281,1,198,533,731,0.3714821763602251
2282,1,149,1010,1159,0.14752475247524752
2283,1,10,829,839,0.012062726176115802
2283,2,876,676,1552,1.2958579881656804
2283,3,1560,980,2540,1.5918367346938775
2283,4,2632,343,2975,7.673469387755102
2283,5,3011,541,3552,5.565619223659889
2283,6,3569,982,4551,3.634419551934827
2283,7,4560,614,5174,7.4267100977198695
2283,8,5205,959,6164,5.427528675703858
2283,9,6189,831,7020,7.447653429602888
2283,10,7040,809,7849,8.702101359703338
2284,1,262,115,377,2.2782608695652176
2284,2,997,83,1080,12.012048192771084
2284,3,1086,121,1207,8.975206611570249
2284,4,1213,311,1524,3.90032154340836
2284,5,1530,463,1993,3.304535637149028
2284,6,1999,530,2529,3.771698113207547
2284,7,2535,880,3415,2.8806818181818183
2284,8,3421,836,4257,4.092105263157895
2284,9,4263,436,4699,9.777522935779816
2284,10,4705,725,5430,6.489655172413793
2284,11,5436,1004,6440,5.414342629482071
2284,12,6451,407,6858,15.85012285012285
2284,13,6864,298,7162,23.033557046979865
2285,1,38,250,288,0.152
2285,2,555,330,885,1.6818181818181819
2285,3,906,243,1149,3.728395061728395
2285,4,1165,371,1536,3.1401617250673852
2286,1,12,900,912,0.013333333333333334
2286,2,914,858,1772,1.0652680652680653
2286,3,1774,932,2706,1.9034334763948497
2286,4,2708,883,3591,3.066817667044168
2286,5,3604,861,4465,4.185830429732869
2287,1,85,821,906,0.10353227771010962
2287,2,916,996,1912,0.9196787148594378
2287,3,2310,341,2651,6.774193548387097
2287,4,2687,48,2735,55.979166666666664
2287,5,2757,136,2893,20.272058823529413
2287,6,2901,81,2982,35.81481481481482
2287,7,2990,247,3237,12.105263157894736
2287,8,3248,728,3976,4.461538461538462
2287,9,4275,174,4449,24.56896551724138
2287,10,4467,183,4650,24.40983606557377
2287,11,4662,213,4875,21.887323943661972
2287,12,4928,385,5313,12.8
2287,13,5338,115,5453,46.417391304347824
2287,14,5465,229,5694,23.8646288209607
2287,15,5754,442,6196,13.018099547511312
2287,16,6515,341,6856,19.10557184750733
2287,17,7568,252,7820,30.03174603174603
2288,1,96,700,796,0.13714285714285715
2289,1,8,43,51,0.18604651162790697
2289,2,60,349,409,0.17191977077363896
2289,3,464,498,962,0.9317269076305221
2289,4,1025,285,1310,3.5964912280701755
2289,5,1335,436,1771,3.061926605504587
2289,6,1788,475,2263,3.7642105263157895
2289,7,2347,513,2860,4.57504873294347
2289,8,2933,428,3361,6.852803738317757
2289,9,3397,464,3861,7.321120689655173
2289,10,3980,456,4436,8.728070175438596
2289,11,4515,596,5111,7.575503355704698
2289,12,5147,196,5343,26.260204081632654
2289,13,5387,262,5649,20.561068702290076
2289,14,5674,194,5868,29.24742268041237
2289,15,5901,680,6581,8.677941176470588
2289,16,6582,48,6630,137.125
2290,1,59,622,681,0.09485530546623794
2290,2,714,644,1358,1.108695652173913
2290,3,1428,669,2097,2.1345291479820627
2290,4,2123,970,3093,2.188659793814433
2290,5,3096,649,3745,4.770416024653313
2290,6,3759,42,3801,89.5
2291,1,30,759,789,0.039525691699604744
2291,2,798,788,1586,1.0126903553299493
2292,1,26,614,640,0.04234527687296417
2293,1,22,403,425,0.05459057071960298
2293,2,510,981,1491,0.5198776758409785
2293,3,1620,890,2510,1.8202247191011236
2293,4,2528,209,2737,12.095693779904305
2293,5,2764,37,2801,74.70270270270271
2294,1,40,435,475,0.09195402298850575
2294,2,504,558,1062,0.9032258064516129
2294,3,1082,517,1599,2.09284332688588
2294,4,1617,480,2097,3.36875
2294,5,2119,483,2602,4.387163561076605
2294,6,2632,1028,3660,2.5603112840466924
2294,7,3668,565,4233,6.4920353982300885
2294,8,4258,983,5241,4.331637843336725
2294,9,5261,335,5596,15.704477611940298
2294,10,5619,649,6268,8.657935285053929
2294,11,6364,757,7121,8.406869220607662
2294,12,7152,560,7712,12.771428571428572
2295,1,8,815,823,0.0098159509202454
2296,1,119,804,923,0.1480099502487562
2296,2,935,792,1727,1.1805555555555556
2296,3,1739,817,2556,2.128518971848225
2296,4,2568,293,2861,8.764505119453926
2296,5,2985,763,3748,3.9121887287024903
2296,6,3760,617,4377,6.094003241491086
2296,7,4505,799,5304,5.638297872340425
2296,8,5316,554,5870,9.5956678700361
2296,9,6000,813,6813,7.380073800738008
2296,10,6825,524,7349,13.024809160305344
2297,1,21,456,477,0.046052631578947366
2298,1,26,145,171,0.1793103448275862
2299,1,17,342,359,0.049707602339181284
2299,2,381,302,683,1.2615894039735098
2299,3,725,164,889,4.420731707317073
2299,4,926,141,1067,6.567375886524823
2299,5,1113,234,1347,4.756410256410256
2299,6,1363,333,1696,4.093093093093093
2299,7,1778,226,2004,7.867256637168142
2300,1,358,232,590,1.543103448275862
2300,2,600,143,743,4.195804195804196
2300,3,750,97,847,7.731958762886598
2300,4,857,126,983,6.801587301587301
2300,5,994,95,1089,10.463157894736842
2300,6,1100,115,1215,9.565217391304348
2300,7,1224,163,1387,7.50920245398773
2300,8,1398,133,1531,10.511278195488721
2300,9,1542,156,1698,9.884615384615385
2300,10,1706,105,1811,16.247619047619047
2300,11,1819,141,1960,12.900709219858156
2300,12,1972,139,2111,14.18705035971223
2300,13,2122,129,2251,16.449612403100776
2301,1,161,47,208,3.425531914893617
2301,2,215,29,244,7.413793103448276
2301,3,623,231,854,2.696969696969697
2301,4,1025,121,1146,8.47107438016529
2301,5,1171,79,1250,14.822784810126583
2301,6,1263,144,1407,8.770833333333334
2301,7,1419,209,1628,6.7894736842105265
2301,8,1654,385,2039,4.296103896103896
2301,9,2058,413,2471,4.983050847457627
2301,10,2495,390,2885,6.397435897435898
2301,11,2890,131,3021,22.061068702290076
2301,12,3060,406,3466,7.536945812807882
2301,13,3484,349,3833,9.982808022922637
2301,14,3882,104,3986,37.32692307692308
2301,15,4081,258,4339,15.817829457364342
2301,16,4404,444,4848,9.91891891891892
2301,17,4895,539,5434,9.081632653061224
2301,18,5470,680,6150,8.044117647058824
2301,19,6173,636,6809,9.705974842767295
2301,20,6850,781,7631,8.770806658130601
2301,21,7652,250,7902,30.608
2302,1,39,383,422,0.10182767624020887
2302,2,458,438,896,1.0456621004566211
2303,1,146,100,246,1.46
2304,1,78,620,698,0.12580645161290321
2304,2,795,565,1360,1.407079646017699
2305,1,499,556,1055,0.8974820143884892
2306,1,592,626,1218,0.9456869009584664
2307,1,23,318,341,0.07232704402515723
2308,1,26,73,99,0.3561643835616438
2308,2,115,71,186,1.619718309859155
2308,3,209,57,266,3.6666666666666665
2309,1,537,705,1242,0.7617021276595745
2309,2,1730,737,2467,2.3473541383989147
2309,3,2521,754,3275,3.343501326259947
2309,4,3315,621,3936,5.338164251207729
2310,1,2019,397,2416,5.085642317380352
2310,2,2473,449,2922,5.507795100222717
2310,3,2981,332,3313,8.978915662650602
2310,4,3820,389,4209,9.820051413881748
2310,5,4211,309,4520,13.627831715210355
2310,6,4581,368,4949,12.44836956521739
2310,7,5003,418,5421,11.9688995215311
2310,8,6005,409,6414,14.682151589242054
2310,9,6461,364,6825,17.75
2310,10,6889,428,7317,16.095794392523363
2310,11,7319,328,7647,22.3140243902439
2310,12,7722,358,8080,21.56983240223464
2311,1,20,606,626,0.033003300330033
2311,2,631,619,1250,1.0193861066235865
2311,3,1266,464,1730,2.728448275862069
2311,4,1738,472,2210,3.6822033898305087
2311,5,2256,50,2306,45.12
2311,6,2312,315,2627,7.339682539682539
2311,7,2693,227,2920,11.863436123348018
2311,8,2928,146,3074,20.054794520547944
2312,1,2762,4,2766,690.5
2312,2,2823,177,3000,15.94915254237288
2312,3,3072,268,3340,11.462686567164178
2312,4,3357,436,3793,7.6995412844036695
2313,1,79,531,610,0.1487758945386064
2313,2,671,273,944,2.457875457875458
2313,3,983,384,1367,2.5598958333333335
2313,4,1705,480,2185,3.5520833333333335
2313,5,2270,373,2643,6.085790884718499
2313,6,2687,305,2992,8.809836065573771
2314,1,20,478,498,0.04184100418410042
2314,2,549,351,900,1.564102564102564
2315,1,241,608,849,0.3963815789473684
2315,2,922,300,1222,3.0733333333333333
2315,3,1224,379,1603,3.229551451187335
2315,4,1658,564,2222,2.9397163120567376
2315,5,2236,618,2854,3.618122977346278
2315,6,3087,664,3751,4.649096385542169
2315,7,3804,692,4496,5.497109826589595
2315,8,4507,738,5245,6.107046070460704
2315,9,5277,732,6009,7.209016393442623
2315,10,6027,661,6688,9.118003025718608
2315,11,6720,805,7525,8.347826086956522
2316,1,98,803,901,0.12204234122042341
2317,1,27,580,607,0.04655172413793104
2317,2,616,536,1152,1.1492537313432836
2317,3,1163,558,1721,2.0842293906810037
2317,4,1751,570,2321,3.0719298245614035
2317,5,2327,766,3093,3.037859007832898
2317,6,3163,811,3974,3.900123304562269
2317,7,3984,771,4755,5.167315175097277
2317,8,4792,50,4842,95.84
2317,9,4849,548,5397,8.848540145985401
2317,10,5413,46,5459,117.67391304347827
2317,11,5479,297,5776,18.447811447811446
2317,12,5785,223,6008,25.94170403587444
2318,1,41,647,688,0.0633693972179289
2318,2,699,831,1530,0.8411552346570397
2318,3,1545,983,2528,1.5717192268565616
2318,4,2555,576,3131,4.435763888888889
2318,5,3147,374,3521,8.414438502673796
2318,6,3537,639,4176,5.535211267605634
2318,7,4223,346,4569,12.205202312138729
2318,8,4619,241,4860,19.16597510373444
2318,9,4956,956,5912,5.184100418410042
2318,10,7007,331,7338,21.169184290030213
2318,11,7385,220,7605,33.56818181818182
2318,12,7651,200,7851,38.255
2319,1,16,598,614,0.026755852842809364
2319,2,630,569,1199,1.1072056239015817
2320,1,911,218,1129,4.178899082568807
2321,1,134,526,660,0.25475285171102663
2321,2,710,399,1109,1.7794486215538847
2322,1,34,34,68,1.0
2322,2,112,790,902,0.14177215189873418
2322,3,921,422,1343,2.1824644549763033
2322,4,1362,609,1971,2.2364532019704435
2322,5,1990,547,2537,3.6380255941499087
2323,1,23,814,837,0.028255528255528257
2324,1,218,1031,1249,0.21144519883608148
2324,2,1403,947,2350,1.4815205913410772
2324,3,2481,1034,3515,2.3994197292069632
2324,4,3558,1037,4595,3.431051108968177
2324,5,4692,981,5673,4.782874617737003
2324,6,5789,954,6743,6.068134171907757
2324,7,6795,953,7748,7.130115424973767
2325,1,51,225,276,0.22666666666666666
2325,2,424,313,737,1.354632587859425
2325,3,760,33,793,23.03030303030303
2325,4,801,224,1025,3.575892857142857
2325,5,1074,163,1237,6.588957055214724
2325,6,1286,139,1425,9.251798561151078
2325,7,1870,655,2525,2.854961832061069
2325,8,2567,728,3295,3.526098901098901
2325,9,3310,134,3444,24.70149253731343
2325,10,3479,930,4409,3.7408602150537633
2325,11,4433,144,4577,30.78472222222222
2326,1,535,290,825,1.8448275862068966
2327,1,434,939,1373,0.46219382321618746
2327,2,1401,657,2058,2.132420091324201
2328,1,31,631,662,0.0491283676703645
2329,1,1180,1022,2202,1.1545988258317026
2329,2,2232,941,3173,2.3719447396386824
2330,1,6326,1051,7377,6.019029495718364
2330,2,7398,587,7985,12.603066439522998
2331,1,35,686,721,0.05102040816326531
2331,2,744,658,1402,1.1306990881458967
2331,3,1413,601,2014,2.35108153078203
2332,1,83,193,276,0.43005181347150256
2332,2,411,469,880,0.8763326226012793
2332,3,881,360,1241,2.4472222222222224
2332,4,1242,341,1583,3.6422287390029324
2332,5,1584,371,1955,4.269541778975741
2332,6,1956,356,2312,5.49438202247191
2332,7,2313,406,2719,5.697044334975369
2332,8,2720,314,3034,8.662420382165605
2333,1,103,1049,1152,0.09818875119161107
2333,2,1159,817,1976,1.4186046511627908
2334,1,34,340,374,0.1
2334,2,381,366,747,1.040983606557377
2335,1,64,654,718,0.09785932721712538
2335,2,747,685,1432,1.0905109489051095
2335,3,1475,774,2249,1.9056847545219637
2335,4,2320,847,3167,2.739079102715466
2336,1,411,161,572,2.5527950310559007
2336,2,591,92,683,6.423913043478261
2336,3,701,147,848,4.7687074829931975
2336,4,863,372,1235,2.3198924731182795
2336,5,1250,93,1343,13.440860215053764
2336,6,1364,36,1400,37.888888888888886
2336,7,1425,25,1450,57.0
2337,1,22,770,792,0.02857142857142857
2337,2,1906,819,2725,2.3272283272283274
2337,3,2744,619,3363,4.432956381260097
2338,1,32,872,904,0.03669724770642202
2339,1,276,1052,1328,0.2623574144486692
2339,2,1427,331,1758,4.311178247734139
2339,3,1764,824,2588,2.1407766990291264
2339,4,2689,1254,3943,2.1443381180223287
2340,1,12,556,568,0.02158273381294964
2340,2,579,276,855,2.097826086956522
2341,1,26,538,564,0.048327137546468404
2342,1,20,286,306,0.06993006993006994
2342,2,342,999,1341,0.34234234234234234
2342,3,1365,465,1830,2.935483870967742
2342,4,1855,421,2276,4.406175771971497
2342,5,2313,955,3268,2.4219895287958115
2342,6,3308,958,4266,3.453027139874739
2342,7,4347,961,5308,4.523413111342352
2342,8,5328,364,5692,14.637362637362637
2342,9,5712,419,6131,13.632458233890215
2343,1,8,43,51,0.18604651162790697
2343,2,60,221,281,0.27149321266968324
2343,3,284,25,309,11.36
2344,1,79,134,213,0.5895522388059702
2344,2,253,115,368,2.2
2345,1,262,308,570,0.8506493506493507
2345,2,586,98,684,5.979591836734694
2345,3,704,339,1043,2.0766961651917404
2346,1,802,748,1550,1.072192513368984
2347,1,246,573,819,0.4293193717277487
2347,2,999,681,1680,1.4669603524229076
2347,3,1744,832,2576,2.0961538461538463
2347,4,2607,801,3408,3.254681647940075
2347,5,3554,776,4330,4.579896907216495
2347,6,4369,603,4972,7.2454394693200666
2348,1,106,583,689,0.18181818181818182
2348,2,721,571,1292,1.2626970227670753
2348,3,1303,568,1871,2.2940140845070425
2348,4,1888,569,2457,3.3181019332161688
2349,1,98,368,466,0.266304347826087
2349,2,485,198,683,2.4494949494949494
2350,1,26,183,209,0.14207650273224043
2350,2,222,268,490,0.8283582089552238
2350,3,504,355,859,1.419718309859155
2350,4,870,227,1097,3.8325991189427313
2351,1,53,877,930,0.06043329532497149
2352,1,273,868,1141,0.31451612903225806
2352,2,1421,818,2239,1.7371638141809291
2352,3,2249,64,2313,35.140625
2352,4,3547,907,4454,3.910694597574421
2352,5,4467,720,5187,6.204166666666667
2352,6,5197,57,5254,91.17543859649123
2352,7,5257,56,5313,93.875
2352,8,5330,64,5394,83.28125
2352,9,5432,30,5462,181.06666666666666
2352,10,5550,89,5639,62.359550561797754
2352,11,6052,823,6875,7.353584447144593
2352,12,6881,530,7411,12.983018867924528
2353,1,222,970,1192,0.2288659793814433
2353,2,1210,921,2131,1.3137893593919652
2353,3,2161,976,3137,2.214139344262295
2353,4,3624,631,4255,5.743264659270999
2353,5,4681,776,5457,6.032216494845361
2353,6,5473,1103,6576,4.961922030825023
2353,7,6610,361,6971,18.310249307479225
2353,8,7152,309,7461,23.145631067961165
2353,9,7471,85,7556,87.89411764705882
2353,10,7567,329,7896,23.0
2354,1,87,801,888,0.10861423220973783
2354,2,912,640,1552,1.425
2354,3,1566,423,1989,3.702127659574468
2354,4,2002,429,2431,4.666666666666667
2354,5,2449,526,2975,4.655893536121673
2354,6,2988,580,3568,5.151724137931034
2354,7,3582,480,4062,7.4625
2354,8,4103,588,4691,6.977891156462585
2355,1,60,375,435,0.16
2356,1,49,118,167,0.4152542372881356
2356,2,1723,416,2139,4.141826923076923
2356,3,2170,179,2349,12.12290502793296
2356,4,2358,328,2686,7.189024390243903
2356,5,2723,109,2832,24.98165137614679
2356,6,2865,353,3218,8.11614730878187
2356,7,3235,178,3413,18.174157303370787
2356,8,3426,229,3655,14.960698689956331
2356,9,3682,381,4063,9.664041994750656
2356,10,4071,189,4260,21.53968253968254
2356,11,4278,259,4537,16.517374517374517
2356,12,4553,228,4781,19.969298245614034
2356,13,4798,233,5031,20.59227467811159
2356,14,5039,258,5297,19.531007751937985
2356,15,5321,164,5485,32.44512195121951
2356,16,5494,228,5722,24.096491228070175
2356,17,5732,249,5981,23.02008032128514
2356,18,5997,320,6317,18.740625
2356,19,6358,328,6686,19.384146341463413
2356,20,6701,414,7115,16.185990338164252
2356,21,7148,274,7422,26.087591240875913
2356,22,7435,272,7707,27.334558823529413
2356,23,7741,260,8001,29.773076923076925
2357,1,49,436,485,0.11238532110091744
2357,2,573,731,1304,0.7838577291381669
2357,3,1355,1037,2392,1.3066538090646094
2357,4,2407,571,2978,4.215411558669002
2357,5,2988,350,3338,8.537142857142857
2357,6,4501,259,4760,17.37837837837838
2357,7,4795,834,5629,5.749400479616307
2357,8,5684,703,6387,8.085348506401138
2357,9,6434,1076,7510,5.979553903345725
2357,10,7537,54,7591,139.57407407407408
2358,1,27,79,106,0.34177215189873417
2358,2,140,414,554,0.33816425120772947
2358,3,594,340,934,1.7470588235294118
2358,4,1024,541,1565,1.8927911275415896
2358,5,1611,806,2417,1.998759305210918
2359,1,82,435,517,0.18850574712643678
2359,2,920,204,1124,4.509803921568627
2359,3,1145,352,1497,3.252840909090909
2360,1,112,788,900,0.14213197969543148
2361,1,179,1059,1238,0.16902738432483475
2362,1,190,11,201,17.272727272727273
2363,1,17,41,58,0.4146341463414634
2363,2,463,592,1055,0.7820945945945946
2363,3,1093,600,1693,1.8216666666666668
2363,4,1722,786,2508,2.1908396946564888
2363,5,2529,107,2636,23.635514018691588
2363,6,2664,237,2901,11.240506329113924
2364,1,1,10,11,0.1
2364,2,79,345,424,0.2289855072463768
2364,3,449,398,847,1.1281407035175879
2364,4,869,369,1238,2.355013550135501
2364,5,1258,425,1683,2.96
2364,6,1712,247,1959,6.931174089068826
2364,7,1975,232,2207,8.512931034482758
2364,8,2219,6,2225,369.8333333333333
2364,9,2251,414,2665,5.43719806763285
2364,10,2815,254,3069,11.082677165354331
2364,11,3171,96,3267,33.03125
2364,12,3304,268,3572,12.328358208955224
2364,13,3677,9,3686,408.55555555555554
2364,14,4012,9,4021,445.77777777777777
2364,15,4039,369,4408,10.94579945799458
2364,16,4427,20,4447,221.35
2364,17,4463,24,4487,185.95833333333334
2364,18,4509,279,4788,16.161290322580644
2364,19,4816,246,5062,19.577235772357724
2364,20,5093,88,5181,57.875
2364,21,5198,286,5484,18.174825174825173
2364,22,5508,310,5818,17.767741935483873
2364,23,5855,379,6234,15.448548812664908
2364,24,6258,266,6524,23.526315789473685
2364,25,6565,314,6879,20.90764331210191
2364,26,6907,249,7156,27.73895582329317
2364,27,7180,368,7548,19.51086956521739
2364,28,7571,318,7889,23.80817610062893
2365,1,48,635,683,0.07559055118110236
2365,2,696,628,1324,1.10828025477707
2365,3,1331,622,1953,2.139871382636656
2366,1,1560,528,2088,2.9545454545454546
2367,1,239,69,308,3.463768115942029
2367,2,502,332,834,1.5120481927710843
2367,3,1038,277,1315,3.747292418772563
2367,4,1492,230,1722,6.48695652173913
2367,5,1732,288,2020,6.013888888888889
2367,6,2203,183,2386,12.03825136612022
2367,7,2561,132,2693,19.401515151515152
2368,1,84,106,190,0.7924528301886793
2368,2,284,47,331,6.042553191489362
2368,3,559,289,848,1.934256055363322
2368,4,877,42,919,20.88095238095238
2368,5,2896,907,3803,3.1929437706725468
2368,6,3822,380,4202,10.057894736842105
2368,7,4225,256,4481,16.50390625
2368,8,4503,140,4643,32.16428571428571
2368,9,4668,369,5037,12.65040650406504
2368,10,5069,37,5106,137.0
2368,11,5451,689,6140,7.911465892597968
2368,12,6155,54,6209,113.98148148148148
2368,13,6234,312,6546,19.98076923076923
2368,14,6571,319,6890,20.598746081504704
2368,15,6915,317,7232,21.813880126182966
2368,16,7257,320,7577,22.678125
2368,17,7608,278,7886,27.366906474820144
2368,18,7896,37,7933,213.40540540540542
2369,1,74,193,267,0.38341968911917096
2369,2,269,371,640,0.7250673854447439
2369,3,642,167,809,3.844311377245509
2369,4,839,314,1153,2.671974522292994
2369,5,1198,287,1485,4.174216027874564
2369,6,1507,329,1836,4.580547112462006
2369,7,1862,259,2121,7.1891891891891895
2369,8,2134,288,2422,7.409722222222222
2369,9,2465,185,2650,13.324324324324325
2369,10,2652,164,2816,16.170731707317074
2369,11,2818,160,2978,17.6125
2369,12,2998,163,3161,18.392638036809817
2369,13,3163,349,3512,9.063037249283667
2369,14,3531,370,3901,9.543243243243243
2369,15,3963,260,4223,15.242307692307692
2369,16,4235,169,4404,25.059171597633135
2370,1,25,505,530,0.04950495049504951
2371,1,17,561,578,0.030303030303030304
2371,2,598,595,1193,1.0050420168067227
2371,3,1234,705,1939,1.750354609929078
2371,4,1995,831,2826,2.4007220216606497
2371,5,2847,863,3710,3.298957126303592
2372,1,36,496,532,0.07258064516129033
2373,1,144,497,641,0.289738430583501
2374,1,17,922,939,0.01843817787418655
2375,1,3630,501,4131,7.245508982035928
2375,2,4167,386,4553,10.795336787564766
2376,1,925,273,1198,3.3882783882783882
2376,2,1212,340,1552,3.5647058823529414
2376,3,1569,245,1814,6.404081632653061
2377,1,450,465,915,0.967741935483871
2377,2,1007,769,1776,1.3094928478543564
2377,3,1807,806,2613,2.2419354838709675
2377,4,2693,352,3045,7.650568181818182
2377,5,3895,816,4711,4.77328431372549
2377,6,4763,219,4982,21.748858447488583
2377,7,5470,299,5769,18.294314381270905
2377,8,7462,640,8102,11.659375
2378,1,38,376,414,0.10106382978723404
2378,2,439,286,725,1.534965034965035
2378,3,751,345,1096,2.1768115942028987
2379,1,999,601,1600,1.6622296173044926
2380,1,53,45,98,1.1777777777777778
2380,2,113,38,151,2.973684210526316
2380,3,885,411,1296,2.153284671532847
2380,4,1596,167,1763,9.55688622754491
2380,5,1973,139,2112,14.194244604316546
2380,6,2359,131,2490,18.00763358778626
2380,7,2711,148,2859,18.31756756756757
2380,8,2860,40,2900,71.5
2380,9,3540,379,3919,9.340369393139841
2380,10,4080,148,4228,27.56756756756757
2380,11,4381,146,4527,30.006849315068493
2380,12,4686,101,4787,46.396039603960396
2380,13,4987,131,5118,38.06870229007634
2380,14,5814,47,5861,123.70212765957447
2380,15,5981,18,5999,332.27777777777777
2380,16,6010,245,6255,24.53061224489796
2380,17,6966,398,7364,17.502512562814072
2380,18,7374,30,7404,245.8
2380,19,7550,129,7679,58.52713178294574
2380,20,7712,35,7747,220.34285714285716
2381,1,14,420,434,0.03333333333333333
2381,2,454,527,981,0.8614800759013282
2382,1,44,63,107,0.6984126984126984
2382,2,181,850,1031,0.21294117647058824
2382,3,2497,60,2557,41.61666666666667
2382,4,4610,884,5494,5.214932126696833
2382,5,5496,886,6382,6.203160270880361
2382,6,6384,900,7284,7.093333333333334
2383,1,17,1037,1054,0.01639344262295082
2383,2,1070,349,1419,3.0659025787965617
2383,3,1436,1092,2528,1.315018315018315
2383,4,2534,1093,3627,2.3183897529734674
2383,5,3648,267,3915,13.662921348314606
2383,6,3938,269,4207,14.639405204460967
2384,1,18,900,918,0.02
2384,2,971,555,1526,1.7495495495495494
2385,1,98,705,803,0.13900709219858157
2385,2,828,502,1330,1.649402390438247
2385,3,1351,751,2102,1.7989347536617843
2385,4,2156,894,3050,2.411633109619687
2385,5,3079,280,3359,10.996428571428572
2385,6,3390,371,3761,9.137466307277627
2386,1,32,372,404,0.08602150537634409
2386,2,809,130,939,6.223076923076923
2386,3,2952,30,2982,98.4
2386,4,2991,270,3261,11.077777777777778
2386,5,3288,245,3533,13.420408163265305
2386,6,3643,147,3790,24.782312925170068
2386,7,3825,151,3976,25.33112582781457
2386,8,6050,258,6308,23.449612403100776
2386,9,6507,428,6935,15.203271028037383
2386,10,6958,345,7303,20.168115942028987
2386,11,7315,348,7663,21.020114942528735
2387,1,1055,875,1930,1.2057142857142857
2387,2,1969,825,2794,2.3866666666666667
2387,3,2796,825,3621,3.389090909090909
2388,1,101,133,234,0.7593984962406015
2388,2,296,179,475,1.6536312849162011
2388,3,490,224,714,2.1875
2388,4,811,98,909,8.275510204081632
2388,5,922,174,1096,5.2988505747126435
2389,1,284,590,874,0.48135593220338985
2389,3,876,66,942,13.272727272727273
2389,4,1017,316,1333,3.2183544303797467
2389,5,1343,265,1608,5.067924528301887
2389,6,1616,276,1892,5.855072463768116
2389,7,1992,340,2332,5.858823529411764
2390,1,684,673,1357,1.0163447251114412
2390,2,1505,662,2167,2.273413897280967
2390,3,2243,654,2897,3.429663608562691
2390,4,2973,588,3561,5.0561224489795915
2390,5,3637,643,4280,5.656298600311042
2390,6,4356,654,5010,6.660550458715596
2390,7,5130,578,5708,8.875432525951558
2390,8,5828,718,6546,8.116991643454039
2390,9,6666,716,7382,9.310055865921788
2391,1,18,120,138,0.15
2391,2,172,355,527,0.48450704225352115
2391,3,658,532,1190,1.236842105263158
2392,1,578,624,1202,0.9262820512820513
2393,1,17,405,422,0.04197530864197531
2393,2,436,422,858,1.033175355450237
2393,3,882,424,1306,2.080188679245283
2393,4,1318,334,1652,3.946107784431138
2393,5,1735,412,2147,4.211165048543689
2393,6,2203,362,2565,6.085635359116022
2393,7,2591,378,2969,6.854497354497354
2393,8,2992,375,3367,7.978666666666666
2393,9,3421,405,3826,8.446913580246914
2393,10,3835,592,4427,6.47804054054054
2393,11,4467,543,5010,8.226519337016574
2393,12,5027,512,5539,9.818359375
2393,13,5585,536,6121,10.419776119402986
2393,14,6155,496,6651,12.409274193548388
2393,15,6685,529,7214,12.637051039697543
2393,16,7274,472,7746,15.411016949152541
2394,1,80,333,413,0.24024024024024024
2394,2,462,655,1117,0.7053435114503817
2394,3,1148,473,1621,2.427061310782241
2394,4,1650,801,2451,2.059925093632959
2395,1,2168,193,2361,11.233160621761659
2395,2,2390,571,2961,4.185639229422066
2395,3,3041,989,4030,3.0748230535894843
2395,4,4033,725,4758,5.562758620689655
2395,5,4795,268,5063,17.89179104477612
2396,1,11,727,738,0.015130674002751032
2397,1,164,87,251,1.8850574712643677
2397,2,261,144,405,1.8125
2397,3,426,111,537,3.8378378378378377
2397,4,576,86,662,6.6976744186046515
2397,5,686,86,772,7.976744186046512
2397,6,792,129,921,6.1395348837209305
2397,7,928,122,1050,7.60655737704918
2398,1,110,428,538,0.2570093457943925
2399,1,23,636,659,0.036163522012578615
2400,1,148,484,632,0.30578512396694213
2400,2,643,692,1335,0.9291907514450867
2401,1,14,858,872,0.016317016317016316
2401,2,891,383,1274,2.3263707571801566
2401,3,1277,257,1534,4.968871595330739
2401,4,1554,392,1946,3.9642857142857144
2401,5,1949,152,2101,12.822368421052632
2401,6,2172,467,2639,4.650963597430406
2401,7,2642,292,2934,9.047945205479452
2401,8,2958,388,3346,7.623711340206185
2401,9,3366,354,3720,9.508474576271187
2401,10,3757,363,4120,10.349862258953168
2402,1,47,919,966,0.051142546245919476
2402,2,969,155,1124,6.251612903225807
2402,3,1266,668,1934,1.8952095808383234
2402,4,2123,786,2909,2.7010178117048347
2402,5,3071,709,3780,4.331452750352609
2402,6,3991,730,4721,5.467123287671233
2402,7,4893,711,5604,6.881856540084388
2402,8,5762,724,6486,7.958563535911602
2402,9,6567,871,7438,7.539609644087256
2402,10,7441,92,7533,80.8804347826087
2403,1,116,397,513,0.29219143576826195
2403,2,515,352,867,1.4630681818181819
2403,3,869,302,1171,2.877483443708609
2403,4,1182,227,1409,5.20704845814978
2403,5,1491,351,1842,4.247863247863248
2403,6,1865,517,2382,3.607350096711799
2403,7,2412,403,2815,5.9851116625310175
2404,1,43,165,208,0.2606060606060606
2404,2,256,125,381,2.048
2404,3,417,42,459,9.928571428571429
2404,4,508,220,728,2.309090909090909
2404,5,766,379,1145,2.021108179419525
2404,6,1255,541,1796,2.319778188539741
2404,7,2016,488,2504,4.131147540983607
2404,8,2681,540,3221,4.964814814814815
2404,9,3405,474,3879,7.1835443037974684
2404,10,3961,602,4563,6.579734219269103
2405,1,86,912,998,0.09429824561403509
2405,2,1007,1102,2109,0.9137931034482759
2405,3,2116,1158,3274,1.8272884283246977
2405,4,3499,1030,4529,3.3970873786407765
2405,5,4556,1161,5717,3.9242032730404826
2406,1,575,74,649,7.77027027027027
2406,2,908,516,1424,1.7596899224806202
2407,1,199,323,522,0.6160990712074303
2407,2,840,432,1272,1.9444444444444444
2407,3,1422,467,1889,3.044967880085653
2407,4,1984,166,2150,11.951807228915662
2407,5,2181,653,2834,3.339969372128637
2407,6,2915,817,3732,3.5679314565483478
2407,7,3780,580,4360,6.517241379310345
2407,8,4489,435,4924,10.319540229885057
2407,9,5057,644,5701,7.85248447204969
2407,10,5856,588,6444,9.959183673469388
2408,1,85,59,144,1.4406779661016949
2408,2,1685,402,2087,4.191542288557214
2409,1,20,537,557,0.037243947858473
2409,2,599,583,1182,1.0274442538593482
2409,3,1234,894,2128,1.3803131991051454
2409,4,2130,291,2421,7.319587628865979
2409,5,2475,677,3152,3.655834564254062
2409,6,3203,687,3890,4.662299854439593
2409,7,3948,756,4704,5.222222222222222
2409,8,4771,796,5567,5.993718592964824
2409,9,5624,593,6217,9.483979763912311
2410,1,49,2712,2761,0.018067846607669618
2411,1,83,850,933,0.0976470588235294
2411,2,1019,1021,2040,0.9980411361410382
2411,3,2216,807,3023,2.745972738537794
2411,4,3120,853,3973,3.6576787807737396
2411,5,4115,849,4964,4.846878680800942
2411,6,5349,877,6226,6.099201824401368
2411,7,6308,880,7188,7.168181818181818
2411,8,7212,148,7360,48.729729729729726
2412,1,1215,306,1521,3.9705882352941178
2413,1,130,346,476,0.37572254335260113
2413,2,481,383,864,1.2558746736292428
2413,3,867,317,1184,2.7350157728706623
2413,4,1203,220,1423,5.468181818181818
2414,1,168,209,377,0.8038277511961722
2414,2,488,270,758,1.8074074074074074
2414,3,904,758,1662,1.1926121372031662
2415,1,54,948,1002,0.056962025316455694
2416,1,50,476,526,0.10504201680672269
2416,2,562,338,900,1.6627218934911243
2416,3,942,309,1251,3.0485436893203883
2416,4,1375,719,2094,1.9123783031988872
2416,5,2154,98,2252,21.979591836734695
2416,6,2349,797,3146,2.9473023839397743
2416,7,3195,766,3961,4.171018276762402
2416,8,4128,830,4958,4.973493975903614
2416,9,5110,922,6032,5.542299349240781
2416,10,6183,955,7138,6.47434554973822
2416,11,7164,365,7529,19.627397260273973
2417,1,10,411,421,0.024330900243309004
2417,2,444,597,1041,0.7437185929648241
2417,3,1071,691,1762,1.5499276410998553
2417,4,1788,743,2531,2.4064602960969044
2417,5,2535,451,2986,5.6208425720620845
2417,6,3017,742,3759,4.066037735849057
2417,7,3763,555,4318,6.78018018018018
2417,8,4386,763,5149,5.748361730013106
2417,9,5153,492,5645,10.473577235772357
2417,10,5671,790,6461,7.178481012658228
2417,11,6465,637,7102,10.149136577708006
2418,1,47,39,86,1.205128205128205
2418,2,93,127,220,0.7322834645669292
2419,1,59,271,330,0.2177121771217712
2419,2,353,303,656,1.165016501650165
2419,3,686,295,981,2.3254237288135595
2419,4,1032,325,1357,3.1753846153846155
2420,1,89,688,777,0.12936046511627908
2420,2,841,552,1393,1.5235507246376812
2420,3,1436,166,1602,8.650602409638553
2420,4,1631,106,1737,15.38679245283019
2420,5,1776,266,2042,6.676691729323308
2420,6,2083,444,2527,4.691441441441442
2420,7,2591,179,2770,14.474860335195531
2420,8,2896,317,3213,9.135646687697161
2420,9,3308,264,3572,12.530303030303031
2420,10,3631,438,4069,8.289954337899543
2420,11,4119,229,4348,17.986899563318776
2420,12,4359,82,4441,53.15853658536585
2420,13,4504,388,4892,11.608247422680412
2420,14,4921,89,5010,55.29213483146067
2420,15,5046,142,5188,35.53521126760563
2420,16,5217,393,5610,13.274809160305344
2420,17,5654,116,5770,48.741379310344826
2421,1,1286,981,2267,1.3109072375127422
2421,2,2275,489,2764,4.652351738241308
2421,3,4124,814,4938,5.066339066339066
2421,4,5295,809,6104,6.545117428924598
2421,5,6394,973,7367,6.571428571428571
2422,1,34,34,68,1.0
2422,2,112,790,902,0.14177215189873418
2422,3,921,422,1343,2.1824644549763033
2422,4,1362,609,1971,2.2364532019704435
2422,5,1990,547,2537,3.6380255941499087
2423,1,15,570,585,0.02631578947368421
2423,2,600,442,1042,1.3574660633484164
2423,3,1063,674,1737,1.5771513353115727
2423,4,1758,625,2383,2.8128
2424,1,189,555,744,0.34054054054054056
2424,2,771,274,1045,2.8138686131386863
2424,3,1066,894,1960,1.192393736017897
2424,4,1983,395,2378,5.020253164556962
2424,5,2400,682,3082,3.5190615835777126
2424,6,3162,512,3674,6.17578125
2424,7,3690,346,4036,10.664739884393063
2424,8,4077,398,4475,10.243718592964823
2424,9,4487,933,5420,4.809217577706324
2425,1,307,454,761,0.6762114537444934
2425,2,777,593,1370,1.3102866779089377
2425,3,1380,318,1698,4.339622641509434
2425,4,1706,500,2206,3.412
2425,5,2216,906,3122,2.445916114790287
2425,6,3138,127,3265,24.708661417322833
2425,7,3272,149,3421,21.959731543624162
2425,8,3459,199,3658,17.381909547738694
2426,1,17,698,715,0.024355300859598854
2426,2,725,668,1393,1.0853293413173652
2426,3,1406,760,2166,1.85
2426,4,2177,814,2991,2.6744471744471743
2426,5,3005,875,3880,3.434285714285714
2426,6,3891,502,4393,7.750996015936255
2426,7,4412,609,5021,7.244663382594417
2426,8,5035,755,5790,6.66887417218543
2426,9,5804,909,6713,6.385038503850385
2426,10,6727,898,7625,7.491091314031181
2427,1,80,582,662,0.13745704467353953
2427,2,664,31,695,21.419354838709676
2428,1,8,569,577,0.014059753954305799
2428,2,593,848,1441,0.6992924528301887
2428,3,1444,435,1879,3.3195402298850576
2428,4,1881,501,2382,3.754491017964072
2428,5,2384,664,3048,3.5903614457831323
2428,6,3050,649,3699,4.699537750385208
2428,7,3701,557,4258,6.644524236983842
2429,1,23,843,866,0.027283511269276393
2430,1,29,49,78,0.5918367346938775
2430,2,91,38,129,2.3947368421052633
2431,1,788,26,814,30.307692307692307
2431,2,3184,265,3449,12.015094339622642
2431,3,3485,186,3671,18.736559139784948
2431,4,3695,641,4336,5.764430577223089
2431,5,4364,779,5143,5.602053915275995
2431,6,5170,791,5961,6.5360303413400755
2431,7,5992,22,6014,272.3636363636364
2432,1,20,108,128,0.18518518518518517
2432,2,141,65,206,2.169230769230769
2432,3,314,960,1274,0.32708333333333334
2432,4,1277,691,1968,1.8480463096960926
2433,1,21,355,376,0.059154929577464786
2433,2,390,445,835,0.8764044943820225
2434,1,161,901,1062,0.17869034406215317
2434,2,1069,454,1523,2.354625550660793
2434,3,1560,264,1824,5.909090909090909
2434,4,1847,374,2221,4.938502673796791
2435,1,26,432,458,0.06018518518518518
2435,2,472,430,902,1.0976744186046512
2435,3,915,411,1326,2.2262773722627736
2435,4,1329,390,1719,3.4076923076923076
2436,1,43,329,372,0.13069908814589665
2436,2,380,476,856,0.7983193277310925
2436,3,864,461,1325,1.8741865509761388
2437,1,25,536,561,0.04664179104477612
2437,2,570,481,1051,1.185031185031185
2437,3,1074,365,1439,2.9424657534246577
2437,4,1448,51,1499,28.392156862745097
2437,5,1515,118,1633,12.838983050847459
2437,6,1646,125,1771,13.168
2437,7,1792,145,1937,12.358620689655172
2437,8,1951,195,2146,10.005128205128205
2437,9,2151,149,2300,14.436241610738255
2437,10,2315,150,2465,15.433333333333334
2437,11,2480,182,2662,13.626373626373626
2437,12,2704,198,2902,13.656565656565656
2437,13,2920,210,3130,13.904761904761905
2437,14,3139,238,3377,13.1890756302521
2437,15,3421,217,3638,15.764976958525345
2437,16,3656,377,4033,9.697612732095491
2437,17,4047,463,4510,8.740820734341252
2437,18,4522,268,4790,16.87313432835821
2437,19,4823,219,5042,22.022831050228312
2438,1,87,615,702,0.14146341463414633
2438,2,845,702,1547,1.2037037037037037
2438,3,1581,807,2388,1.9591078066914498
2438,4,2409,499,2908,4.8276553106212425
2438,5,2925,393,3318,7.442748091603053
2438,6,3349,518,3867,6.4652509652509655
2438,7,3890,544,4434,7.150735294117647
2438,8,4453,733,5186,6.075034106412005
2438,9,5208,385,5593,13.527272727272727
2438,10,5624,110,5734,51.127272727272725
2439,1,82,445,527,0.1842696629213483
2439,2,542,339,881,1.59882005899705
2439,3,900,743,1643,1.2113055181695829
2440,1,9,831,840,0.010830324909747292
2440,2,853,465,1318,1.8344086021505377
2440,3,1328,888,2216,1.4954954954954955
2440,4,2229,832,3061,2.6790865384615383
2440,5,3104,983,4087,3.157680569684639
2440,6,4098,802,4900,5.109725685785536
2440,7,4914,978,5892,5.024539877300613
2440,8,5910,668,6578,8.847305389221557
2440,9,6591,684,7275,9.635964912280702
2441,1,95,88,183,1.0795454545454546
2441,2,217,70,287,3.1
2441,3,305,121,426,2.520661157024793
2442,1,218,337,555,0.6468842729970327
2442,2,575,301,876,1.910299003322259
2442,3,882,298,1180,2.959731543624161
2442,4,1201,277,1478,4.335740072202166
2442,5,1483,95,1578,15.610526315789473
2442,6,1591,196,1787,8.11734693877551
2442,7,1855,326,2181,5.690184049079755
2442,8,4341,329,4670,13.19452887537994
2442,9,4672,84,4756,55.61904761904762
2442,10,4769,148,4917,32.222972972972975
2442,11,5028,117,5145,42.97435897435897
2442,12,6329,281,6610,22.523131672597867
2442,13,7072,263,7335,26.88973384030418
2442,14,7372,251,7623,29.37051792828685
2442,15,7742,102,7844,75.90196078431373
2443,1,23,97,120,0.23711340206185566
2443,2,142,78,220,1.8205128205128205
2443,3,238,178,416,1.3370786516853932
2443,4,430,172,602,2.5
2443,5,615,123,738,5.0
2443,6,761,108,869,7.046296296296297
2443,7,911,141,1052,6.460992907801418
2443,8,1099,123,1222,8.934959349593496
2443,9,1241,167,1408,7.431137724550898
2444,1,52,689,741,0.07547169811320754
2445,1,8,43,51,0.18604651162790697
2445,2,60,349,409,0.17191977077363896
2445,3,464,498,962,0.9317269076305221
2445,4,1025,285,1310,3.5964912280701755
2445,5,1335,436,1771,3.061926605504587
2445,6,1788,475,2263,3.7642105263157895
2445,7,2347,513,2860,4.57504873294347
2445,8,2933,428,3361,6.852803738317757
2445,9,3397,464,3861,7.321120689655173
2445,10,3980,456,4436,8.728070175438596
2445,11,4515,596,5111,7.575503355704698
2445,12,5147,196,5343,26.260204081632654
2445,13,5387,262,5649,20.561068702290076
2445,14,5652,29,5681,194.89655172413794
2446,1,311,580,891,0.5362068965517242
2446,2,905,532,1437,1.7011278195488722
2447,1,38,733,771,0.05184174624829468
2447,2,809,568,1377,1.4242957746478873
2447,3,1389,927,2316,1.4983818770226538
2447,4,2331,354,2685,6.584745762711864
2448,1,2354,1001,3355,2.3516483516483517
2448,2,3357,346,3703,9.702312138728324
2449,1,96,408,504,0.23529411764705882
2449,2,525,293,818,1.7918088737201365
2449,3,822,484,1306,1.6983471074380165
2449,4,1312,353,1665,3.71671388101983
2450,1,51,570,621,0.08947368421052632
2451,1,124,943,1067,0.13149522799575822
2451,2,1069,959,2028,1.1147028154327425
2451,3,2039,302,2341,6.751655629139073
2452,1,170,588,758,0.2891156462585034
2452,2,800,367,1167,2.1798365122615806
2453,1,592,102,694,5.803921568627451
2453,2,739,4,743,184.75
2453,3,807,741,1548,1.0890688259109311
2453,4,1561,612,2173,2.5506535947712417
2453,5,2262,894,3156,2.530201342281879
2454,1,34,232,266,0.14655172413793102
2454,2,276,323,599,0.8544891640866873
2454,3,618,311,929,1.9871382636655948
2455,1,4064,55,4119,73.89090909090909
2455,2,4129,617,4746,6.692058346839546
2455,3,4886,503,5389,9.713717693836978
2455,4,5522,440,5962,12.55
2455,5,6013,168,6181,35.791666666666664
2455,6,6204,110,6314,56.4
2455,7,6326,530,6856,11.935849056603773
2455,8,6885,342,7227,20.13157894736842
2455,9,7378,327,7705,22.56269113149847
2455,10,7715,291,8006,26.512027491408936
2456,1,16,811,827,0.01972872996300863
2456,2,878,962,1840,0.9126819126819127
2456,3,1870,746,2616,2.506702412868633
2456,4,2658,746,3404,3.5630026809651474
2457,1,162,748,910,0.21657754010695188
2458,1,111,190,301,0.5842105263157895
2458,2,311,186,497,1.6720430107526882
2458,3,517,136,653,3.801470588235294
2459,1,102,450,552,0.22666666666666666
2459,2,555,472,1027,1.1758474576271187
2459,3,1036,424,1460,2.443396226415094
2459,4,1463,447,1910,3.272930648769575
2459,5,1913,221,2134,8.656108597285067
2460,1,15,997,1012,0.015045135406218655
2460,2,1022,360,1382,2.838888888888889
2460,3,1398,721,2119,1.9389736477115118
2460,4,2251,349,2600,6.4498567335243555
2460,5,2626,512,3138,5.12890625
2460,6,3155,321,3476,9.828660436137072
2460,7,3490,682,4172,5.117302052785924
2460,8,4197,685,4882,6.127007299270073
2460,9,5032,930,5962,5.410752688172043
2460,10,5970,853,6823,6.998827667057444
2460,11,6869,684,7553,10.042397660818713
2461,1,88,293,381,0.3003412969283277
2461,2,391,231,622,1.6926406926406927
2461,3,651,284,935,2.2922535211267605
2461,4,980,306,1286,3.2026143790849675
2461,5,1300,90,1390,14.444444444444445
2461,6,1404,43,1447,32.651162790697676
2461,7,1471,61,1532,24.114754098360656
2461,8,1537,37,1574,41.54054054054054
2462,1,1435,21,1456,68.33333333333333
2462,2,1476,448,1924,3.294642857142857
2462,3,1927,409,2336,4.711491442542787
2462,4,2337,328,2665,7.125
2462,5,2668,361,3029,7.390581717451523
2462,6,3032,319,3351,9.504702194357368
2462,7,3354,318,3672,10.547169811320755
2462,8,3675,355,4030,10.352112676056338
2462,9,4033,317,4350,12.722397476340694
2462,10,4353,313,4666,13.907348242811501
2462,11,4669,232,4901,20.125
2462,12,4904,358,5262,13.69832402234637
2462,13,5265,359,5624,14.665738161559888
2462,14,5627,365,5992,15.416438356164383
2462,15,5995,333,6328,18.003003003003002
2462,16,6331,312,6643,20.291666666666668
2462,17,6646,299,6945,22.22742474916388
2462,18,6948,349,7297,19.908309455587393
2462,19,7300,400,7700,18.25
2462,20,7703,335,8038,22.99402985074627
2463,1,82,396,478,0.20707070707070707
2464,1,60,508,568,0.11811023622047244
2465,1,87,382,469,0.22774869109947643
2465,2,472,752,1224,0.6276595744680851
2465,3,1315,791,2106,1.6624525916561315
2465,4,2117,867,2984,2.4417531718569783
2465,5,3089,935,4024,3.3037433155080214
2465,6,4027,456,4483,8.831140350877194
2465,7,4500,975,5475,4.615384615384615
2465,8,5486,460,5946,11.92608695652174
2465,9,5961,453,6414,13.158940397350994
2465,10,6426,359,6785,17.899721448467968
2465,11,6796,480,7276,14.158333333333333
2465,12,7296,258,7554,28.27906976744186
2465,13,7574,266,7840,28.473684210526315
2466,1,277,431,708,0.642691415313225
2466,2,715,479,1194,1.4926931106471817
2466,3,1197,438,1635,2.732876712328767
2467,1,7,122,129,0.05737704918032787
2467,2,277,555,832,0.4990990990990991
2468,1,28,618,646,0.045307443365695796
2468,2,655,463,1118,1.4146868250539957
2468,3,1129,439,1568,2.571753986332574
2468,4,1600,455,2055,3.5164835164835164
2469,1,218,891,1109,0.244668911335578
2469,2,1139,285,1424,3.9964912280701754
2470,1,148,150,298,0.9866666666666667
2470,2,1761,451,2212,3.9046563192904657
2470,3,2266,262,2528,8.648854961832061
2470,4,7496,434,7930,17.27188940092166
2471,1,85,66,151,1.2878787878787878
2471,2,176,627,803,0.2807017543859649
2471,3,881,409,1290,2.154034229828851
2471,4,1354,331,1685,4.090634441087613
2471,5,1755,166,1921,10.572289156626505
2471,6,1999,619,2618,3.2294022617124396
2471,7,2672,288,2960,9.277777777777779
2471,8,3018,400,3418,7.545
2471,9,3492,365,3857,9.567123287671233
2472,1,833,3,836,277.6666666666667
2473,1,38,480,518,0.07916666666666666
2474,1,55,404,459,0.13613861386138615
2474,2,469,371,840,1.2641509433962264
2474,3,854,435,1289,1.9632183908045977
2474,4,1301,414,1715,3.142512077294686
2474,5,1732,289,2021,5.993079584775087
2474,6,2032,361,2393,5.628808864265928
2474,7,2412,235,2647,10.263829787234043
2474,8,2665,478,3143,5.575313807531381
2474,9,3156,290,3446,10.882758620689655
2474,10,3470,414,3884,8.381642512077295
2475,1,28,625,653,0.0448
2475,2,691,438,1129,1.5776255707762556
2476,1,16,452,468,0.035398230088495575
2477,1,30,917,947,0.03271537622682661
2478,1,248,498,746,0.4979919678714859
2479,1,296,500,796,0.592
2479,2,3885,735,4620,5.285714285714286
2479,3,4632,207,4839,22.3768115942029
2479,4,4856,301,5157,16.132890365448507
2479,5,5287,664,5951,7.962349397590361
2479,6,6832,867,7699,7.880046136101499
2480,1,88,707,795,0.12446958981612447
2480,2,846,774,1620,1.0930232558139534
2481,1,173,995,1168,0.17386934673366833
2481,2,1209,511,1720,2.3659491193737767
2481,3,1743,137,1880,12.722627737226277
2481,4,1962,1000,2962,1.962
2481,5,4113,66,4179,62.31818181818182
2481,6,4250,946,5196,4.4926004228329806
2481,7,5252,220,5472,23.87272727272727
2481,8,5511,510,6021,10.805882352941177
2481,9,6081,365,6446,16.660273972602738
2481,10,6477,359,6836,18.041782729805014
2481,11,6874,691,7565,9.947901591895803
2481,12,7587,309,7896,24.553398058252426
2482,1,103,451,554,0.22838137472283815
2482,2,561,276,837,2.032608695652174
2482,3,845,133,978,6.353383458646617
2482,4,998,362,1360,2.7569060773480665
2483,1,286,515,801,0.5553398058252427
2483,2,863,459,1322,1.8801742919389979
2483,3,1386,700,2086,1.98
2483,4,2107,203,2310,10.379310344827585
2483,5,2346,636,2982,3.688679245283019
2483,6,3029,241,3270,12.568464730290456
2483,7,3513,295,3808,11.908474576271187
2483,8,4001,342,4343,11.698830409356725
2483,9,4536,1015,5551,4.468965517241379
2483,10,5631,279,5910,20.182795698924732
2483,11,5961,293,6254,20.344709897610922
2483,12,6594,1061,7655,6.214891611687087
2484,1,1086,648,1734,1.6759259259259258
2485,1,49,435,484,0.11264367816091954
2485,2,523,61,584,8.573770491803279
2485,3,633,488,1121,1.2971311475409837
2485,4,1680,57,1737,29.473684210526315
2485,5,1783,465,2248,3.8344086021505377
2485,6,2524,240,2764,10.516666666666667
2485,7,2773,47,2820,59.0
2486,1,43,70,113,0.6142857142857143
2487,1,29,292,321,0.09931506849315068
2487,2,526,81,607,6.493827160493828
2487,3,708,512,1220,1.3828125
2487,4,1276,606,1882,2.1056105610561056
2487,5,1913,620,2533,3.085483870967742
2487,6,2574,641,3215,4.015600624024961
2488,1,15,541,556,0.027726432532347505
2488,2,574,635,1209,0.9039370078740158
2488,3,1242,615,1857,2.0195121951219512
2488,4,1877,634,2511,2.9605678233438484
2488,5,2593,717,3310,3.616457461645746
2488,6,3482,731,4213,4.763337893296853
2489,1,54,386,440,0.13989637305699482
2490,1,55,730,785,0.07534246575342465
2491,1,73,747,820,0.09772423025435073
2491,2,847,486,1333,1.742798353909465
2491,3,1360,637,1997,2.135007849293564
2491,4,2041,628,2669,3.25
2492,1,8,455,463,0.017582417582417582
2492,2,479,630,1109,0.7603174603174603
2492,3,1126,627,1753,1.79585326953748
2493,1,98,598,696,0.16387959866220736
2494,1,242,64,306,3.78125
2494,2,2262,556,2818,4.068345323741007
2494,3,2855,433,3288,6.593533487297922
2494,4,3300,340,3640,9.705882352941176
2495,1,33,627,660,0.05263157894736842
2495,2,718,890,1608,0.8067415730337079
2495,3,1634,729,2363,2.241426611796982
2495,4,2380,667,3047,3.568215892053973
2495,5,3065,712,3777,4.304775280898877
2495,6,3797,52,3849,73.01923076923077
2496,1,114,811,925,0.1405672009864365
2496,2,970,706,1676,1.3739376770538243
2497,1,107,331,438,0.32326283987915405
2497,2,453,293,746,1.546075085324232
2497,3,799,316,1115,2.528481012658228
2498,1,104,433,537,0.24018475750577367
2498,2,541,211,752,2.5639810426540284
2499,1,42,915,957,0.04590163934426229
2499,2,960,504,1464,1.9047619047619047
2499,3,1631,869,2500,1.8768699654775605
2499,4,2521,731,3252,3.4487004103967167
2499,5,3292,542,3834,6.07380073800738
2499,6,3880,503,4383,7.713717693836978
2499,7,4437,531,4968,8.35593220338983
2500,1,19,1265,1284,0.015019762845849802
2500,2,1409,1654,3063,0.8518742442563483
2501,1,2050,321,2371,6.386292834890965
2502,1,65,770,835,0.08441558441558442
2503,1,155,53,208,2.9245283018867925
2503,2,382,852,1234,0.44835680751173707
2503,3,1247,780,2027,1.5987179487179488
2504,1,165,807,972,0.20446096654275092
2505,1,15,534,549,0.028089887640449437
2505,2,560,662,1222,0.8459214501510574
2505,3,2240,881,3121,2.542565266742338
2505,4,3123,127,3250,24.590551181102363
2505,5,3257,663,3920,4.912518853695325
2505,6,4353,498,4851,8.740963855421686
2505,7,6753,614,7367,10.998371335504887
2506,1,27,436,463,0.06192660550458716
2506,2,494,473,967,1.0443974630021142
2507,1,8,132,140,0.06060606060606061
2507,2,170,145,315,1.1724137931034482
2507,3,333,226,559,1.4734513274336283
2508,1,38,2,40,19.0
2508,2,165,500,665,0.33
2509,1,13,445,458,0.029213483146067417
2509,2,480,212,692,2.2641509433962264
2510,1,63,84,147,0.75
2510,2,159,73,232,2.1780821917808217
2510,3,246,200,446,1.23
2510,4,461,156,617,2.9551282051282053
2510,5,679,58,737,11.706896551724139
2510,6,766,126,892,6.079365079365079
2511,1,69,67,136,1.0298507462686568
2511,2,1348,721,2069,1.869625520110957
2511,3,2215,855,3070,2.590643274853801
2511,4,3229,881,4110,3.6651532349602722
2511,5,4119,701,4820,5.875891583452211
2511,6,4995,996,5991,5.015060240963855
2511,7,6011,753,6764,7.98273572377158
2511,8,6786,502,7288,13.51792828685259
2511,9,7300,597,7897,12.22780569514238
2512,1,100,101,201,0.9900990099009901
2512,2,1313,520,1833,2.525
2512,3,1943,509,2452,3.817288801571709
2512,4,2648,534,3182,4.9588014981273405
2512,5,3287,521,3808,6.309021113243762
2512,6,3901,394,4295,9.901015228426395
2512,7,4400,343,4743,12.82798833819242
2512,8,4800,290,5090,16.551724137931036
2512,9,5187,179,5366,28.977653631284916
2512,10,5405,305,5710,17.721311475409838
2513,1,61,353,414,0.17280453257790368
2513,2,416,417,833,0.9976019184652278
2513,3,835,418,1253,1.9976076555023923
2513,4,1255,383,1638,3.2767624020887727
2513,5,1640,419,2059,3.9140811455847255
2513,6,2061,369,2430,5.585365853658536
2513,7,2432,222,2654,10.954954954954955
2514,1,1441,45,1486,32.022222222222226
2514,2,1501,60,1561,25.016666666666666
2515,1,515,1298,1813,0.3967642526964561
2515,2,2015,1129,3144,1.7847652790079716
2515,3,3310,968,4278,3.419421487603306
2515,4,4513,1141,5654,3.955302366345311
2516,1,712,498,1210,1.429718875502008
2516,2,1218,53,1271,22.9811320754717
2517,1,99,14,113,7.071428571428571
2517,2,1144,702,1846,1.6296296296296295
2518,1,536,215,751,2.4930232558139536
2518,2,1349,400,1749,3.3725
2518,3,1778,315,2093,5.644444444444445
2518,4,2107,300,2407,7.023333333333333
2519,1,59,521,580,0.11324376199616124
2520,1,8,41,49,0.1951219512195122
2520,2,446,592,1038,0.7533783783783784
2520,3,1067,600,1667,1.7783333333333333
2520,4,1688,786,2474,2.1475826972010177
2521,1,42,719,761,0.0584144645340751
2521,2,836,423,1259,1.9763593380614657
2521,3,1273,421,1694,3.02375296912114
2521,4,1708,389,2097,4.390745501285347
2522,1,10,35,45,0.2857142857142857
2522,2,187,802,989,0.23316708229426433
2522,3,991,218,1209,4.545871559633028
2522,4,1240,124,1364,10.0
2523,1,199,1100,1299,0.1809090909090909
2523,2,3530,617,4147,5.721231766612642
2523,3,4171,566,4737,7.369257950530035
2523,4,4819,1040,5859,4.633653846153846
2523,5,5988,496,6484,12.07258064516129
2523,6,6552,233,6785,28.120171673819744
2523,7,6903,338,7241,20.423076923076923
2523,8,7289,458,7747,15.914847161572052
2524,1,61,784,845,0.0778061224489796
2524,2,848,65,913,13.046153846153846
2524,3,1290,544,1834,2.3713235294117645
2524,4,1879,336,2215,5.592261904761905
2524,5,2266,396,2662,5.722222222222222
2524,6,2713,337,3050,8.050445103857566
2524,7,3091,387,3478,7.987080103359173
2524,8,4147,611,4758,6.787234042553192
2524,9,4809,391,5200,12.29923273657289
2525,1,150,780,930,0.19230769230769232
2525,2,981,624,1605,1.5721153846153846
2525,3,1621,693,2314,2.339105339105339
2525,4,2341,448,2789,5.225446428571429
2525,5,2847,670,3517,4.249253731343283
2525,6,3545,177,3722,20.028248587570623
2525,7,3758,151,3909,24.887417218543046
2525,8,3921,64,3985,61.265625
2525,9,4025,412,4437,9.769417475728156
2526,1,24,427,451,0.05620608899297424
2526,2,456,427,883,1.0679156908665106
2526,3,888,763,1651,1.163826998689384
2527,1,984,197,1181,4.99492385786802
2527,2,1857,262,2119,7.087786259541985
2527,3,3309,256,3565,12.92578125
2527,4,3628,187,3815,19.40106951871658
2528,1,33,584,617,0.05650684931506849
2528,2,628,286,914,2.195804195804196
2529,1,31,792,823,0.039141414141414144
2529,2,906,408,1314,2.2205882352941178
2529,3,1626,295,1921,5.511864406779661
2529,4,1935,596,2531,3.2466442953020134
2529,5,2840,381,3221,7.454068241469816
2529,6,3250,546,3796,5.9523809523809526
2529,7,4238,486,4724,8.720164609053498
2529,8,4793,297,5090,16.13804713804714
2529,9,5367,305,5672,17.59672131147541
2529,10,6065,405,6470,14.975308641975309
2530,1,27,709,736,0.0380818053596615
2530,2,757,821,1578,0.9220462850182704
2530,3,1603,424,2027,3.7806603773584904
2530,4,2070,965,3035,2.145077720207254
2531,1,262,104,366,2.519230769230769
2531,2,994,124,1118,8.016129032258064
2531,3,1124,164,1288,6.853658536585366
2531,4,1294,447,1741,2.894854586129754
2531,5,1747,489,2236,3.572597137014315
2531,6,2242,761,3003,2.946123521681997
2531,7,3009,750,3759,4.012
2531,8,3765,397,4162,9.483627204030226
2531,9,4168,674,4842,6.183976261127596
2531,10,4848,719,5567,6.742698191933241
2531,11,5573,215,5788,25.92093023255814
2532,1,142,875,1017,0.16228571428571428
2533,1,40,419,459,0.0954653937947494
2533,2,506,933,1439,0.5423365487674169
2533,3,1441,782,2223,1.8427109974424551
2534,1,34,843,877,0.04033214709371293
2534,2,1039,642,1681,1.618380062305296
2534,3,1732,790,2522,2.1924050632911394
2534,4,2565,860,3425,2.9825581395348837
2534,5,3465,907,4372,3.820286659316428
2534,6,4380,935,5315,4.684491978609626
2534,7,5577,930,6507,5.996774193548387
2534,8,6571,943,7514,6.968186638388123
2535,1,47,177,224,0.2655367231638418
2536,1,64,1248,1312,0.05128205128205128
2537,1,58,673,731,0.0861812778603269
2537,2,779,390,1169,1.9974358974358974
2537,3,1192,731,1923,1.6306429548563612
2537,4,1930,917,2847,2.104689203925845
2538,1,27,1059,1086,0.025495750708215296
2538,2,1111,1052,2163,1.056083650190114
2538,3,2174,571,2745,3.807355516637478
2538,4,2772,1086,3858,2.552486187845304
2538,5,3866,837,4703,4.618876941457587
2539,1,53,944,997,0.05614406779661017
2539,2,1016,223,1239,4.556053811659193
2539,3,1295,583,1878,2.221269296740995
2539,4,1911,1017,2928,1.87905604719764
2539,5,2969,1047,4016,2.835721107927412
2539,6,4033,667,4700,6.04647676161919
2539,7,4743,1039,5782,4.564966313763234
2539,8,5845,1022,6867,5.719178082191781
2539,9,6915,1011,7926,6.839762611275964
2540,1,22,921,943,0.023887079261672096
2540,2,980,830,1810,1.180722891566265
2540,3,1842,681,2523,2.7048458149779737
2540,4,2597,518,3115,5.013513513513513
2540,5,3149,758,3907,4.154353562005277
2540,6,3935,762,4697,5.164041994750656
2540,7,4739,584,5323,8.11472602739726
2540,8,5881,630,6511,9.334920634920636
2540,9,6539,606,7145,10.790429042904291
2540,10,7200,604,7804,11.920529801324504
2541,1,207,876,1083,0.2363013698630137
2541,2,1090,449,1539,2.4276169265033407
2542,1,10,485,495,0.020618556701030927
2542,2,521,853,1374,0.6107854630715123
2542,3,1404,852,2256,1.647887323943662
2542,4,2264,477,2741,4.746331236897275
2542,5,2762,549,3311,5.030965391621129
2542,6,3351,704,4055,4.759943181818182
2542,7,4144,338,4482,12.2603550295858
2542,8,4598,874,5472,5.260869565217392
2542,9,5480,347,5827,15.792507204610951
2542,10,5854,902,6756,6.490022172949002
2542,11,6779,796,7575,8.516331658291458
2543,1,388,316,704,1.2278481012658229
2543,2,707,350,1057,2.02
2543,3,1059,286,1345,3.702797202797203
2543,4,1375,335,1710,4.104477611940299
2543,5,1721,187,1908,9.203208556149733
2544,1,262,122,384,2.1475409836065573
2544,2,943,68,1011,13.867647058823529
2544,3,1017,166,1183,6.126506024096385
2544,4,1189,234,1423,5.081196581196581
2544,5,1429,622,2051,2.297427652733119
2544,6,2057,745,2802,2.7610738255033556
2544,7,2808,546,3354,5.142857142857143
2544,8,3360,792,4152,4.242424242424242
2544,9,4158,517,4675,8.042553191489361
2544,10,4681,690,5371,6.784057971014493
2544,11,5377,612,5989,8.7859477124183
2544,12,5995,914,6909,6.559080962800875
2544,13,6915,247,7162,27.995951417004047
2545,1,31,334,365,0.09281437125748503
2545,2,391,126,517,3.1031746031746033
2545,3,670,191,861,3.507853403141361
2545,4,908,252,1160,3.6031746031746033
2545,5,1276,72,1348,17.72222222222222
2545,6,1385,475,1860,2.9157894736842107
2545,7,1874,193,2067,9.709844559585493
2545,8,2085,175,2260,11.914285714285715
2546,1,193,8,201,24.125
2546,2,224,94,318,2.382978723404255
2546,3,1852,213,2065,8.694835680751174
2546,4,2154,578,2732,3.726643598615917
2547,1,135,657,792,0.2054794520547945
2547,2,813,334,1147,2.434131736526946
2547,3,1185,533,1718,2.223264540337711
2548,1,347,962,1309,0.3607068607068607
2548,2,1635,906,2541,1.804635761589404
2549,1,629,760,1389,0.8276315789473684
2549,2,1846,429,2275,4.303030303030303
2550,1,4,626,630,0.006389776357827476
2550,2,1134,448,1582,2.53125
2550,3,1610,575,2185,2.8
2551,1,35,2353,2388,0.014874628134296642
2551,2,2442,2676,5118,0.9125560538116592
2551,3,5262,2814,8076,1.8699360341151385
2552,1,35,824,859,0.04247572815533981
2552,2,888,872,1760,1.018348623853211
2552,3,1775,870,2645,2.0402298850574714
2552,4,2675,981,3656,2.726809378185525
2552,5,3664,474,4138,7.729957805907173
2552,6,4173,854,5027,4.886416861826698
2553,1,10,599,609,0.01669449081803005
2553,2,640,926,1566,0.6911447084233261
2553,3,1613,760,2373,2.1223684210526317
2553,4,2428,1172,3600,2.0716723549488054
2553,5,3623,628,4251,5.769108280254777
2553,6,4283,183,4466,23.404371584699454
2553,7,4527,527,5054,8.590132827324478
2553,8,5106,517,5623,9.876208897485494
2553,9,5713,290,6003,19.7
2553,10,6023,571,6594,10.54816112084063
2553,11,6620,658,7278,10.060790273556231
2554,1,532,646,1178,0.8235294117647058
2555,1,18,702,720,0.02564102564102564
2556,1,898,249,1147,3.606425702811245
2556,2,1154,269,1423,4.289962825278811
2556,3,2029,300,2329,6.763333333333334
2556,4,2335,326,2661,7.162576687116564
2556,5,2969,314,3283,9.455414012738853
2556,6,3292,109,3401,30.201834862385322
2556,7,3437,516,3953,6.660852713178294
2556,8,5448,750,6198,7.264
2556,9,6209,746,6955,8.323056300268096
2556,10,6980,36,7016,193.88888888888889
2556,11,7193,127,7320,56.63779527559055
2556,12,7412,97,7509,76.41237113402062
2557,1,21,153,174,0.13725490196078433
2557,2,227,48,275,4.729166666666667
2557,3,342,62,404,5.516129032258065
2557,4,416,59,475,7.0508474576271185
2557,5,504,49,553,10.285714285714286
2557,6,559,27,586,20.703703703703702
2557,7,589,37,626,15.91891891891892
2557,8,642,26,668,24.692307692307693
2557,9,680,117,797,5.811965811965812
2557,10,832,49,881,16.979591836734695
2557,11,892,37,929,24.10810810810811
2557,12,953,32,985,29.78125
2557,13,993,31,1024,32.03225806451613
2557,14,1034,42,1076,24.61904761904762
2557,15,1086,208,1294,5.221153846153846
2558,1,83,528,611,0.1571969696969697
2558,2,622,900,1522,0.6911111111111111
2558,3,1535,188,1723,8.164893617021276
2558,4,1756,557,2313,3.1526032315978454
2558,5,2320,614,2934,3.778501628664495
2558,6,2942,422,3364,6.971563981042654
2559,1,29,644,673,0.04503105590062112
2559,2,691,595,1286,1.1613445378151261
2559,3,1319,659,1978,2.001517450682853
2560,1,134,1272,1406,0.10534591194968554
2560,2,1419,1260,2679,1.1261904761904762
2560,3,2691,1225,3916,2.196734693877551
2560,4,4035,1208,5243,3.3402317880794703
2560,5,5255,294,5549,17.874149659863946
2561,1,231,98,329,2.357142857142857
2561,2,496,903,1399,0.5492801771871539
2561,3,1618,940,2558,1.721276595744681
2562,1,31,582,613,0.05326460481099656
2563,1,20,379,399,0.052770448548812667
2563,2,420,665,1085,0.631578947368421
2563,3,1139,1338,2477,0.851270553064275
2563,4,2533,1094,3627,2.3153564899451555
2563,5,3686,865,4551,4.261271676300578
2563,6,4625,1132,5757,4.0856890459363955
2563,7,5799,909,6708,6.37953795379538
2564,1,10,41,51,0.24390243902439024
2564,2,64,37,101,1.7297297297297298
2564,3,522,47,569,11.106382978723405
2564,4,1115,226,1341,4.933628318584071
2564,5,3398,243,3641,13.983539094650206
2564,6,5634,66,5700,85.36363636363636
2564,7,6400,162,6562,39.50617283950617
2564,8,7798,96,7894,81.22916666666667
2565,1,56,687,743,0.08151382823871907
2566,1,42,439,481,0.09567198177676538
2567,1,511,353,864,1.4475920679886685
2568,1,257,148,405,1.7364864864864864
2569,1,11,262,273,0.04198473282442748
2569,2,280,155,435,1.8064516129032258
2569,3,442,243,685,1.8189300411522633
2569,4,692,201,893,3.442786069651741
2569,5,911,154,1065,5.915584415584416
2569,6,1072,300,1372,3.5733333333333333
2569,7,1379,285,1664,4.838596491228071
2569,8,1671,271,1942,6.166051660516605
2570,1,23,578,601,0.039792387543252594
2571,1,140,354,494,0.3954802259887006
2571,2,505,221,726,2.2850678733031673
2571,3,761,21,782,36.23809523809524
2571,4,802,300,1102,2.6733333333333333
2571,5,1140,775,1915,1.4709677419354839
2572,1,212,156,368,1.358974358974359
2573,1,369,148,517,2.4932432432432434
2573,2,550,67,617,8.208955223880597
2573,3,1369,365,1734,3.750684931506849
2573,4,1753,70,1823,25.042857142857144
2573,5,1831,45,1876,40.68888888888889
2573,6,1890,415,2305,4.554216867469879
2573,7,2468,85,2553,29.03529411764706
2573,8,2569,305,2874,8.422950819672131
2573,9,2971,302,3273,9.83774834437086
2573,10,3302,148,3450,22.31081081081081
2573,11,3484,50,3534,69.68
2573,12,3553,56,3609,63.44642857142857
2573,13,3860,336,4196,11.488095238095237
2573,14,4237,184,4421,23.027173913043477
2573,15,4462,248,4710,17.991935483870968
2573,16,4752,106,4858,44.83018867924528
2573,17,4897,417,5314,11.743405275779377
2573,18,5361,169,5530,31.72189349112426
2573,19,5555,77,5632,72.14285714285714
2573,20,5699,84,5783,67.8452380952381
2573,21,6570,133,6703,49.3984962406015
2573,22,6720,113,6833,59.469026548672566
2573,23,6848,93,6941,73.63440860215054
2573,24,6946,58,7004,119.75862068965517
2573,25,7019,62,7081,113.20967741935483
2573,26,7665,119,7784,64.41176470588235
2574,1,85,66,151,1.2878787878787878
2574,2,176,627,803,0.2807017543859649
2574,3,881,409,1290,2.154034229828851
2574,4,1354,331,1685,4.090634441087613
2574,5,1755,166,1921,10.572289156626505
2574,6,1999,619,2618,3.2294022617124396
2574,7,2672,288,2960,9.277777777777779
2574,8,3018,400,3418,7.545
2575,1,96,170,266,0.5647058823529412
2575,2,297,412,709,0.720873786407767
2575,3,720,60,780,12.0
2576,1,1072,544,1616,1.9705882352941178
2576,2,1683,542,2225,3.1051660516605164
2577,1,24,446,470,0.053811659192825115
2577,2,498,263,761,1.8935361216730038
2577,3,875,618,1493,1.4158576051779934
2577,4,1636,626,2262,2.6134185303514377
2577,5,2356,71,2427,33.183098591549296
2577,6,3436,208,3644,16.51923076923077
2577,7,3682,421,4103,8.7458432304038
2577,8,4173,145,4318,28.779310344827586
2578,1,315,550,865,0.5727272727272728
2578,2,884,586,1470,1.5085324232081911
2578,3,1516,481,1997,3.1517671517671517
2578,4,2030,531,2561,3.822975517890772
2578,5,2573,998,3571,2.5781563126252505
2579,1,49,108,157,0.4537037037037037
2579,2,165,105,270,1.5714285714285714
2579,3,279,107,386,2.607476635514019
2579,4,418,135,553,3.096296296296296
2579,5,575,89,664,6.46067415730337
2579,6,712,119,831,5.983193277310924
2579,7,878,79,957,11.113924050632912
2580,1,50,361,411,0.13850415512465375
2581,1,41,468,509,0.0876068376068376
2581,2,533,197,730,2.7055837563451774
2581,3,749,115,864,6.51304347826087
2581,4,880,240,1120,3.6666666666666665
2582,1,421,397,818,1.0604534005037782
2582,2,829,326,1155,2.542944785276074
2582,3,1166,332,1498,3.5120481927710845
2583,1,68,544,612,0.125
2584,1,1247,882,2129,1.4138321995464853
2584,2,3306,933,4239,3.5434083601286175
2585,1,147,430,577,0.34186046511627904
2586,1,26,535,561,0.048598130841121495
2586,2,592,556,1148,1.064748201438849
2586,3,1182,535,1717,2.209345794392523
2586,4,1737,93,1830,18.677419354838708
2586,5,1846,87,1933,21.2183908045977
2586,6,1939,192,2131,10.098958333333334
2586,7,2158,365,2523,5.912328767123288
2586,8,2562,209,2771,12.258373205741627
2586,9,2809,284,3093,9.890845070422536
2586,10,3100,261,3361,11.877394636015326
2586,11,3385,306,3691,11.062091503267974
2587,1,17,405,422,0.04197530864197531
2587,2,436,422,858,1.033175355450237
2587,3,882,424,1306,2.080188679245283
2587,4,1318,334,1652,3.946107784431138
2587,5,1735,412,2147,4.211165048543689
2587,6,2203,362,2565,6.085635359116022
2587,7,2591,378,2969,6.854497354497354
2587,8,2992,375,3367,7.978666666666666
2587,9,3421,405,3826,8.446913580246914
2587,10,3835,592,4427,6.47804054054054
2587,11,4467,543,5010,8.226519337016574
2587,12,5027,512,5539,9.818359375
2587,13,5585,536,6121,10.419776119402986
2587,14,6155,496,6651,12.409274193548388
2587,15,6685,529,7214,12.637051039697543
2587,16,7274,472,7746,15.411016949152541
2588,1,991,423,1414,2.342789598108747
2588,2,1431,66,1497,21.681818181818183
2588,3,1511,88,1599,17.170454545454547
2589,1,61,906,967,0.0673289183222958
2589,2,1003,116,1119,8.64655172413793
2589,3,1163,402,1565,2.8930348258706466
2590,1,54,730,784,0.07397260273972603
2591,1,94,364,458,0.25824175824175827
2591,2,464,50,514,9.28
2592,1,85,375,460,0.22666666666666666
2593,1,24,227,251,0.10572687224669604
2594,1,1640,938,2578,1.748400852878465
2594,2,2592,574,3166,4.515679442508711
2594,3,4295,983,5278,4.369277721261445
2594,4,5291,330,5621,16.033333333333335
2594,5,6784,667,7451,10.170914542728635
2595,1,152,291,443,0.5223367697594502
2595,2,599,454,1053,1.3193832599118942
2595,3,1216,122,1338,9.967213114754099
2595,4,1503,93,1596,16.161290322580644
2595,5,1758,45,1803,39.06666666666667
2595,6,1967,454,2421,4.332599118942731
2595,7,2596,587,3183,4.4224872231686545
2595,8,3380,528,3908,6.401515151515151
2595,9,4109,596,4705,6.894295302013423
2595,10,4913,596,5509,8.243288590604028
2595,11,5719,396,6115,14.441919191919192
2595,12,6145,929,7074,6.614639397201292
2595,13,7103,580,7683,12.24655172413793
2596,1,1850,517,2367,3.5783365570599615
2597,1,750,257,1007,2.9182879377431905
2598,1,284,590,874,0.48135593220338985
2598,3,876,66,942,13.272727272727273
2598,4,1017,316,1333,3.2183544303797467
2598,5,1343,265,1608,5.067924528301887
2598,6,1616,276,1892,5.855072463768116
2598,7,1992,340,2332,5.858823529411764
2598,8,2349,522,2871,4.5
2598,9,2972,567,3539,5.241622574955908
2598,10,3561,229,3790,15.550218340611353
2598,11,3829,334,4163,11.464071856287426
2598,84,4170,271,4441,15.387453874538746
2598,86,4482,247,4729,18.14574898785425
2598,87,4736,300,5036,15.786666666666667
2598,88,5051,516,5567,9.78875968992248
2599,1,211,868,1079,0.24308755760368664
2600,1,143,957,1100,0.14942528735632185
2600,2,1102,545,1647,2.022018348623853
2601,1,29,777,806,0.03732303732303732
2602,1,35,816,851,0.0428921568627451
2603,1,26,37,63,0.7027027027027027
2603,2,605,482,1087,1.2551867219917012
2603,3,1091,246,1337,4.434959349593496
2603,4,1347,323,1670,4.170278637770898
2603,5,1689,447,2136,3.778523489932886
2603,6,2158,266,2424,8.112781954887218
2603,7,2456,423,2879,5.806146572104019
2603,8,2890,211,3101,13.696682464454977
2603,9,3109,451,3560,6.893569844789357
2603,10,3588,351,3939,10.222222222222221
2603,11,3943,104,4047,37.91346153846154
2603,12,4096,346,4442,11.83815028901734
2603,13,4464,244,4708,18.295081967213115
2603,14,4727,200,4927,23.635
2603,15,4945,285,5230,17.350877192982455
2603,16,5260,518,5778,10.154440154440154
2603,17,5807,447,6254,12.991051454138702
2603,18,6263,487,6750,12.860369609856264
2603,19,6782,45,6827,150.7111111111111
2603,20,7274,4,7278,1818.5
2604,1,42,737,779,0.05698778833107191
2604,2,788,798,1586,0.9874686716791979
2604,3,1609,485,2094,3.3175257731958765
2605,1,23,56,79,0.4107142857142857
2605,2,98,538,636,0.1821561338289963
2606,1,827,85,912,9.729411764705882
2606,2,1545,124,1669,12.459677419354838
2606,3,1880,124,2004,15.161290322580646
2606,4,2121,145,2266,14.627586206896552
2606,5,3085,129,3214,23.914728682170544
2607,1,169,716,885,0.2360335195530726
2608,1,18,742,760,0.02425876010781671
2608,2,820,456,1276,1.7982456140350878
2608,3,1290,528,1818,2.4431818181818183
2608,4,1832,728,2560,2.5164835164835164
2608,5,2586,616,3202,4.1980519480519485
2608,6,3230,612,3842,5.277777777777778
2609,1,22,816,838,0.02696078431372549
2610,1,68,725,793,0.09379310344827586
2610,2,812,775,1587,1.047741935483871
2610,3,1615,405,2020,3.9876543209876543
2611,1,1131,473,1604,2.3911205073995774
2611,2,1611,437,2048,3.6864988558352403
2611,3,2050,177,2227,11.581920903954803
2611,4,2863,403,3266,7.104218362282879
2611,5,3273,236,3509,13.86864406779661
2611,6,4039,421,4460,9.593824228028504
2612,1,25,31,56,0.8064516129032258
2612,2,140,56,196,2.5
2612,3,202,61,263,3.3114754098360657
2612,4,277,85,362,3.2588235294117647
2612,5,385,230,615,1.673913043478261
2612,6,640,243,883,2.633744855967078
2612,7,908,204,1112,4.450980392156863
2613,1,321,499,820,0.6432865731462926
2613,2,823,573,1396,1.4363001745200699
2614,1,190,529,719,0.3591682419659735
2615,1,10,829,839,0.012062726176115802
2615,2,876,676,1552,1.2958579881656804
2615,3,1560,980,2540,1.5918367346938775
2615,4,2632,343,2975,7.673469387755102
2615,5,3011,541,3552,5.565619223659889
2615,6,3569,982,4551,3.634419551934827
2615,7,4560,614,5174,7.4267100977198695
2615,8,5205,959,6164,5.427528675703858
2615,9,6189,831,7020,7.447653429602888
2615,10,7040,809,7849,8.702101359703338
2616,1,214,10,224,21.4
2616,2,276,254,530,1.0866141732283465
2616,3,582,159,741,3.660377358490566
2616,4,794,251,1045,3.1633466135458166
2616,5,1059,373,1432,2.839142091152815
2616,6,1486,442,1928,3.3619909502262444
2616,7,1959,290,2249,6.755172413793104
2616,8,2260,326,2586,6.932515337423313
2616,9,2616,410,3026,6.380487804878049
2616,10,3060,153,3213,20.0
2616,11,3240,451,3691,7.184035476718403
2616,12,3739,80,3819,46.7375
2616,13,3857,25,3882,154.28
2616,14,3914,57,3971,68.66666666666667
2616,15,4052,112,4164,36.17857142857143
2616,16,4210,147,4357,28.639455782312925
2616,17,4367,72,4439,60.65277777777778
2616,18,4493,159,4652,28.257861635220127
2616,19,4740,130,4870,36.46153846153846
2616,20,4878,76,4954,64.1842105263158
2616,21,4993,201,5194,24.8407960199005
2616,22,5263,418,5681,12.590909090909092
2616,23,5721,268,5989,21.347014925373134
2616,24,6019,357,6376,16.859943977591037
2616,25,6396,412,6808,15.524271844660195
2616,26,6840,511,7351,13.385518590998043
2617,1,29,539,568,0.05380333951762523
2617,2,645,713,1358,0.9046283309957924
2617,3,1374,633,2007,2.170616113744076
2617,4,2034,730,2764,2.786301369863014
2617,5,2791,474,3265,5.8881856540084385
2617,6,3343,588,3931,5.6853741496598635
2617,7,4017,625,4642,6.4272
2617,8,4732,111,4843,42.630630630630634
2617,9,4903,853,5756,5.7479484173505275
2617,10,5774,1027,6801,5.622200584225901
2617,11,7074,864,7938,8.1875
2618,1,27,660,687,0.04090909090909091
2619,1,32,603,635,0.05306799336650083
2619,2,645,461,1106,1.3991323210412148
2619,3,1149,559,1708,2.0554561717352415
2619,4,1752,392,2144,4.469387755102041
2620,1,120,156,276,0.7692307692307693
2620,2,284,124,408,2.2903225806451615
2621,1,27,853,880,0.031652989449003514
2621,2,907,867,1774,1.0461361014994233
2621,3,2503,499,3002,5.0160320641282565
2621,4,3028,874,3902,3.4645308924485128
2621,5,3948,1025,4973,3.8517073170731706
2621,6,5562,935,6497,5.948663101604278
2621,7,6513,909,7422,7.1650165016501655
2622,1,333,978,1311,0.34049079754601225
2622,2,1344,1055,2399,1.2739336492890996
2622,3,2433,594,3027,4.095959595959596
2622,4,3057,759,3816,4.027667984189724
2622,5,3829,517,4346,7.406189555125725
2623,1,273,566,839,0.4823321554770318
2623,2,852,532,1384,1.6015037593984962
2623,3,1401,561,1962,2.4973262032085564
2623,4,1983,573,2556,3.4607329842931938
2623,5,2579,571,3150,4.516637478108581
2623,6,3179,582,3761,5.462199312714777
2624,1,58,328,386,0.17682926829268292
2624,2,1761,1180,2941,1.4923728813559323
2624,3,2981,602,3583,4.951827242524917
2624,4,3986,556,4542,7.169064748201439
2624,5,4554,343,4897,13.276967930029155
2624,6,4962,821,5783,6.043848964677223
2624,7,5857,1310,7167,4.470992366412213
2625,1,74,66,140,1.121212121212121
2625,2,174,43,217,4.046511627906977
2625,3,256,35,291,7.314285714285714
2625,4,339,41,380,8.268292682926829
2625,5,430,43,473,10.0
2625,6,527,48,575,10.979166666666666
2625,7,619,43,662,14.395348837209303
2625,8,692,726,1418,0.953168044077135
2625,9,1499,1177,2676,1.2735768903993203
2625,10,2684,1196,3880,2.2441471571906355
2625,11,3888,906,4794,4.291390728476821
2625,12,4802,636,5438,7.550314465408805
2626,1,77,63,140,1.2222222222222223
2626,2,1549,50,1599,30.98
2626,3,4320,3,4323,1440.0
2627,1,353,1156,1509,0.305363321799308
2627,2,1624,848,2472,1.9150943396226414
2627,3,2529,885,3414,2.857627118644068
2628,1,1425,815,2240,1.7484662576687116
2628,2,2245,694,2939,3.2348703170028816
2628,3,4285,830,5115,5.162650602409639
2628,4,5120,441,5561,11.609977324263038
2628,5,5680,811,6491,7.003699136868065
2628,6,6569,734,7303,8.949591280653951
2629,1,318,305,623,1.042622950819672
2629,2,634,379,1013,1.6728232189973615
2629,3,1024,367,1391,2.790190735694823
2629,4,1402,345,1747,4.063768115942029
2629,5,1758,143,1901,12.293706293706293
2629,6,1915,96,2011,19.947916666666668
2629,7,2037,284,2321,7.172535211267606
2629,8,2352,267,2619,8.808988764044944
2629,9,2634,114,2748,23.105263157894736
2629,10,2875,338,3213,8.505917159763314
2629,11,3224,342,3566,9.426900584795321
2629,12,3577,274,3851,13.054744525547445
2629,13,3868,331,4199,11.685800604229607
2629,14,4210,345,4555,12.202898550724637
2629,15,4597,312,4909,14.73397435897436
2629,16,4920,278,5198,17.697841726618705
2629,17,5201,3,5204,1733.6666666666667
2630,1,91,382,473,0.23821989528795812
2631,1,95,538,633,0.17657992565055763
2632,1,132,132,264,1.0
2632,2,271,317,588,0.8548895899053628
2632,3,595,349,944,1.7048710601719197
2632,4,963,396,1359,2.4318181818181817
2632,5,1366,452,1818,3.02212389380531
2632,6,1825,357,2182,5.1120448179271705
2632,7,2190,253,2443,8.65612648221344
2633,1,34,577,611,0.058925476603119586
2633,2,627,69,696,9.08695652173913
2633,3,713,472,1185,1.5105932203389831
2633,4,1201,349,1550,3.4412607449856734
2633,5,1567,350,1917,4.477142857142857
2634,1,1408,320,1728,4.4
2634,2,1735,329,2064,5.27355623100304
2634,3,2095,390,2485,5.371794871794871
2634,4,2512,381,2893,6.593175853018373
2634,5,2930,353,3283,8.30028328611898
2635,1,26,101,127,0.25742574257425743
2635,2,160,110,270,1.4545454545454546
2635,3,286,28,314,10.214285714285714
2635,4,334,38,372,8.789473684210526
2635,5,624,87,711,7.172413793103448
2635,6,720,127,847,5.669291338582677
2635,7,4805,171,4976,28.099415204678362
2635,8,5275,121,5396,43.59504132231405
2635,9,7763,195,7958,39.81025641025641
2636,1,24,516,540,0.046511627906976744
2636,2,559,508,1067,1.1003937007874016
2636,3,1330,435,1765,3.057471264367816
2636,4,2212,348,2560,6.35632183908046
2636,5,2578,290,2868,8.889655172413793
2636,6,2885,172,3057,16.773255813953487
2637,1,68,265,333,0.25660377358490566
2637,2,406,306,712,1.326797385620915
2637,3,736,438,1174,1.6803652968036529
2637,4,1208,512,1720,2.359375
2637,5,1732,636,2368,2.7232704402515724
2637,6,2399,786,3185,3.0521628498727735
2637,7,3230,409,3639,7.897310513447433
2637,8,3662,402,4064,9.109452736318408
2637,9,4156,620,4776,6.703225806451613
2637,10,4865,466,5331,10.439914163090128
2637,11,5423,345,5768,15.718840579710145
2637,12,5818,181,5999,32.14364640883978
2637,13,6081,498,6579,12.210843373493976
2638,1,24,517,541,0.04642166344294004
2638,2,558,356,914,1.5674157303370786
2639,1,578,944,1522,0.6122881355932204
2639,2,3856,47,3903,82.04255319148936
2640,1,118,427,545,0.27634660421545665
2640,2,632,567,1199,1.1146384479717812
2640,3,1208,435,1643,2.7770114942528736
2641,1,40,535,575,0.07476635514018691
2641,2,615,684,1299,0.8991228070175439
2641,3,1384,618,2002,2.2394822006472492
2641,4,2035,626,2661,3.2507987220447285
2641,5,2733,429,3162,6.370629370629371
2641,6,3226,484,3710,6.6652892561983474
2641,7,3729,238,3967,15.668067226890756
2642,1,2869,801,3670,3.581772784019975
2642,2,3702,821,4523,4.509135200974422
2642,3,4608,897,5505,5.137123745819398
2642,4,5536,828,6364,6.685990338164252
2642,5,6421,659,7080,9.743550834597876
2642,6,7107,634,7741,11.209779179810726
2643,1,49,118,167,0.4152542372881356
2643,2,1723,416,2139,4.141826923076923
2643,3,2170,179,2349,12.12290502793296
2643,4,2358,328,2686,7.189024390243903
2643,5,2723,109,2832,24.98165137614679
2643,6,2865,353,3218,8.11614730878187
2643,7,3235,178,3413,18.174157303370787
2643,8,3426,229,3655,14.960698689956331
2643,9,3682,381,4063,9.664041994750656
2643,10,4071,189,4260,21.53968253968254
2643,11,4278,259,4537,16.517374517374517
2643,12,4553,228,4781,19.969298245614034
2643,13,4798,233,5031,20.59227467811159
2643,14,5039,258,5297,19.531007751937985
2643,15,5321,164,5485,32.44512195121951
2643,16,5494,228,5722,24.096491228070175
2643,17,5732,249,5981,23.02008032128514
2643,18,5997,320,6317,18.740625
2643,19,6358,328,6686,19.384146341463413
2643,20,6701,414,7115,16.185990338164252
2643,21,7148,274,7422,26.087591240875913
2643,22,7435,272,7707,27.334558823529413
2643,23,7741,260,8001,29.773076923076925
2644,1,19,272,291,0.06985294117647059
2645,1,346,903,1249,0.3831672203765227
2645,2,1262,927,2189,1.3613807982740023
2645,3,2202,264,2466,8.340909090909092
2645,4,2489,626,3115,3.976038338658147
2645,5,3142,926,4068,3.3930885529157666
2646,1,203,22,225,9.227272727272727
2646,2,242,598,840,0.40468227424749165
2647,1,320,964,1284,0.33195020746887965
2647,2,1291,983,2274,1.313326551373347
2647,3,2306,974,3280,2.3675564681724848
2647,4,3287,627,3914,5.242424242424242
2648,1,16,96,112,0.16666666666666666
2648,2,153,91,244,1.6813186813186813
2648,3,443,659,1102,0.6722306525037937
2648,4,1125,809,1934,1.3906056860321385
2648,5,1965,605,2570,3.2479338842975207
2648,6,2651,848,3499,3.126179245283019
2648,7,3508,576,4084,6.090277777777778
2648,8,4106,636,4742,6.455974842767295
2649,1,20,664,684,0.030120481927710843
2649,2,710,329,1039,2.1580547112462005
2649,3,1071,237,1308,4.518987341772152
2649,4,1332,502,1834,2.653386454183267
2649,5,1865,500,2365,3.73
2649,6,2386,648,3034,3.682098765432099
2649,7,3056,552,3608,5.536231884057971
2649,8,3626,515,4141,7.040776699029126
2649,9,4160,452,4612,9.20353982300885
2649,10,4631,516,5147,8.974806201550388
2649,11,5197,647,5844,8.032457496136013
2650,1,50,771,821,0.0648508430609598
2650,2,1617,848,2465,1.9068396226415094
2650,3,2467,335,2802,7.364179104477612
2650,4,2810,844,3654,3.329383886255924
2650,5,3660,714,4374,5.126050420168068
2650,6,4387,859,5246,5.10710128055879
2650,7,5248,597,5845,8.790619765494137
2650,8,5873,802,6675,7.322942643391521
2650,9,6696,825,7521,8.116363636363637
2651,1,601,508,1109,1.1830708661417322
2651,2,1130,451,1581,2.505543237250554
2651,3,1600,431,2031,3.7122969837587005
2651,4,2059,488,2547,4.219262295081967
2651,5,2567,523,3090,4.908221797323136
2652,1,10,38,48,0.2631578947368421
2652,2,70,175,245,0.4
2652,3,259,415,674,0.6240963855421687
2652,4,686,167,853,4.107784431137724
2652,5,928,428,1356,2.1682242990654204
2652,6,1377,366,1743,3.762295081967213
2652,7,1762,139,1901,12.676258992805755
2652,8,1917,775,2692,2.4735483870967743
2653,1,267,452,719,0.5907079646017699
2653,2,728,505,1233,1.4415841584158415
2653,3,1241,230,1471,5.395652173913043
2653,4,1511,583,2094,2.5917667238421958
2653,5,2111,475,2586,4.444210526315789
2653,6,2886,6,2892,481.0
2653,7,3192,440,3632,7.254545454545455
2653,8,4032,205,4237,19.66829268292683
2653,9,4269,209,4478,20.425837320574164
2653,10,4488,88,4576,51.0
2653,11,4586,113,4699,40.584070796460175
2653,12,5121,197,5318,25.99492385786802
2653,13,5496,156,5652,35.23076923076923
2653,14,5792,315,6107,18.387301587301586
2653,15,6168,479,6647,12.876826722338205
2653,16,6673,483,7156,13.815734989648034
2653,17,7170,451,7621,15.8980044345898
2653,18,7635,96,7731,79.53125
2654,1,184,515,699,0.3572815533980582
2654,2,727,383,1110,1.8981723237597912
2655,1,442,602,1044,0.7342192691029901
2656,1,69,67,136,1.0298507462686568
2656,2,1348,721,2069,1.869625520110957
2656,3,2215,855,3070,2.590643274853801
2656,4,3229,881,4110,3.6651532349602722
2656,5,4119,701,4820,5.875891583452211
2656,6,4995,1003,5998,4.980059820538385
2657,1,18,456,474,0.039473684210526314
2657,2,491,433,924,1.1339491916859123
2657,3,932,380,1312,2.4526315789473685
2657,4,1320,424,1744,3.1132075471698113
2658,1,72,411,483,0.17518248175182483
2658,2,518,936,1454,0.5534188034188035
2659,1,13,367,380,0.035422343324250684
2659,2,399,575,974,0.6939130434782609
2660,1,403,433,836,0.930715935334873
2660,2,1547,682,2229,2.268328445747801
2660,3,2596,955,3551,2.718324607329843
2660,4,3658,1226,4884,2.9836867862969005
2660,5,4918,317,5235,15.514195583596214
2660,6,5345,1215,6560,4.399176954732511
2661,1,3973,9,3982,441.44444444444446
2661,2,4066,529,4595,7.686200378071834
2662,1,739,203,942,3.6403940886699506
2662,2,953,101,1054,9.435643564356436
2662,3,1066,162,1228,6.580246913580247
2663,1,23,667,690,0.034482758620689655
2663,2,715,665,1380,1.0751879699248121
2663,3,1409,724,2133,1.9461325966850829
2663,4,2150,610,2760,3.5245901639344264
2663,5,2776,735,3511,3.7768707482993196
2663,6,3533,906,4439,3.8995584988962473
2663,7,4468,669,5137,6.678624813153961
2663,8,5177,814,5991,6.35995085995086
2664,1,532,951,1483,0.5594111461619348
2664,2,1495,269,1764,5.557620817843866
2664,3,1818,471,2289,3.859872611464968
2665,1,152,494,646,0.3076923076923077
2665,2,648,46,694,14.08695652173913
2665,3,759,406,1165,1.8694581280788178
2665,4,1167,226,1393,5.163716814159292
2665,5,1419,369,1788,3.845528455284553
2666,1,33,654,687,0.05045871559633028
2667,1,54,664,718,0.08132530120481928
2667,2,892,1124,2016,0.7935943060498221
2668,1,17,1037,1054,0.01639344262295082
2668,2,1070,349,1419,3.0659025787965617
2668,3,1436,1092,2528,1.315018315018315
2668,4,2534,1093,3627,2.3183897529734674
2668,5,3648,267,3915,13.662921348314606
2668,6,3938,269,4207,14.639405204460967
2668,7,4242,323,4565,13.13312693498452
2669,1,280,1021,1301,0.2742409402546523
2669,2,1358,941,2299,1.4431455897980872
2670,1,94,834,928,0.11270983213429256
2670,2,1658,266,1924,6.2330827067669174
2670,3,1927,376,2303,5.125
2670,4,2748,71,2819,38.70422535211268
2670,5,4793,302,5095,15.870860927152318
2671,1,33,789,822,0.04182509505703422
2671,2,858,760,1618,1.1289473684210527
2671,3,1702,540,2242,3.151851851851852
2671,4,2316,532,2848,4.353383458646617
2671,5,2922,461,3383,6.3383947939262475
2671,6,3413,507,3920,6.731755424063117
2671,7,3951,450,4401,8.78
2671,8,4429,486,4915,9.113168724279836
2671,9,4948,481,5429,10.286902286902286
2671,10,5461,336,5797,16.25297619047619
2671,11,5838,654,6492,8.926605504587156
2671,12,6527,661,7188,9.874432677760968
2671,13,7225,420,7645,17.202380952380953
2672,1,41,1012,1053,0.040513833992094864
2673,1,25,587,612,0.04258943781942078
2673,2,628,523,1151,1.2007648183556405
2673,3,1169,658,1827,1.7765957446808511
2673,4,1857,565,2422,3.286725663716814
2673,5,2446,865,3311,2.827745664739884
2673,6,3339,400,3739,8.3475
2673,7,3757,427,4184,8.798594847775176
2674,1,7,398,405,0.017587939698492462
2674,2,423,524,947,0.8072519083969466
2674,3,971,599,1570,1.6210350584307178
2674,4,1922,574,2496,3.3484320557491287
2674,5,2971,692,3663,4.293352601156069
2674,6,3683,139,3822,26.496402877697843
2674,7,3976,597,4573,6.659966499162479
2674,8,4599,553,5152,8.316455696202532
2674,9,5193,337,5530,15.409495548961424
2674,10,5742,723,6465,7.941908713692946
2674,11,6528,188,6716,34.723404255319146
2674,12,6726,136,6862,49.455882352941174
2674,13,6979,327,7306,21.34250764525994
2675,1,19,274,293,0.06934306569343066
2676,1,129,357,486,0.36134453781512604
2676,2,513,347,860,1.478386167146974
2677,1,244,274,518,0.8905109489051095
2677,2,550,182,732,3.021978021978022
2677,3,737,205,942,3.5951219512195123
2677,4,953,115,1068,8.28695652173913
2677,5,1079,211,1290,5.113744075829384
2677,6,1293,210,1503,6.1571428571428575
2677,7,1518,195,1713,7.7846153846153845
2677,8,1725,369,2094,4.67479674796748
2677,9,2106,250,2356,8.424
2677,10,2359,165,2524,14.296969696969697
2677,11,2527,103,2630,24.533980582524272
2677,12,2633,192,2825,13.713541666666666
2677,13,2860,306,3166,9.34640522875817
2677,14,3191,239,3430,13.351464435146443
2677,15,3444,187,3631,18.41711229946524
2677,16,3643,171,3814,21.304093567251464
2677,17,3817,229,4046,16.66812227074236
2677,18,4049,259,4308,15.633204633204633
2677,19,4311,278,4589,15.507194244604317
2677,20,4592,254,4846,18.078740157480315
2677,21,4849,254,5103,19.090551181102363
2677,22,5106,228,5334,22.394736842105264
2677,23,5373,219,5592,24.534246575342465
2677,24,5595,233,5828,24.012875536480685
2677,25,5865,239,6104,24.539748953974897
2677,26,6107,257,6364,23.762645914396888
2677,27,6385,251,6636,25.438247011952193
2677,28,6639,226,6865,29.376106194690266
2677,29,6892,234,7126,29.45299145299145
2677,30,7167,203,7370,35.30541871921182
2678,1,2,30,32,0.06666666666666667
2679,1,364,439,803,0.8291571753986332
2679,2,816,476,1292,1.7142857142857142
2680,1,11,386,397,0.02849740932642487
2680,2,408,262,670,1.5572519083969465
2680,3,683,320,1003,2.134375
2680,4,1063,474,1537,2.242616033755274
2680,5,1550,484,2034,3.2024793388429753
2680,6,2047,295,2342,6.938983050847457
2680,7,2461,284,2745,8.665492957746478
2680,8,2993,315,3308,9.501587301587302
2680,9,4048,314,4362,12.89171974522293
2680,10,4378,406,4784,10.783251231527094
2681,1,228,634,862,0.35962145110410093
2681,2,961,642,1603,1.4968847352024923
2681,3,1707,689,2396,2.4775036284470247
2681,4,2480,765,3245,3.241830065359477
2681,5,3352,802,4154,4.179551122194514
2681,6,4293,816,5109,5.261029411764706
2681,7,5126,403,5529,12.719602977667494
2681,8,5566,199,5765,27.969849246231156
2682,1,13,572,585,0.022727272727272728
2682,2,605,589,1194,1.0271646859083192
2682,3,1210,580,1790,2.086206896551724
2682,4,1815,480,2295,3.78125
2683,1,17,688,705,0.024709302325581394
2684,1,72,797,869,0.0903387703889586
2684,2,955,1093,2048,0.8737419945105215
2684,3,2113,922,3035,2.2917570498915403
2684,4,3102,71,3173,43.690140845070424
2684,5,3344,1089,4433,3.0707070707070705
2684,6,4460,329,4789,13.556231003039514
2684,7,4835,1026,5861,4.712475633528265
2684,8,5912,679,6591,8.706921944035345
2684,9,6698,1079,7777,6.207599629286376
2685,1,5,24,29,0.20833333333333334
2685,2,173,956,1129,0.1809623430962343
2685,3,1215,615,1830,1.975609756097561
2685,4,1930,929,2859,2.077502691065662
2685,5,2951,431,3382,6.846867749419953
2685,6,3397,464,3861,7.321120689655173
2686,1,95,576,671,0.16493055555555555
2686,2,685,103,788,6.650485436893204
2686,3,798,147,945,5.428571428571429
2686,4,962,133,1095,7.2330827067669174
2686,5,1106,149,1255,7.422818791946309
2686,6,1283,281,1564,4.565836298932385
2686,7,1596,220,1816,7.254545454545455
2686,8,1831,105,1936,17.438095238095237
2686,9,1967,239,2206,8.230125523012552
2686,10,2217,115,2332,19.278260869565216
2686,11,2355,422,2777,5.580568720379147
2686,12,2789,155,2944,17.993548387096773
2686,13,2960,121,3081,24.462809917355372
2686,14,3114,435,3549,7.158620689655172
2686,15,3552,203,3755,17.497536945812808
2687,1,29,784,813,0.036989795918367346
2688,1,47,858,905,0.054778554778554776
2688,2,2551,427,2978,5.97423887587822
2688,3,3137,1067,4204,2.9400187441424555
2688,4,4218,1016,5234,4.1515748031496065
2688,5,5288,204,5492,25.92156862745098
2688,6,5539,418,5957,13.251196172248804
2688,7,6032,426,6458,14.15962441314554
2688,8,6513,804,7317,8.100746268656716
2688,9,7372,534,7906,13.805243445692884
2689,1,18,588,606,0.030612244897959183
2689,2,621,695,1316,0.8935251798561151
2689,3,1339,833,2172,1.6074429771908763
2689,4,2187,1026,3213,2.1315789473684212
2689,5,3233,736,3969,4.392663043478261
2690,1,1134,931,2065,1.218045112781955
2691,1,18,324,342,0.05555555555555555
2691,2,377,377,754,1.0
2691,3,781,429,1210,1.8205128205128205
2691,4,1248,249,1497,5.0120481927710845
2691,5,1564,383,1947,4.0835509138381205
2691,6,1971,439,2410,4.489749430523918
2691,7,2448,553,3001,4.426763110307414
2691,8,3032,103,3135,29.436893203883496
2691,9,3163,527,3690,6.001897533206831
2691,10,3719,787,4506,4.72554002541296
2691,11,4603,360,4963,12.786111111111111
2691,12,4996,373,5369,13.394101876675602
2691,13,5452,462,5914,11.8008658008658
2691,14,6448,458,6906,14.078602620087336
2692,1,2038,12,2050,169.83333333333334
2692,2,3844,12,3856,320.3333333333333
2692,3,5131,12,5143,427.5833333333333
2692,4,5192,434,5626,11.963133640552995
2692,5,5638,512,6150,11.01171875
2693,1,78,642,720,0.12149532710280374
2694,1,5,529,534,0.00945179584120983
2694,2,561,261,822,2.1494252873563218
2695,1,29,259,288,0.11196911196911197
2695,2,330,1131,1461,0.2917771883289125
2695,3,1517,1020,2537,1.4872549019607844
2695,4,2688,975,3663,2.756923076923077
2695,5,3756,1069,4825,3.5135640785781104
2695,6,4877,361,5238,13.509695290858726
2695,7,5331,889,6220,5.996625421822272
2695,8,6258,146,6404,42.863013698630134
2696,1,1749,523,2272,3.344168260038241
2696,2,2356,382,2738,6.167539267015707
2696,3,4540,524,5064,8.664122137404581
2697,1,10,829,839,0.012062726176115802
2697,2,876,676,1552,1.2958579881656804
2697,3,1560,980,2540,1.5918367346938775
2697,4,2632,343,2975,7.673469387755102
2697,5,3011,541,3552,5.565619223659889
2697,6,3569,982,4551,3.634419551934827
2697,7,4560,614,5174,7.4267100977198695
2697,8,5205,959,6164,5.427528675703858
2697,9,6189,831,7020,7.447653429602888
2697,10,7040,809,7849,8.702101359703338
2698,1,1222,523,1745,2.3365200764818357
2699,1,72,304,376,0.23684210526315788
2699,2,643,818,1461,0.7860635696821516
2699,3,1466,634,2100,2.312302839116719
2700,1,142,460,602,0.30869565217391304
2701,1,77,688,765,0.1119186046511628
2702,1,11,337,348,0.032640949554896145
2703,1,90,125,215,0.72
2703,2,225,125,350,1.8
2703,3,365,347,712,1.0518731988472623
2703,4,726,286,1012,2.5384615384615383
2704,1,33,878,911,0.03758542141230068
2704,2,944,462,1406,2.0432900432900434
2704,3,1427,954,2381,1.4958071278825995
2704,4,2389,971,3360,2.460350154479918
2704,5,3383,814,4197,4.156019656019656
2704,6,4206,666,4872,6.315315315315315
2704,7,4895,189,5084,25.8994708994709
2705,1,45,622,667,0.07234726688102894
2706,1,74,481,555,0.15384615384615385
2706,2,578,240,818,2.408333333333333
2707,1,694,74,768,9.378378378378379
2707,2,1375,77,1452,17.857142857142858
2707,3,1493,424,1917,3.5212264150943398
2707,4,1988,503,2491,3.952286282306163
2707,5,2524,383,2907,6.590078328981723
2707,6,2932,207,3139,14.16425120772947
2707,7,3172,581,3753,5.459552495697074
2707,8,3778,372,4150,10.155913978494624
2707,9,4196,423,4619,9.919621749408984
2707,10,4635,728,5363,6.366758241758242
2707,11,5412,563,5975,9.61278863232682
2707,12,5990,386,6376,15.518134715025907
2707,13,6394,508,6902,12.586614173228346
2707,14,6926,634,7560,10.92429022082019
2708,1,40,892,932,0.04484304932735426
2708,2,1019,1023,2042,0.9960899315738025
2708,3,2058,1012,3070,2.033596837944664
2708,4,3091,1020,4111,3.030392156862745
2708,5,4130,1035,5165,3.9903381642512077
2708,6,5189,1044,6233,4.9703065134099615
2708,7,6302,1028,7330,6.13035019455253
2709,1,32,363,395,0.0881542699724518
2709,2,494,535,1029,0.9233644859813084
2709,3,1073,955,2028,1.1235602094240837
2709,4,2086,659,2745,3.165402124430956
2709,5,2906,367,3273,7.918256130790191
2709,6,3285,398,3683,8.253768844221106
2709,7,3696,377,4073,9.803713527851459
2709,8,4197,784,4981,5.353316326530612
2709,9,5136,511,5647,10.050880626223092
2709,10,5737,503,6240,11.405566600397615
2709,11,6315,820,7135,7.701219512195122
2709,12,7219,655,7874,11.021374045801526
2710,1,1968,500,2468,3.936
2710,2,2524,780,3304,3.235897435897436
2710,3,3521,621,4142,5.669887278582931
2711,1,10,613,623,0.01631321370309951
2711,2,652,588,1240,1.1088435374149659
2711,3,1341,374,1715,3.585561497326203
2711,4,1727,368,2095,4.692934782608695
2711,5,2235,439,2674,5.091116173120729
2711,6,2820,224,3044,12.589285714285714
2711,7,3167,219,3386,14.461187214611872
2711,8,3407,188,3595,18.122340425531913
2711,9,3614,194,3808,18.628865979381445
2712,1,33,440,473,0.075
2712,2,483,407,890,1.1867321867321867
2712,3,919,210,1129,4.376190476190477
2712,4,1143,304,1447,3.7598684210526314
2713,1,35,111,146,0.3153153153153153
2713,2,152,95,247,1.6
2714,1,94,728,822,0.12912087912087913
2714,2,829,693,1522,1.1962481962481963
2714,3,1565,885,2450,1.768361581920904
2714,4,2467,753,3220,3.2762284196547147
2714,5,3236,996,4232,3.248995983935743
2714,6,4241,692,4933,6.128612716763006
2714,7,4941,1061,6002,4.656927426955702
2714,8,6007,410,6417,14.651219512195121
2715,1,181,42,223,4.309523809523809
2715,2,2013,609,2622,3.3054187192118225
2715,3,4174,272,4446,15.345588235294118
2715,4,4462,463,4925,9.637149028077754
2715,5,6765,338,7103,20.014792899408285
2715,6,7116,271,7387,26.25830258302583
2715,7,7882,198,8080,39.80808080808081
2716,1,57,656,713,0.08689024390243902
2716,2,723,3,726,241.0
2717,1,43,355,398,0.12112676056338029
2718,1,1660,87,1747,19.080459770114942
2719,1,220,392,612,0.5612244897959183
2719,2,1000,425,1425,2.3529411764705883
2719,3,1566,266,1832,5.887218045112782
2719,4,1999,401,2400,4.985037406483791
2719,5,2463,422,2885,5.8364928909952605
2719,6,2888,526,3414,5.490494296577947
2719,7,3430,423,3853,8.108747044917259
2719,8,3856,364,4220,10.593406593406593
2719,9,4256,8,4264,532.0
2719,10,4743,473,5216,10.027484143763214
2719,11,5235,269,5504,19.460966542750928
2719,12,5525,265,5790,20.849056603773583
2719,13,6336,47,6383,134.80851063829786
2720,1,18,521,539,0.0345489443378119
2720,2,551,443,994,1.2437923250564333
2720,3,1005,367,1372,2.7384196185286105
2720,4,1392,573,1965,2.4293193717277486
2720,5,1977,647,2624,3.05564142194745
2720,6,2648,450,3098,5.884444444444444
2720,7,3162,937,4099,3.374599786552828
2720,8,4117,489,4606,8.41922290388548
2720,9,4633,587,5220,7.89267461669506
2720,10,5236,675,5911,7.757037037037037
2720,11,5925,692,6617,8.5621387283237
2720,12,6634,597,7231,11.112227805695142
2720,13,7248,649,7897,11.167950693374422
2721,1,1550,741,2291,2.0917678812415654
2722,1,206,23,229,8.956521739130435
2722,2,304,471,775,0.6454352441613588
2722,3,807,504,1311,1.6011904761904763
2722,4,1322,508,1830,2.6023622047244093
2722,5,1837,526,2363,3.4923954372623576
2722,6,2370,522,2892,4.540229885057471
2722,7,2899,511,3410,5.673189823874756
2722,8,3417,528,3945,6.471590909090909
2722,9,3952,531,4483,7.44256120527307
2722,10,4490,513,5003,8.75243664717349
2722,11,5010,511,5521,9.804305283757339
2723,1,313,362,675,0.8646408839779005
2724,1,52,980,1032,0.053061224489795916
2724,2,1038,210,1248,4.942857142857143
2724,3,1264,618,1882,2.045307443365696
2724,4,1893,317,2210,5.971608832807571
2724,5,2236,386,2622,5.7927461139896375
2724,6,2651,288,2939,9.20486111111111
2724,7,2948,343,3291,8.594752186588922
2724,8,3319,87,3406,38.14942528735632
2725,1,142,392,534,0.3622448979591837
2725,2,549,159,708,3.452830188679245
2725,3,772,304,1076,2.539473684210526
2725,4,1142,316,1458,3.6139240506329116
2726,1,253,148,401,1.7094594594594594
2726,2,693,775,1468,0.8941935483870967
2726,3,1532,586,2118,2.614334470989761
2726,4,2322,647,2969,3.58887171561051
2726,5,3048,856,3904,3.560747663551402
2726,6,3972,1045,5017,3.800956937799043
2727,1,130,597,727,0.21775544388609716
2728,1,4,15,19,0.26666666666666666
2729,1,17,469,486,0.03624733475479744
2730,1,142,89,231,1.595505617977528
2730,2,316,510,826,0.6196078431372549
2730,3,880,389,1269,2.2622107969151672
2730,4,1669,502,2171,3.3247011952191237
2731,1,24,1021,1045,0.023506366307541625
2731,2,1047,702,1749,1.4914529914529915
2732,1,153,113,266,1.3539823008849559
2732,2,2717,372,3089,7.303763440860215
2732,3,3119,373,3492,8.361930294906166
2732,4,3495,388,3883,9.007731958762887
2732,5,3886,335,4221,11.6
2732,6,4224,330,4554,12.8
2732,7,4578,304,4882,15.05921052631579
2732,8,4885,303,5188,16.122112211221122
2732,9,5191,383,5574,13.553524804177545
2732,10,5577,165,5742,33.8
2732,11,5796,680,6476,8.523529411764706
2732,12,6505,655,7160,9.931297709923664
2732,13,7179,588,7767,12.209183673469388
2733,1,36,927,963,0.038834951456310676
2734,1,19,265,284,0.07169811320754717
2734,2,313,287,600,1.0905923344947734
2735,1,13,397,410,0.0327455919395466
2736,1,75,87,162,0.8620689655172413
2736,2,193,336,529,0.5744047619047619
2736,3,560,401,961,1.3965087281795512
2736,4,983,57,1040,17.24561403508772
2736,5,1062,56,1118,18.964285714285715
2736,6,1126,99,1225,11.373737373737374
2736,7,1240,304,1544,4.078947368421052
2736,8,1557,212,1769,7.34433962264151
2736,9,1784,281,2065,6.3487544483985765
2736,10,2082,125,2207,16.656
2736,11,2223,121,2344,18.371900826446282
2736,12,2364,161,2525,14.683229813664596
2736,13,2530,77,2607,32.857142857142854
2736,14,2649,515,3164,5.14368932038835
2736,15,3169,25,3194,126.76
2736,16,3200,81,3281,39.50617283950617
2736,17,3288,221,3509,14.877828054298643
2737,1,96,579,675,0.16580310880829016
2738,1,54,36,90,1.5
2738,2,116,232,348,0.5
2739,1,18,501,519,0.03592814371257485
2739,2,529,303,832,1.7458745874587458
2739,3,869,299,1168,2.9063545150501673
2739,4,1208,161,1369,7.503105590062112
2739,5,1408,410,1818,3.4341463414634146
2739,6,1861,426,2287,4.368544600938967
2739,7,2310,523,2833,4.416826003824092
2739,8,2856,340,3196,8.4
2739,9,3210,463,3673,6.93304535637149
2739,10,3683,457,4140,8.059080962800875
2739,11,4184,478,4662,8.753138075313808
2739,12,4705,418,5123,11.25598086124402
2739,13,5190,300,5490,17.3
2739,14,5510,484,5994,11.384297520661157
2739,15,6013,633,6646,9.499210110584519
2739,16,6728,503,7231,13.375745526838966
2739,17,7242,673,7915,10.760772659732542
2740,1,14,193,207,0.07253886010362694
2740,2,220,371,591,0.5929919137466307
2740,3,598,551,1149,1.08529945553539
2740,4,1175,34,1209,34.55882352941177
2740,5,1853,896,2749,2.068080357142857
2740,6,2758,801,3559,3.4431960049937578
2740,7,3714,171,3885,21.719298245614034
2740,8,4090,188,4278,21.75531914893617
2740,9,4375,406,4781,10.775862068965518
2740,10,4801,532,5333,9.024436090225564
2740,11,5374,739,6113,7.2719891745602165
2740,12,6290,495,6785,12.707070707070708
2740,13,6808,528,7336,12.893939393939394
2740,14,7360,551,7911,13.357531760435572
2741,1,160,858,1018,0.1864801864801865
2741,2,1072,799,1871,1.3416770963704632
2741,3,2050,914,2964,2.2428884026258205
2741,4,2993,126,3119,23.753968253968253
2741,5,3241,1175,4416,2.7582978723404254
2741,6,4524,603,5127,7.502487562189055
2742,1,16,149,165,0.10738255033557047
2742,2,171,83,254,2.0602409638554215
2742,3,435,527,962,0.825426944971537
2743,1,143,190,333,0.7526315789473684
2743,2,373,236,609,1.5805084745762712
2743,3,722,246,968,2.934959349593496
2743,4,1049,237,1286,4.4261603375527425
2743,5,1330,183,1513,7.26775956284153
2744,1,33,109,142,0.30275229357798167
2744,2,157,157,314,1.0
2744,3,479,422,901,1.1350710900473933
2745,1,84,69,153,1.2173913043478262
2745,2,189,191,380,0.9895287958115183
2745,3,386,64,450,6.03125
2746,1,40,46,86,0.8695652173913043
2746,2,104,165,269,0.6303030303030303
2746,3,288,446,734,0.6457399103139013
2746,4,765,576,1341,1.328125
2747,1,29,282,311,0.10283687943262411
2747,2,314,302,616,1.0397350993377483
2747,3,619,303,922,2.042904290429043
2747,4,926,333,1259,2.780780780780781
2748,1,18,610,628,0.029508196721311476
2748,2,639,393,1032,1.6259541984732824
2748,3,1045,539,1584,1.9387755102040816
2749,1,3584,683,4267,5.247437774524158
2749,2,4275,751,5026,5.692410119840213
2749,3,5063,494,5557,10.248987854251013
2749,4,5565,648,6213,8.587962962962964
2750,1,671,436,1107,1.5389908256880733
2750,2,1147,443,1590,2.5891647855530473
2750,3,1632,310,1942,5.264516129032258
2750,4,1976,302,2278,6.543046357615894
2750,5,2299,310,2609,7.416129032258064
2750,6,2641,65,2706,40.63076923076923
2751,1,1735,392,2127,4.426020408163265
2752,1,159,1060,1219,0.15
2752,2,1235,683,1918,1.808199121522694
2753,1,20,360,380,0.05555555555555555
2753,2,455,555,1010,0.8198198198198198
2753,3,1053,507,1560,2.076923076923077
2753,4,1573,537,2110,2.9292364990689013
2753,5,2147,126,2273,17.03968253968254
2753,6,2308,590,2898,3.911864406779661
2753,7,2915,536,3451,5.438432835820896
2754,1,100,101,201,0.9900990099009901
2754,2,1313,520,1833,2.525
2754,3,1943,509,2452,3.817288801571709
2754,4,2648,534,3182,4.9588014981273405
2754,5,3287,521,3808,6.309021113243762
2754,6,3901,394,4295,9.901015228426395
2755,1,30,498,528,0.060240963855421686
2755,2,540,529,1069,1.0207939508506616
2755,3,1076,531,1607,2.0263653483992465
2756,1,14,416,430,0.03365384615384615
2756,2,439,223,662,1.968609865470852
2756,3,668,390,1058,1.7128205128205127
2756,4,1066,359,1425,2.969359331476323
2756,5,1438,197,1635,7.299492385786802
2757,1,65,530,595,0.12264150943396226
2758,1,423,443,866,0.9548532731376975
2759,1,12,488,500,0.02459016393442623
2760,1,62,766,828,0.08093994778067885
2761,1,22,131,153,0.16793893129770993
2761,2,235,173,408,1.3583815028901733
2761,3,420,193,613,2.1761658031088085
2762,1,32,661,693,0.048411497730711045
2763,1,257,476,733,0.5399159663865546
2763,2,781,511,1292,1.528375733855186
2764,1,383,1160,1543,0.33017241379310347
2764,2,1600,1154,2754,1.3864818024263432
2764,3,2829,507,3336,5.579881656804734
2764,4,3438,1200,4638,2.865
2764,5,4931,583,5514,8.457975986277873
2764,6,5607,1167,6774,4.804627249357327
2764,7,6919,935,7854,7.4
2765,1,880,263,1143,3.346007604562738
2765,2,1153,391,1544,2.948849104859335
2765,3,1573,86,1659,18.290697674418606
2765,4,1675,67,1742,25.0
2765,5,1754,278,2032,6.309352517985611
2765,6,2050,295,2345,6.9491525423728815
2765,7,2361,459,2820,5.143790849673203
2765,8,3859,287,4146,13.445993031358885
2765,9,4167,402,4569,10.365671641791044
2765,10,4595,135,4730,34.03703703703704
2765,11,6655,187,6842,35.588235294117645
2765,12,6866,156,7022,44.01282051282051
2765,13,7041,201,7242,35.02985074626866
2765,14,7322,201,7523,36.42786069651741
2765,15,7586,249,7835,30.46586345381526
2766,1,41,22,63,1.8636363636363635
2766,2,72,125,197,0.576
2766,3,207,79,286,2.6202531645569622
2766,4,302,44,346,6.863636363636363
2766,5,357,220,577,1.6227272727272728
2767,1,23,213,236,0.107981220657277
2767,2,251,527,778,0.476280834914611
2767,3,864,888,1752,0.972972972972973
2767,4,1754,737,2491,2.379918588873813
2768,1,98,711,809,0.13783403656821377
2768,2,828,882,1710,0.9387755102040817
2768,3,1767,321,2088,5.5046728971962615
2768,4,2094,164,2258,12.768292682926829
2769,1,23,116,139,0.19827586206896552
2769,2,201,420,621,0.4785714285714286
2769,3,660,225,885,2.933333333333333
2769,4,976,633,1609,1.5418641390205372
2769,5,1648,277,1925,5.949458483754513
2769,6,2063,510,2573,4.045098039215686
2769,7,2686,815,3501,3.2957055214723927
2769,8,4163,626,4789,6.6501597444089455
2769,9,4835,589,5424,8.208828522920204
2769,10,5447,830,6277,6.562650602409638
2769,11,6742,726,7468,9.286501377410469
2770,1,55,753,808,0.07304116865869854
2770,2,848,702,1550,1.207977207977208
2770,3,1569,552,2121,2.842391304347826
2770,4,2136,364,2500,5.868131868131868
2770,5,2527,1065,3592,2.3727699530516433
2770,6,3598,240,3838,14.991666666666667
2771,1,1190,977,2167,1.218014329580348
2771,2,2169,366,2535,5.926229508196721
2771,3,2594,453,3047,5.72626931567329
2772,1,1694,424,2118,3.9952830188679247
2773,1,602,451,1053,1.334811529933481
2773,2,1067,113,1180,9.442477876106194
2774,1,67,1284,1351,0.05218068535825545
2775,1,9,463,472,0.019438444924406047
2775,2,508,652,1160,0.7791411042944786
2776,1,814,131,945,6.213740458015267
2777,1,57,903,960,0.06312292358803986
2777,2,970,508,1478,1.9094488188976377
2777,3,1491,504,1995,2.9583333333333335
2777,4,2024,646,2670,3.1331269349845203
2778,1,72,230,302,0.3130434782608696
2779,1,31,660,691,0.04696969696969697
2780,1,10,506,516,0.019762845849802372
2780,2,520,463,983,1.123110151187905
2780,3,988,430,1418,2.297674418604651
2780,4,1450,87,1537,16.666666666666668
2780,5,1552,127,1679,12.220472440944881
2780,6,1687,284,1971,5.940140845070423
2781,1,109,1001,1110,0.1088911088911089
2782,1,64,920,984,0.06956521739130435
2782,2,993,839,1832,1.1835518474374256
2783,1,190,757,947,0.2509907529722589
2784,1,24,599,623,0.04006677796327212
2785,1,41,324,365,0.12654320987654322
2785,2,367,33,400,11.121212121212121
2786,1,129,332,461,0.3885542168674699
2786,2,471,405,876,1.162962962962963
2787,1,53,558,611,0.09498207885304659
2788,1,29,103,132,0.2815533980582524
2788,2,247,296,543,0.8344594594594594
2788,3,1595,228,1823,6.995614035087719
2788,4,2575,295,2870,8.728813559322035
2788,5,2877,65,2942,44.261538461538464
2788,6,2959,198,3157,14.944444444444445
2788,7,3638,336,3974,10.827380952380953
2788,8,4305,292,4597,14.743150684931507
2788,9,4928,278,5206,17.72661870503597
2788,10,5277,161,5438,32.77639751552795
2788,11,5535,232,5767,23.857758620689655
2788,12,6141,489,6630,12.558282208588958
2788,13,6640,512,7152,12.96875
2788,14,7165,368,7533,19.470108695652176
2788,15,7543,342,7885,22.055555555555557
2789,1,21,693,714,0.030303030303030304
2790,1,148,1058,1206,0.13988657844990549
2790,2,1255,528,1783,2.3768939393939394
2790,3,1844,567,2411,3.252204585537919
2790,4,2445,385,2830,6.35064935064935
2790,5,2875,410,3285,7.012195121951219
2790,6,3530,299,3829,11.806020066889632
2790,7,3870,1054,4924,3.6717267552182165
2790,8,4944,1030,5974,4.8
2790,9,6025,1051,7076,5.732635585156993
2791,1,9,154,163,0.05844155844155844
2791,2,173,78,251,2.217948717948718
2791,3,285,108,393,2.638888888888889
2791,4,759,638,1397,1.1896551724137931
2791,5,1406,561,1967,2.5062388591800357
2791,6,2916,716,3632,4.072625698324022
2792,1,414,215,629,1.9255813953488372
2792,2,663,293,956,2.262798634812287
2792,3,1514,568,2082,2.665492957746479
2792,4,2156,662,2818,3.256797583081571
2792,5,5640,534,6174,10.561797752808989
2792,6,6220,453,6673,13.730684326710817
2792,7,6717,633,7350,10.611374407582938
2793,1,1763,456,2219,3.866228070175439
2794,1,96,945,1041,0.10158730158730159
2794,2,1052,602,1654,1.7475083056478404
2795,1,41,665,706,0.061654135338345864
2795,2,730,451,1181,1.6186252771618626
2795,3,1262,486,1748,2.596707818930041
2795,4,1952,482,2434,4.049792531120332
2795,5,2708,769,3477,3.5214564369310795
2795,6,3496,1002,4498,3.489021956087824
2796,1,1014,81,1095,12.518518518518519
2797,1,170,1025,1195,0.16585365853658537
2797,2,1213,490,1703,2.475510204081633
2797,3,1712,610,2322,2.8065573770491805
2797,4,2332,280,2612,8.32857142857143
2797,5,2625,452,3077,5.807522123893805
2797,6,3087,419,3506,7.3675417661097855
2797,7,3564,408,3972,8.735294117647058
2797,8,4001,257,4258,15.568093385214008
2797,9,4310,632,4942,6.819620253164557
2797,10,4967,961,5928,5.168574401664932
2797,11,6009,524,6533,11.467557251908397
2797,12,6688,946,7634,7.069767441860465
2798,1,52,1080,1132,0.04814814814814815
2798,2,1140,568,1708,2.007042253521127
2798,3,1729,1058,2787,1.6342155009451795
2798,4,2795,561,3356,4.982174688057041
2799,1,841,818,1659,1.028117359413203
2799,2,1675,542,2217,3.0904059040590406
2799,3,2233,612,2845,3.6486928104575163
2799,4,2869,887,3756,3.234498308906426
2799,5,3772,870,4642,4.335632183908046
2799,6,4658,866,5524,5.378752886836028
2799,7,5540,433,5973,12.79445727482679
2799,8,5989,562,6551,10.65658362989324
2799,9,6581,631,7212,10.429477020602219
2799,10,7228,584,7812,12.376712328767123
2800,1,1057,621,1678,1.7020933977455717
2800,2,1731,778,2509,2.2249357326478147
2801,1,8,873,881,0.009163802978235968
2802,1,81,396,477,0.20454545454545456
2802,2,546,800,1346,0.6825
2803,1,1365,455,1820,3.0
2804,1,16,598,614,0.026755852842809364
2805,1,185,324,509,0.5709876543209876
2805,2,535,334,869,1.6017964071856288
2806,1,307,454,761,0.6762114537444934
2807,1,327,366,693,0.8934426229508197
2807,2,696,168,864,4.142857142857143
2808,1,9,269,278,0.03345724907063197
2808,2,289,278,567,1.039568345323741
2808,3,576,149,725,3.865771812080537
2808,4,728,341,1069,2.134897360703812
2808,5,1072,294,1366,3.6462585034013606
2808,6,1369,200,1569,6.845
2809,1,25,615,640,0.04065040650406504
2810,1,62,470,532,0.13191489361702127
2810,2,631,524,1155,1.2041984732824427
2810,3,1183,265,1448,4.464150943396226
2810,4,1468,475,1943,3.090526315789474
2810,5,1952,774,2726,2.5219638242894056
2810,6,2734,546,3280,5.007326007326007
2811,1,19,326,345,0.05828220858895705
2811,2,371,81,452,4.580246913580247
2811,3,474,113,587,4.1946902654867255
2811,4,605,511,1116,1.1839530332681019
2811,5,1145,715,1860,1.6013986013986015
2812,1,13,227,240,0.05726872246696035
2812,2,246,196,442,1.2551020408163265
2813,1,1260,828,2088,1.5217391304347827
2813,2,2209,1051,3260,2.1018078020932447
2814,1,68,882,950,0.07709750566893424
2814,2,1720,784,2504,2.193877551020408
2814,3,2577,569,3146,4.528998242530756
2814,4,3221,637,3858,5.056514913657771
2814,5,3931,602,4533,6.529900332225914
2814,6,4613,683,5296,6.75402635431918
2814,7,5374,822,6196,6.537712895377129
2814,8,6269,578,6847,10.846020761245676
2815,1,81,830,911,0.09759036144578313
2815,2,932,583,1515,1.5986277873070327
2815,3,1541,844,2385,1.8258293838862558
2815,4,2434,720,3154,3.3805555555555555
2815,5,3193,722,3915,4.422437673130194
2815,6,3927,560,4487,7.0125
2815,7,4507,917,5424,4.914940021810251
2816,1,44,605,649,0.07272727272727272
2816,2,668,608,1276,1.0986842105263157
2816,3,1290,641,1931,2.012480499219969
2817,1,110,777,887,0.14157014157014158
2817,2,897,603,1500,1.4875621890547264
2817,3,1522,738,2260,2.062330623306233
2818,1,16,408,424,0.0392156862745098
2819,1,96,935,1031,0.10267379679144385
2819,2,1141,1074,2215,1.0623836126629422
2819,3,2365,1085,3450,2.1797235023041477
2819,4,3458,777,4235,4.45045045045045
2819,5,4308,969,5277,4.445820433436532
2819,6,5403,1053,6456,5.131054131054131
2819,7,6562,888,7450,7.38963963963964
2820,1,133,466,599,0.2854077253218884
2820,2,768,778,1546,0.987146529562982
2820,3,1571,916,2487,1.715065502183406
2821,1,522,401,923,1.3017456359102244
2822,1,57,27,84,2.111111111111111
2822,2,1713,396,2109,4.325757575757576
2822,3,3339,379,3718,8.810026385224274
2822,4,5461,401,5862,13.618453865336658
2823,1,40,962,1002,0.04158004158004158
2823,2,1029,584,1613,1.7619863013698631
2823,3,1616,893,2509,1.8096304591265397
2823,4,2530,757,3287,3.342140026420079
2823,5,3296,422,3718,7.81042654028436
2823,6,3731,967,4698,3.858324715615305
2823,7,4701,914,5615,5.143326039387309
2824,1,133,1040,1173,0.12788461538461537
2824,2,1177,778,1955,1.512853470437018
2824,3,2094,3,2097,698.0
2825,1,212,195,407,1.087179487179487
2826,1,19,484,503,0.03925619834710744
2827,1,92,432,524,0.21296296296296297
2828,1,415,931,1346,0.44575725026852847
2828,2,1531,923,2454,1.658721560130011
2828,3,2538,938,3476,2.7057569296375266
2828,4,3560,932,4492,3.819742489270386
2828,5,4603,554,5157,8.308664259927799
2828,6,5213,938,6151,5.5575692963752665
2828,7,6292,622,6914,10.115755627009646
2828,8,7028,779,7807,9.021822849807446
2829,1,398,28,426,14.214285714285714
2829,2,884,363,1247,2.435261707988981
2829,3,1295,344,1639,3.76453488372093
2829,4,1649,397,2046,4.153652392947103
2829,5,2080,534,2614,3.8951310861423223
2829,6,2652,546,3198,4.857142857142857
2829,7,3229,489,3718,6.603271983640082
2829,8,3749,108,3857,34.71296296296296
2829,9,4182,417,4599,10.028776978417266
2829,10,4623,392,5015,11.793367346938776
2829,11,5043,340,5383,14.83235294117647
2829,12,5447,414,5861,13.157004830917874
2829,13,5870,372,6242,15.779569892473118
2829,14,6772,680,7452,9.958823529411765
2829,15,7488,591,8079,12.67005076142132
2830,1,84,597,681,0.1407035175879397
2830,2,733,1000,1733,0.733
2830,3,1749,454,2203,3.852422907488987
2830,4,2226,952,3178,2.338235294117647
2830,5,3180,376,3556,8.457446808510639
2830,6,3597,855,4452,4.207017543859649
2830,7,4480,603,5083,7.429519071310116
2831,1,71,29,100,2.4482758620689653
2831,2,650,135,785,4.814814814814815
2831,3,2232,11,2243,202.9090909090909
2831,4,2327,338,2665,6.884615384615385
2831,5,2684,336,3020,7.988095238095238
2831,6,3035,211,3246,14.383886255924171
2831,7,3274,359,3633,9.119777158774374
2831,8,3638,328,3966,11.091463414634147
2831,9,3971,217,4188,18.29953917050691
2832,1,214,9,223,23.77777777777778
2832,2,231,8,239,28.875
2832,3,352,10,362,35.2
2832,4,391,8,399,48.875
2832,5,512,23,535,22.26086956521739
2832,6,547,26,573,21.03846153846154
2832,7,956,49,1005,19.510204081632654
2832,8,1014,8,1022,126.75
2832,9,1135,25,1160,45.4
2832,10,1177,25,1202,47.08
2832,11,1446,91,1537,15.89010989010989
2832,12,1574,8,1582,196.75
2832,13,1695,28,1723,60.535714285714285
2832,14,1729,27,1756,64.03703703703704
2832,15,2240,138,2378,16.231884057971016
2832,16,2411,8,2419,301.375
2832,17,2532,31,2563,81.6774193548387
2832,18,2577,25,2602,103.08
2832,19,2839,143,2982,19.853146853146853
2832,20,2991,8,2999,373.875
2832,21,3112,8,3120,389.0
2832,22,3183,10,3193,318.3
2832,23,3252,47,3299,69.19148936170212
2832,24,3308,47,3355,70.38297872340425
2832,25,3859,222,4081,17.382882882882882
2833,1,55,856,911,0.06425233644859812
2833,2,934,596,1530,1.5671140939597314
2833,3,1562,338,1900,4.621301775147929
2833,4,1918,407,2325,4.712530712530713
2833,5,2345,615,2960,3.813008130081301
2833,6,2984,352,3336,8.477272727272727
2833,7,3376,477,3853,7.077568134171908
2833,8,3906,284,4190,13.753521126760564
2833,9,4227,743,4970,5.689098250336474
2833,10,5042,374,5416,13.481283422459892
2834,1,103,374,477,0.27540106951871657
2834,2,499,503,1002,0.9920477137176938
2835,1,54,219,273,0.2465753424657534
2836,1,27,986,1013,0.02738336713995943
2837,1,78,463,541,0.16846652267818574
2837,2,576,1000,1576,0.576
2837,3,1591,918,2509,1.733115468409586
2837,4,2533,691,3224,3.6657018813314037
2837,5,3261,972,4233,3.3549382716049383
2837,6,4248,39,4287,108.92307692307692
2837,7,4315,996,5311,4.332329317269076
2837,8,5328,764,6092,6.973821989528796
2837,9,6148,300,6448,20.493333333333332
2837,10,6510,882,7392,7.380952380952381
2838,1,138,4,142,34.5
2838,2,446,4,450,111.5
2838,3,457,19,476,24.05263157894737
2838,4,643,4,647,160.75
2838,5,682,727,1409,0.938101788170564
2838,6,1540,369,1909,4.173441734417344
2839,1,374,986,1360,0.3793103448275862
2839,2,1366,129,1495,10.589147286821705
2839,3,1544,208,1752,7.423076923076923
2840,1,29,69,98,0.42028985507246375
2840,2,112,42,154,2.6666666666666665
2840,3,163,106,269,1.5377358490566038
2840,4,279,130,409,2.146153846153846
2840,5,419,39,458,10.743589743589743
2840,6,470,46,516,10.217391304347826
2840,7,537,57,594,9.421052631578947
2840,8,604,39,643,15.487179487179487
2840,9,669,93,762,7.193548387096774
2840,10,773,53,826,14.584905660377359
2840,11,855,87,942,9.827586206896552
2840,12,954,39,993,24.46153846153846
2840,13,1038,52,1090,19.96153846153846
2840,14,1105,77,1182,14.35064935064935
2840,15,1210,58,1268,20.862068965517242
2840,16,1285,69,1354,18.6231884057971
2840,17,1378,89,1467,15.48314606741573
2840,18,1516,102,1618,14.862745098039216
2840,19,1659,538,2197,3.08364312267658
2840,20,2225,104,2329,21.39423076923077
2840,21,2337,62,2399,37.693548387096776
2840,22,2428,165,2593,14.715151515151515
2840,23,2615,127,2742,20.590551181102363
2840,24,2761,69,2830,40.01449275362319
2840,25,2847,247,3094,11.526315789473685
2840,26,3123,211,3334,14.800947867298579
2840,27,3354,459,3813,7.30718954248366
2840,28,3863,139,4002,27.79136690647482
2840,29,4040,388,4428,10.412371134020619
2840,30,4461,107,4568,41.691588785046726
2840,31,4607,105,4712,43.87619047619047
2840,32,4735,217,4952,21.820276497695854
2840,33,4997,116,5113,43.077586206896555
2840,34,5133,122,5255,42.07377049180328
2840,35,5276,121,5397,43.603305785123965
2840,36,5440,194,5634,28.04123711340206
2840,37,5662,118,5780,47.983050847457626
2840,38,5791,223,6014,25.968609865470853
2840,39,6038,32,6070,188.6875
2840,40,6083,62,6145,98.11290322580645
2840,41,6156,71,6227,86.70422535211267
2840,42,6244,73,6317,85.53424657534246
2841,1,21,94,115,0.22340425531914893
2841,2,139,58,197,2.396551724137931
2841,3,246,282,528,0.8723404255319149
2842,1,83,2384,2467,0.03481543624161074
2842,2,2670,2468,5138,1.0818476499189627
2843,1,100,669,769,0.14947683109118087
2843,2,887,557,1444,1.59245960502693
2843,3,1522,526,2048,2.893536121673004
2844,1,74,443,517,0.1670428893905192
2844,2,538,487,1025,1.104722792607803
2844,3,1040,1008,2048,1.0317460317460319
2844,4,2051,560,2611,3.6625
2844,5,2633,776,3409,3.393041237113402
2845,1,461,280,741,1.6464285714285714
2846,1,45,643,688,0.06998444790046657
2846,2,727,664,1391,1.0948795180722892
2847,1,69,463,532,0.1490280777537797
2848,1,490,821,1311,0.5968331303288672
2848,2,1327,629,1956,2.109697933227345
2848,3,1965,12,1977,163.75
2848,4,1987,597,2584,3.3283082077051924
2848,5,2599,747,3346,3.4792503346720216
2848,6,3354,16,3370,209.625
2849,1,26,742,768,0.03504043126684636
2849,2,797,29,826,27.482758620689655
2849,3,2158,566,2724,3.812720848056537
2849,4,2739,914,3653,2.9967177242888403
2849,5,3667,138,3805,26.57246376811594
2849,6,3824,580,4404,6.593103448275862
2849,7,4430,590,5020,7.508474576271187
2849,8,5135,617,5752,8.322528363047002
2849,9,5767,536,6303,10.759328358208956
2850,1,18,641,659,0.028081123244929798
2850,2,687,555,1242,1.2378378378378379
2851,1,1356,531,1887,2.553672316384181
2851,2,1903,472,2375,4.031779661016949
2851,3,2395,779,3174,3.0744544287548137
2851,4,3315,812,4127,4.082512315270936
2852,1,25,683,708,0.036603221083455345
2852,2,782,842,1624,0.9287410926365796
2852,3,1633,302,1935,5.4072847682119205
2852,4,2021,844,2865,2.3945497630331753
2852,5,2872,338,3210,8.497041420118343
2853,1,18,111,129,0.16216216216216217
2853,2,144,440,584,0.32727272727272727
2853,3,597,102,699,5.852941176470588
2853,4,1804,159,1963,11.345911949685535
2853,5,1975,704,2679,2.805397727272727
2853,6,2692,389,3081,6.920308483290489
2854,1,7,66,73,0.10606060606060606
2855,1,27,491,518,0.054989816700611
2856,1,73,501,574,0.14570858283433133
2856,2,597,495,1092,1.206060606060606
2856,3,1158,507,1665,2.2840236686390534
2856,4,1700,789,2489,2.1546261089987326
2856,5,2515,463,2978,5.431965442764579
2857,1,16,1768,1784,0.00904977375565611
2857,2,1882,713,2595,2.6395511921458628
2857,3,2682,2028,4710,1.3224852071005917
2858,1,408,975,1383,0.41846153846153844
2859,1,35,1018,1053,0.0343811394891945
2859,2,1056,576,1632,1.8333333333333333
2859,3,1642,1072,2714,1.5317164179104477
2859,4,2726,225,2951,12.115555555555556
2859,5,3003,704,3707,4.265625
2859,6,3720,209,3929,17.79904306220096
2859,7,4074,281,4355,14.498220640569395
2859,8,4482,271,4753,16.538745387453876
2859,9,4765,395,5160,12.063291139240507
2859,10,5584,313,5897,17.840255591054312
2859,11,5918,137,6055,43.197080291970806
2860,1,25,565,590,0.04424778761061947
2861,1,262,129,391,2.0310077519379846
2861,2,949,176,1125,5.392045454545454
2861,3,1131,141,1272,8.02127659574468
2861,4,1278,312,1590,4.096153846153846
2861,5,1596,496,2092,3.217741935483871
2861,6,2103,264,2367,7.965909090909091
2861,7,2381,104,2485,22.89423076923077
2861,8,2498,641,3139,3.8970358814352575
2861,9,3145,499,3644,6.302605210420841
2861,10,3650,712,4362,5.126404494382022
2861,11,4368,538,4906,8.118959107806692
2861,12,4912,767,5679,6.404172099087353
2861,13,5685,540,6225,10.527777777777779
2861,14,6231,848,7079,7.347877358490566
2861,15,7085,222,7307,31.914414414414413
2862,1,17,592,609,0.028716216216216218
2863,1,45,714,759,0.06302521008403361
2864,1,1242,908,2150,1.36784140969163
2865,1,444,403,847,1.1017369727047146
2865,2,1274,395,1669,3.2253164556962024
2866,1,468,675,1143,0.6933333333333334
2866,2,1193,742,1935,1.6078167115902966
2866,3,2143,755,2898,2.83841059602649
2866,4,2927,439,3366,6.667425968109339
2866,5,3376,364,3740,9.274725274725276
2866,6,3833,233,4066,16.450643776824034
2866,7,4076,169,4245,24.118343195266274
2866,8,4255,3,4258,1418.3333333333333
2867,1,50,777,827,0.06435006435006435
2868,1,844,1326,2170,0.6365007541478129
2868,2,2229,1796,4025,1.2410913140311803
2868,3,4136,1957,6093,2.113438937148697
2868,4,6226,1788,8014,3.482102908277405
2869,1,45,643,688,0.06998444790046657
2869,2,727,664,1391,1.0948795180722892
2869,3,1408,422,1830,3.3364928909952605
2870,1,65,840,905,0.07738095238095238
2871,1,142,89,231,1.595505617977528
2871,2,316,510,826,0.6196078431372549
2871,3,880,389,1269,2.2622107969151672
2871,4,1549,525,2074,2.9504761904761905
2872,1,32,672,704,0.047619047619047616
2872,2,722,737,1459,0.9796472184531886
2872,3,1474,803,2277,1.8356164383561644
2872,4,2294,625,2919,3.6704
2872,5,2953,423,3376,6.9810874704491725
2872,6,3410,51,3461,66.86274509803921
2872,7,3533,880,4413,4.014772727272727
2872,8,4463,28,4491,159.39285714285714
2872,9,4544,936,5480,4.854700854700854
2872,10,5482,303,5785,18.09240924092409
2872,11,5803,419,6222,13.84964200477327
2872,12,6235,420,6655,14.845238095238095
2872,13,6668,385,7053,17.31948051948052
2872,14,7070,354,7424,19.971751412429377
2873,1,24,636,660,0.03773584905660377
2873,2,691,687,1378,1.0058224163027656
2873,3,1408,582,1990,2.4192439862542954
2873,4,2006,240,2246,8.358333333333333
2873,5,2272,532,2804,4.2706766917293235
2873,6,2826,740,3566,3.8189189189189188
2873,7,3574,390,3964,9.164102564102564
2873,8,3987,274,4261,14.55109489051095
2873,9,5059,305,5364,16.58688524590164
2873,10,5383,137,5520,39.29197080291971
2873,11,6170,85,6255,72.58823529411765
2873,12,6272,130,6402,48.246153846153845
2873,13,6453,225,6678,28.68
2873,14,6698,229,6927,29.24890829694323
2873,15,6963,183,7146,38.049180327868854
2873,16,7174,170,7344,42.2
2873,17,7360,179,7539,41.11731843575419
2873,18,7557,467,8024,16.182012847965737
2874,1,57,411,468,0.1386861313868613
2874,2,497,565,1062,0.879646017699115
2875,1,33,565,598,0.0584070796460177
2875,2,648,1036,1684,0.6254826254826255
2875,3,1725,998,2723,1.7284569138276553
2876,1,879,1117,1996,0.7869292748433303
2876,2,2094,1120,3214,1.8696428571428572
2876,3,3266,1137,4403,2.872471416007036
2876,4,4487,988,5475,4.541497975708502
2876,5,5507,709,6216,7.767277856135402
2877,1,16,102,118,0.1568627450980392
2877,2,138,91,229,1.5164835164835164
2877,3,261,235,496,1.1106382978723404
2877,4,519,147,666,3.5306122448979593
2877,5,685,65,750,10.538461538461538
2877,6,772,131,903,5.893129770992366
2877,7,930,93,1023,10.0
2877,8,1033,119,1152,8.680672268907562
2878,1,156,198,354,0.7878787878787878
2879,1,16,527,543,0.030360531309297913
2879,2,550,535,1085,1.02803738317757
2879,3,1094,520,1614,2.103846153846154
2879,4,1618,314,1932,5.1528662420382165
2880,1,13,425,438,0.03058823529411765
2880,2,462,344,806,1.3430232558139534
2880,3,837,499,1336,1.6773547094188377
2880,4,1348,619,1967,2.1777059773828755
2880,5,1983,518,2501,3.828185328185328
2881,1,21,418,439,0.050239234449760764
2881,2,469,309,778,1.5177993527508091
2881,3,798,370,1168,2.156756756756757
2882,1,55,513,568,0.10721247563352826
2882,2,625,391,1016,1.5984654731457801
2882,3,1036,57,1093,18.17543859649123
2882,4,1209,363,1572,3.330578512396694
2883,1,390,380,770,1.0263157894736843
2883,2,773,390,1163,1.9820512820512821
2883,3,1166,367,1533,3.1771117166212535
2883,4,1536,385,1921,3.9896103896103896
2883,5,1934,201,2135,9.621890547263682
2884,1,442,929,1371,0.4757804090419806
2884,2,1824,940,2764,1.9404255319148935
2884,3,3078,488,3566,6.307377049180328
2884,4,3899,511,4410,7.63013698630137
2884,5,4742,510,5252,9.298039215686275
2884,6,5642,681,6323,8.284875183553599
2884,7,6614,791,7405,8.361567635903919
2885,1,31,501,532,0.06187624750499002
2885,2,567,541,1108,1.0480591497227356
2885,3,1127,829,1956,1.3594692400482509
2885,4,1983,726,2709,2.731404958677686
2885,5,2758,685,3443,4.026277372262774
2885,6,3472,308,3780,11.272727272727273
2885,7,3801,292,4093,13.017123287671232
2885,8,4121,479,4600,8.603340292275574
2885,9,4607,46,4653,100.15217391304348
2886,1,892,489,1381,1.8241308793456033
2886,2,1593,203,1796,7.847290640394089
2887,1,344,699,1043,0.49213161659513593
2888,1,133,12,145,11.083333333333334
2888,2,288,13,301,22.153846153846153
2888,3,406,478,884,0.8493723849372385
2889,1,137,1182,1319,0.11590524534686972
2889,2,1344,1128,2472,1.1914893617021276
2889,3,2477,1152,3629,2.150173611111111
2890,1,1082,113,1195,9.575221238938052
2890,2,1211,42,1253,28.833333333333332
2890,3,1391,35,1426,39.74285714285714
2890,4,1441,226,1667,6.376106194690266
2890,5,1682,183,1865,9.191256830601093
2890,6,1884,136,2020,13.852941176470589
2890,7,2037,290,2327,7.024137931034483
2890,8,2338,683,3021,3.4231332357247437
2890,9,3038,447,3485,6.796420581655481
2891,1,962,101,1063,9.524752475247524
2892,1,93,33,126,2.8181818181818183
2893,1,22,579,601,0.037996545768566495
2893,2,611,218,829,2.802752293577982
2893,3,842,762,1604,1.10498687664042
2893,4,1622,555,2177,2.9225225225225224
2893,5,2193,527,2720,4.161290322580645
2893,6,2735,593,3328,4.612141652613828
2893,7,3341,43,3384,77.69767441860465
2893,8,3396,46,3442,73.82608695652173
2894,1,141,425,566,0.33176470588235296
2895,1,55,470,525,0.11702127659574468
2896,1,26,428,454,0.06074766355140187
2897,1,21,506,527,0.041501976284584984
2897,2,2646,1055,3701,2.5080568720379146
2897,3,3722,791,4513,4.70543615676359
2897,4,4539,1018,5557,4.458742632612966
2898,1,194,553,747,0.3508137432188065
2898,2,847,772,1619,1.0971502590673574
2898,3,1627,523,2150,3.1108986615678775
2898,4,2202,529,2731,4.162570888468809
2898,5,2746,580,3326,4.73448275862069
2898,6,3371,672,4043,5.0163690476190474
2898,7,4057,628,4685,6.460191082802548
2898,8,4730,785,5515,6.025477707006369
2898,9,5552,947,6499,5.8627243928194295
2898,10,6608,605,7213,10.922314049586777
2898,11,7261,410,7671,17.709756097560977
2899,1,163,954,1117,0.1708595387840671
2899,2,1153,1007,2160,1.1449851042701091
2899,3,2202,997,3199,2.208625877632899
2899,4,3236,1042,4278,3.105566218809981
2899,5,4312,892,5204,4.834080717488789
2899,6,5239,939,6178,5.579339723109691
2899,7,6215,836,7051,7.434210526315789
2899,8,7083,792,7875,8.943181818181818
2900,1,83,318,401,0.2610062893081761
2900,2,427,287,714,1.4878048780487805
2900,3,740,249,989,2.9718875502008033
2900,4,1122,323,1445,3.473684210526316
2900,5,1471,311,1782,4.729903536977492
2900,6,1865,322,2187,5.791925465838509
2900,7,2213,342,2555,6.470760233918129
2900,8,2581,94,2675,27.45744680851064
2900,9,2946,275,3221,10.712727272727273
2900,10,3247,270,3517,12.025925925925925
2900,11,3610,242,3852,14.917355371900827
2900,12,3873,320,4193,12.103125
2900,13,4454,162,4616,27.493827160493826
2900,14,4664,147,4811,31.727891156462587
2900,15,5245,329,5574,15.94224924012158
2900,16,5595,204,5799,27.426470588235293
2900,17,6053,292,6345,20.72945205479452
2900,18,6366,163,6529,39.05521472392638
2900,19,6563,50,6613,131.26
2900,20,6774,289,7063,23.439446366782008
2900,21,7084,146,7230,48.52054794520548
2900,22,7326,303,7629,24.178217821782177
2901,1,105,505,610,0.2079207920792079
2901,2,692,125,817,5.536
2901,3,879,615,1494,1.4292682926829268
2902,1,39,738,777,0.052845528455284556
2902,2,784,371,1155,2.1132075471698113
2903,1,11,957,968,0.011494252873563218
2903,2,971,114,1085,8.517543859649123
2903,3,1135,580,1715,1.956896551724138
2903,4,1744,847,2591,2.0590318772136955
2904,1,3001,1079,4080,2.7812789620018536
2905,1,30,890,920,0.033707865168539325
2906,1,144,96,240,1.5
2906,2,285,717,1002,0.39748953974895396
2906,3,1021,543,1564,1.8802946593001841
2906,4,1576,710,2286,2.219718309859155
2906,5,2299,438,2737,5.248858447488584
2906,6,2749,172,2921,15.982558139534884
2906,7,2931,461,3392,6.357917570498915
2906,8,3401,305,3706,11.150819672131147
2906,9,3748,572,4320,6.5524475524475525
2906,10,4364,637,5001,6.850863422291994
2906,11,5015,242,5257,20.723140495867767
2907,1,43,462,505,0.09307359307359307
2907,2,528,597,1125,0.8844221105527639
2907,3,1132,441,1573,2.566893424036281
2907,4,1613,697,2310,2.3142037302725966
2907,5,2335,224,2559,10.424107142857142
2907,6,2588,374,2962,6.919786096256685
2907,7,3004,536,3540,5.604477611940299
2908,1,39,967,1006,0.04033092037228542
2908,2,1025,991,2016,1.0343087790110999
2908,3,2037,718,2755,2.8370473537604455
2908,4,2765,700,3465,3.95
2908,5,3475,988,4463,3.5172064777327936
2908,6,4475,982,5457,4.557026476578411
2908,7,5462,964,6426,5.66597510373444
2908,8,6435,993,7428,6.480362537764351
2909,1,58,983,1041,0.059003051881993895
2910,1,43,1295,1338,0.033204633204633204
2910,2,1354,389,1743,3.480719794344473
2910,3,1814,103,1917,17.611650485436893
2910,4,1978,402,2380,4.920398009950249
2910,5,2495,134,2629,18.619402985074625
2910,6,3589,1049,4638,3.421353670162059
2911,1,28,269,297,0.10408921933085502
2911,2,326,504,830,0.6468253968253969
2911,3,951,732,1683,1.2991803278688525
2911,4,1858,844,2702,2.2014218009478674
2911,5,2864,783,3647,3.657726692209451
2911,6,3824,642,4466,5.956386292834891
2911,7,4515,673,5188,6.708766716196137
2911,8,5213,728,5941,7.160714285714286
2911,9,5958,808,6766,7.373762376237623
2911,10,6771,531,7302,12.751412429378531
2912,1,45,763,808,0.05897771952817824
2912,2,819,412,1231,1.9878640776699028
2912,3,1255,461,1716,2.72234273318872
2912,4,1731,414,2145,4.181159420289855
2912,5,2148,432,2580,4.972222222222222
2912,6,2583,380,2963,6.7973684210526315
2912,7,2966,417,3383,7.112709832134293
2912,8,3386,259,3645,13.073359073359073
2912,9,3648,293,3941,12.450511945392492
2912,10,3964,444,4408,8.927927927927929
2912,11,4411,462,4873,9.547619047619047
2912,12,4881,392,5273,12.451530612244898
2912,13,5287,489,5776,10.811860940695297
2912,14,5779,326,6105,17.726993865030675
2912,15,6113,302,6415,20.241721854304636
2912,16,6428,331,6759,19.419939577039276
2912,17,6762,310,7072,21.81290322580645
2912,18,7075,307,7382,23.04560260586319
2912,19,7402,301,7703,24.591362126245848
2912,20,7706,296,8002,26.033783783783782
2913,1,325,952,1277,0.34138655462184875
2913,2,1402,284,1686,4.936619718309859
2913,3,1815,414,2229,4.384057971014493
2913,4,2406,372,2778,6.467741935483871
2913,5,2879,398,3277,7.233668341708543
2913,6,3387,141,3528,24.02127659574468
2913,7,3582,477,4059,7.509433962264151
2914,1,1636,626,2262,2.6134185303514377
2915,1,69,781,850,0.088348271446863
2916,1,20,76,96,0.2631578947368421
2916,2,163,124,287,1.314516129032258
2917,1,1822,33,1855,55.21212121212121
2917,2,2964,33,2997,89.81818181818181
2917,3,4049,35,4084,115.68571428571428
2917,4,4904,35,4939,140.11428571428573
2917,5,5776,35,5811,165.02857142857144
2917,6,7067,31,7098,227.96774193548387
2917,7,7125,396,7521,17.992424242424242
2918,1,763,325,1088,2.3476923076923075
2918,2,1103,328,1431,3.3628048780487805
2919,1,19,688,707,0.027616279069767442
2919,2,721,1041,1762,0.6926032660902978
2920,1,303,336,639,0.9017857142857143
2920,2,921,303,1224,3.0396039603960396
2920,3,1990,308,2298,6.461038961038961
2920,4,3232,434,3666,7.447004608294931
2921,1,15,391,406,0.03836317135549872
2921,2,420,62,482,6.774193548387097
2921,3,487,110,597,4.427272727272728
2921,4,633,84,717,7.535714285714286
2921,5,722,56,778,12.892857142857142
2921,6,783,62,845,12.629032258064516
2921,7,852,60,912,14.2
2921,8,919,57,976,16.12280701754386
2921,9,985,64,1049,15.390625
2921,10,1053,56,1109,18.803571428571427
2921,11,1119,63,1182,17.761904761904763
2921,12,1189,58,1247,20.5
2921,13,1254,62,1316,20.225806451612904
2921,14,1323,57,1380,23.210526315789473
2921,15,1387,59,1446,23.508474576271187
2921,16,1484,112,1596,13.25
2922,1,3546,2,3548,1773.0
2922,2,3636,132,3768,27.545454545454547
2922,3,3814,274,4088,13.91970802919708
2922,4,4149,113,4262,36.716814159292035
2922,5,4302,108,4410,39.833333333333336
2922,6,4456,81,4537,55.01234567901235
2923,1,37,273,310,0.13553113553113552
2924,1,53,45,98,1.1777777777777778
2924,2,113,38,151,2.973684210526316
2924,3,885,411,1296,2.153284671532847
2924,4,1596,167,1763,9.55688622754491
2924,5,1973,139,2112,14.194244604316546
2924,6,2359,131,2490,18.00763358778626
2924,7,2711,148,2859,18.31756756756757
2925,1,160,918,1078,0.17429193899782136
2925,2,1096,583,1679,1.8799313893653515
2925,3,1738,935,2673,1.8588235294117648
2925,4,2690,415,3105,6.481927710843373
2925,5,3168,591,3759,5.3604060913705585
2925,6,3846,297,4143,12.94949494949495
2925,7,4252,942,5194,4.51380042462845
2925,8,5202,947,6149,5.493136219640972
2925,9,6157,645,6802,9.545736434108527
2925,10,6857,942,7799,7.279193205944798
2926,1,95,550,645,0.17272727272727273
2926,2,697,714,1411,0.9761904761904762
2926,3,1434,317,1751,4.523659305993691
2926,4,1800,187,1987,9.62566844919786
2927,1,112,313,425,0.35782747603833864
2927,2,570,366,936,1.5573770491803278
2928,1,36,599,635,0.06010016694490818
2928,2,653,557,1210,1.1723518850987433
2928,3,1228,583,1811,2.106346483704974
2928,4,1911,747,2658,2.5582329317269075
2928,5,2713,552,3265,4.9148550724637685
2928,6,3402,428,3830,7.9485981308411215
2928,7,3949,507,4456,7.788954635108481
2929,1,17,542,559,0.03136531365313653
2929,2,618,449,1067,1.376391982182628
2929,3,1100,447,1547,2.460850111856823
2929,4,1596,462,2058,3.4545454545454546
2929,5,2097,344,2441,6.09593023255814
2929,6,2506,485,2991,5.167010309278351
2929,7,3108,346,3454,8.982658959537572
2929,8,3480,551,4031,6.315789473684211
2929,9,4094,605,4699,6.7669421487603305
2929,10,4726,445,5171,10.620224719101124
2929,11,5236,606,5842,8.64026402640264
2930,1,97,618,715,0.156957928802589
2931,1,96,935,1031,0.10267379679144385
2931,2,1141,1074,2215,1.0623836126629422
2931,3,2365,1085,3450,2.1797235023041477
2931,4,3458,777,4235,4.45045045045045
2931,5,4308,969,5277,4.445820433436532
2931,6,5403,1053,6456,5.131054131054131
2931,7,6562,888,7450,7.38963963963964
2932,1,91,739,830,0.12313937753721245
2933,1,1096,667,1763,1.6431784107946028
2934,1,44,534,578,0.08239700374531835
2934,2,601,457,1058,1.3150984682713347
2934,3,1065,493,1558,2.160243407707911
2934,4,1563,475,2038,3.2905263157894735
2934,5,2056,505,2561,4.071287128712871
2934,6,2578,471,3049,5.473460721868365
2934,7,3064,578,3642,5.301038062283737
2935,1,104,440,544,0.23636363636363636
2935,2,565,386,951,1.4637305699481866
2935,3,978,600,1578,1.63
2935,4,1635,345,1980,4.739130434782608
2935,5,2024,443,2467,4.568848758465012
2935,6,2499,382,2881,6.541884816753926
2935,7,2899,402,3301,7.211442786069652
2935,8,3377,415,3792,8.137349397590361
2935,9,4017,797,4814,5.040150564617315
2935,10,4828,1142,5970,4.227670753064799
2936,1,124,92,216,1.3478260869565217
2936,2,221,106,327,2.0849056603773586
2936,3,332,166,498,2.0
2936,4,508,67,575,7.582089552238806
2936,5,583,217,800,2.686635944700461
2936,6,808,98,906,8.244897959183673
2936,7,962,319,1281,3.0156739811912225
2936,8,1302,105,1407,12.4
2937,1,8,614,622,0.013029315960912053
2938,1,413,913,1326,0.452354874041621
2938,2,1360,1005,2365,1.3532338308457712
2938,3,2399,868,3267,2.763824884792627
2938,4,3301,477,3778,6.920335429769392
2939,1,378,463,841,0.816414686825054
2940,1,4455,284,4739,15.68661971830986
2941,1,390,378,768,1.0317460317460319
2942,1,26,760,786,0.034210526315789476
2943,1,48,1002,1050,0.04790419161676647
2943,2,1103,463,1566,2.3822894168466524
2943,3,1614,725,2339,2.2262068965517243
2943,4,2405,968,3373,2.4845041322314048
2943,5,3412,1006,4418,3.3916500994035785
2943,6,4456,1015,5471,4.390147783251232
2943,7,5553,1028,6581,5.401750972762646
2944,1,43,460,503,0.09347826086956522
2944,2,513,349,862,1.4699140401146131
2945,1,63,455,518,0.13846153846153847
2945,2,521,338,859,1.5414201183431953
2945,3,873,387,1260,2.255813953488372
2945,4,1316,331,1647,3.97583081570997
2945,5,1650,312,1962,5.288461538461538
2946,1,829,98,927,8.459183673469388
2947,1,51,225,276,0.22666666666666666
2947,2,424,313,737,1.354632587859425
2947,3,760,33,793,23.03030303030303
2947,4,801,224,1025,3.575892857142857
2947,5,1074,163,1237,6.588957055214724
2947,6,1286,139,1425,9.251798561151078
2947,7,1870,655,2525,2.854961832061069
2947,8,2567,728,3295,3.526098901098901
2947,9,3310,134,3444,24.70149253731343
2947,10,3479,930,4409,3.7408602150537633
2948,1,18,414,432,0.043478260869565216
2949,1,33,1581,1614,0.020872865275142316
2950,1,168,209,377,0.8038277511961722
2950,2,488,270,758,1.8074074074074074
2950,3,904,758,1662,1.1926121372031662
2950,4,1772,95,1867,18.652631578947368
2950,5,1912,123,2035,15.544715447154472
2950,6,2156,375,2531,5.749333333333333
2950,7,2666,378,3044,7.052910052910053
2950,8,3084,77,3161,40.05194805194805
2950,9,3174,47,3221,67.53191489361703
2950,10,3287,79,3366,41.607594936708864
2950,11,3397,114,3511,29.79824561403509
2950,12,3571,129,3700,27.68217054263566
2950,13,3734,67,3801,55.73134328358209
2950,14,3817,50,3867,76.34
2951,1,36,503,539,0.07157057654075547
2951,2,595,509,1104,1.168958742632613
2951,3,1168,467,1635,2.501070663811563
2951,4,1682,466,2148,3.609442060085837
2951,5,2177,610,2787,3.5688524590163935
2951,6,2801,535,3336,5.235514018691589
2951,7,3346,443,3789,7.553047404063205
2952,1,116,276,392,0.42028985507246375
2953,1,70,307,377,0.2280130293159609
2953,2,384,389,773,0.987146529562982
2954,1,2776,469,3245,5.918976545842217
2954,2,3410,627,4037,5.43859649122807
2954,3,4046,51,4097,79.33333333333333
2954,4,4109,73,4182,56.28767123287671
2955,1,63,53,116,1.1886792452830188
2955,2,1082,816,1898,1.3259803921568627
2955,3,2518,70,2588,35.97142857142857
2955,4,3218,20,3238,160.9
2955,5,3249,611,3860,5.317512274959084
2955,6,3915,528,4443,7.4147727272727275
2955,7,4481,530,5011,8.454716981132075
2955,8,5455,468,5923,11.655982905982906
2955,9,6093,163,6256,37.38036809815951
2956,1,11,433,444,0.025404157043879907
2956,2,462,455,917,1.0153846153846153
2956,3,948,241,1189,3.933609958506224
2956,4,1219,462,1681,2.6385281385281387
2956,5,1712,188,1900,9.106382978723405
2957,1,29,852,881,0.03403755868544601
2957,2,890,598,1488,1.4882943143812708
2957,3,1548,851,2399,1.8190364277320799
2957,4,2630,955,3585,2.7539267015706805
2957,5,3593,970,4563,3.7041237113402063
2957,6,4570,316,4886,14.462025316455696
2957,7,4979,983,5962,5.065106815869786
2957,8,5986,588,6574,10.180272108843537
2958,1,96,76,172,1.263157894736842
2958,2,289,59,348,4.898305084745763
2958,3,766,308,1074,2.487012987012987
2958,4,1080,306,1386,3.5294117647058822
2958,5,1392,192,1584,7.25
2958,6,1689,293,1982,5.764505119453925
2958,7,2100,297,2397,7.070707070707071
2958,8,2403,222,2625,10.824324324324325
2959,1,885,807,1692,1.096654275092937
2960,1,8,787,795,0.010165184243964422
2961,1,84,517,601,0.16247582205029013
2961,2,609,248,857,2.4556451612903225
2961,3,863,323,1186,2.671826625386997
2962,1,60,582,642,0.10309278350515463
2962,2,678,525,1203,1.2914285714285714
2962,3,1305,630,1935,2.0714285714285716
2962,4,2185,668,2853,3.2709580838323356
2962,5,3140,791,3931,3.969658659924147
2962,6,4068,569,4637,7.1493848857644995
2962,7,4739,601,5340,7.885191347753744
2962,8,5382,659,6041,8.166919575113809
2963,1,941,1008,1949,0.933531746031746
2963,2,2054,684,2738,3.002923976608187
2964,1,90,422,512,0.2132701421800948
2964,2,558,458,1016,1.2183406113537119
2965,1,47,639,686,0.07355242566510173
2965,2,723,534,1257,1.353932584269663
2966,1,83,394,477,0.21065989847715735
2966,2,489,373,862,1.3109919571045576
2966,3,873,345,1218,2.5304347826086957
2966,4,1275,464,1739,2.747844827586207
2966,5,1741,254,1995,6.854330708661418
2966,6,2051,360,2411,5.697222222222222
2966,7,2413,358,2771,6.740223463687151
2966,8,2791,600,3391,4.651666666666666
2966,9,3511,578,4089,6.07439446366782
2966,10,4106,986,5092,4.164300202839756
2966,11,5096,38,5134,134.10526315789474
2967,1,30,64,94,0.46875
2967,2,99,94,193,1.053191489361702
2967,3,201,93,294,2.161290322580645
2967,4,308,90,398,3.422222222222222
2967,5,403,83,486,4.855421686746988
2967,6,501,94,595,5.329787234042553
2967,7,603,260,863,2.3192307692307694
2967,8,878,87,965,10.091954022988507
2967,9,986,97,1083,10.164948453608247
2967,10,1096,213,1309,5.145539906103286
2967,11,1324,730,2054,1.8136986301369864
2968,1,4,360,364,0.011111111111111112
2968,2,366,354,720,1.0338983050847457
2968,3,723,129,852,5.604651162790698
2968,4,889,185,1074,4.805405405405406
2968,5,1113,256,1369,4.34765625
2968,6,1459,239,1698,6.104602510460251
2968,7,1772,231,2003,7.670995670995671
2968,8,2073,226,2299,9.172566371681416
2968,9,2363,227,2590,10.409691629955947
2968,10,2652,424,3076,6.254716981132075
2968,11,3081,653,3734,4.71822358346095
2968,12,3736,59,3795,63.32203389830509
2969,1,497,215,712,2.311627906976744
2969,2,746,170,916,4.3882352941176475
2970,1,45,14,59,3.2142857142857144
2970,2,85,19,104,4.473684210526316
2970,3,116,114,230,1.0175438596491229
2970,4,250,70,320,3.5714285714285716
2971,1,543,239,782,2.271966527196653
2971,2,791,181,972,4.370165745856354
2972,1,44,369,413,0.11924119241192412
2972,2,423,309,732,1.3689320388349515
2973,1,246,573,819,0.4293193717277487
2973,2,999,681,1680,1.4669603524229076
2973,3,1744,840,2584,2.0761904761904764
2973,4,2616,804,3420,3.253731343283582
2973,5,3600,789,4389,4.562737642585551
2973,6,4500,856,5356,5.257009345794392
2973,7,5446,43,5489,126.65116279069767
2973,8,5552,416,5968,13.346153846153847
2973,9,5975,787,6762,7.592121982210927
2973,10,6811,653,7464,10.43032159264931
2974,1,98,803,901,0.12204234122042341
2975,1,359,1018,1377,0.3526522593320236
2975,2,1410,380,1790,3.710526315789474
2976,1,91,243,334,0.37448559670781895
2976,2,621,491,1112,1.264765784114053
2977,1,417,273,690,1.5274725274725274
2977,2,718,621,1339,1.1561996779388084
2978,1,34,563,597,0.06039076376554174
2978,2,607,618,1225,0.982200647249191
2978,3,1282,602,1884,2.129568106312292
2979,1,9,224,233,0.04017857142857143
2979,2,263,285,548,0.9228070175438596
2979,3,573,285,858,2.0105263157894737
2979,4,927,189,1116,4.904761904761905
2979,5,1222,76,1298,16.07894736842105
2980,1,152,581,733,0.26161790017211706
2980,2,737,828,1565,0.8900966183574879
2980,3,1569,487,2056,3.2217659137577
2980,4,2060,754,2814,2.7320954907161803
2980,5,2832,778,3610,3.640102827763496
2980,6,3659,661,4320,5.535552193645991
2980,7,4324,99,4423,43.676767676767675
2980,8,4426,13,4439,340.46153846153845
2980,9,4591,824,5415,5.571601941747573
2980,10,5419,780,6199,6.947435897435898
2980,11,6203,705,6908,8.798581560283688
2981,1,55,126,181,0.4365079365079365
2981,2,193,115,308,1.6782608695652175
2981,3,1483,130,1613,11.407692307692308
2981,4,1629,179,1808,9.100558659217876
2982,1,26,793,819,0.03278688524590164
2982,2,1603,1034,2637,1.5502901353965184
2982,3,2653,855,3508,3.1029239766081873
2982,4,3560,1020,4580,3.4901960784313726
2982,5,4596,588,5184,7.816326530612245
2983,1,346,40,386,8.65
2984,1,20,925,945,0.021621621621621623
2984,2,969,590,1559,1.6423728813559322
2984,3,1585,768,2353,2.0638020833333335
2984,4,2381,909,3290,2.6193619361936196
2984,5,3293,939,4232,3.50692225772098
2984,6,4235,299,4534,14.163879598662207
2984,7,4555,476,5031,9.569327731092438
2984,8,5041,246,5287,20.491869918699187
2985,1,261,2,263,130.5
2985,2,360,291,651,1.2371134020618557
2986,1,78,685,763,0.11386861313868613
2987,1,66,716,782,0.09217877094972067
2987,2,856,15,871,57.06666666666667
2987,3,941,970,1911,0.9701030927835051
2987,4,1983,25,2008,79.32
2987,5,2082,9,2091,231.33333333333334
2987,6,2118,443,2561,4.781038374717833
2987,7,2660,26,2686,102.3076923076923
2987,8,2784,226,3010,12.31858407079646
2987,9,3036,496,3532,6.120967741935484
2987,10,3548,510,4058,6.956862745098039
2987,11,4086,396,4482,10.318181818181818
2987,12,4520,93,4613,48.60215053763441
2987,13,4657,881,5538,5.286038592508513
2987,14,5582,34,5616,164.1764705882353
2987,15,5642,83,5725,67.97590361445783
2987,16,5770,226,5996,25.530973451327434
2987,17,6070,678,6748,8.952802359882005
2987,18,6806,547,7353,12.442413162705668
2987,19,7517,481,7998,15.627858627858627
2988,1,118,31,149,3.806451612903226
2988,2,794,39,833,20.358974358974358
2988,3,862,440,1302,1.959090909090909
2988,4,1683,418,2101,4.026315789473684
2988,5,2224,645,2869,3.448062015503876
2988,6,2922,346,3268,8.445086705202312
2988,7,3311,364,3675,9.096153846153847
2988,8,4268,80,4348,53.35
2988,9,4421,151,4572,29.278145695364238
2988,10,4628,344,4972,13.453488372093023
2988,11,4986,435,5421,11.462068965517242
2988,12,5489,304,5793,18.05592105263158
2988,13,5937,400,6337,14.8425
2988,14,6416,159,6575,40.35220125786164
2988,15,6710,562,7272,11.93950177935943
2989,1,311,51,362,6.098039215686274
2989,2,1114,95,1209,11.726315789473684
2989,3,1562,114,1676,13.701754385964913
2989,4,2104,19,2123,110.73684210526316
2989,5,2160,93,2253,23.225806451612904
2989,6,2458,134,2592,18.34328358208955
2989,7,2640,187,2827,14.117647058823529
2989,8,2981,217,3198,13.737327188940093
2989,9,3230,154,3384,20.974025974025974
2989,10,3410,444,3854,7.68018018018018
2989,11,3873,339,4212,11.424778761061948
2989,12,4229,203,4432,20.832512315270936
2989,13,4477,190,4667,23.563157894736843
2989,14,4698,85,4783,55.27058823529412
2989,15,5026,224,5250,22.4375
2989,16,5356,153,5509,35.00653594771242
2989,17,5630,39,5669,144.35897435897436
2989,18,5789,38,5827,152.3421052631579
2989,19,6100,118,6218,51.69491525423729
2989,20,6428,167,6595,38.49101796407186
2989,21,6858,158,7016,43.40506329113924
2989,22,7057,160,7217,44.10625
2989,23,7240,133,7373,54.43609022556391
2989,24,7398,186,7584,39.774193548387096
2989,25,7647,187,7834,40.893048128342244
2990,1,99,549,648,0.18032786885245902
2990,2,683,645,1328,1.0589147286821705
2990,3,1347,488,1835,2.7602459016393444
2990,4,1853,453,2306,4.0905077262693155
2990,5,2344,371,2715,6.318059299191375
2990,6,2741,445,3186,6.159550561797753
2990,7,3222,503,3725,6.405566600397615
2990,8,3834,790,4624,4.853164556962025
2990,9,4643,513,5156,9.050682261208577
2990,10,5194,619,5813,8.390953150242327
2990,11,5842,470,6312,12.429787234042553
2991,1,374,40,414,9.35
2991,2,492,112,604,4.392857142857143
2991,3,611,146,757,4.184931506849315
2991,4,763,179,942,4.262569832402234
2991,5,946,211,1157,4.483412322274882
2992,1,24,85,109,0.2823529411764706
2992,2,143,198,341,0.7222222222222222
2992,3,353,211,564,1.6729857819905214
2993,1,17,451,468,0.037694013303769404
2994,1,22,605,627,0.03636363636363636
2994,2,635,519,1154,1.2235067437379576
2995,1,60,778,838,0.07712082262210797
2995,2,849,819,1668,1.0366300366300367
2995,3,1716,917,2633,1.871319520174482
2995,4,2648,520,3168,5.092307692307692
2995,5,3251,858,4109,3.789044289044289
2995,6,4205,786,4991,5.349872773536895
2995,7,5079,852,5931,5.961267605633803
2995,8,5947,639,6586,9.306729264475743
2996,1,158,432,590,0.36574074074074076
2997,1,672,55,727,12.218181818181819
2997,2,1005,139,1144,7.23021582733813
2997,3,1799,274,2073,6.565693430656935
2997,4,2354,305,2659,7.718032786885246
2997,5,2698,183,2881,14.743169398907105
2997,6,3380,331,3711,10.211480362537765
2997,7,3751,389,4140,9.6426735218509
2997,8,6267,897,7164,6.986622073578595
2997,9,7259,645,7904,11.254263565891472
2998,1,51,20,71,2.55
2998,2,73,20,93,3.65
2998,3,108,36,144,3.0
2998,4,180,44,224,4.090909090909091
2998,5,231,29,260,7.9655172413793105
2998,6,281,33,314,8.515151515151516
2998,7,354,70,424,5.057142857142857
2998,8,437,39,476,11.205128205128204
2998,9,515,90,605,5.722222222222222
2998,10,633,441,1074,1.435374149659864
2999,1,28,687,715,0.040756914119359534
3000,1,33,683,716,0.048316251830161056
3000,2,720,797,1517,0.903387703889586
3000,3,1525,712,2237,2.1418539325842696
3000,4,2247,743,2990,3.024226110363392
3001,1,25,910,935,0.027472527472527472
3002,1,47,530,577,0.08867924528301886
3003,1,15,370,385,0.04054054054054054
3003,2,427,472,899,0.9046610169491526
3003,3,922,118,1040,7.813559322033898
3003,4,1086,104,1190,10.442307692307692
3003,5,1202,70,1272,17.17142857142857
3003,6,1307,73,1380,17.904109589041095
3003,7,1405,147,1552,9.5578231292517
3003,8,1571,63,1634,24.936507936507937
3003,9,1650,102,1752,16.176470588235293
3003,10,1777,142,1919,12.514084507042254
3003,11,1950,158,2108,12.341772151898734
3003,12,2148,160,2308,13.425
3003,13,2328,79,2407,29.468354430379748
3003,14,2464,72,2536,34.22222222222222
3003,15,2565,487,3052,5.26694045174538
3003,16,3107,252,3359,12.329365079365079
3004,1,2406,929,3335,2.589881593110872
3005,1,377,601,978,0.627287853577371
3006,1,31,448,479,0.06919642857142858
3006,2,490,39,529,12.564102564102564
3006,3,555,465,1020,1.1935483870967742
3006,4,1055,296,1351,3.564189189189189
3007,1,36,349,385,0.10315186246418338
3007,2,421,346,767,1.216763005780347
3007,3,803,332,1135,2.4186746987951806
3007,4,1171,792,1963,1.4785353535353536
3007,5,2008,907,2915,2.2138919514884234
3007,6,2978,897,3875,3.319955406911929
3007,7,3886,376,4262,10.335106382978724
3007,8,4306,321,4627,13.414330218068535
3007,9,4676,178,4854,26.269662921348313
3008,1,110,529,639,0.20793950850661624
3008,2,686,515,1201,1.3320388349514563
3008,3,1260,585,1845,2.1538461538461537
3008,4,1893,128,2021,14.7890625
3008,5,2137,244,2381,8.758196721311476
3008,6,2499,360,2859,6.941666666666666
3008,7,2878,214,3092,13.448598130841122
3008,8,3143,246,3389,12.776422764227643
3008,9,3462,262,3724,13.213740458015268
3008,10,3849,692,4541,5.562138728323699
3009,1,205,330,535,0.6212121212121212
3010,1,23,116,139,0.19827586206896552
3010,2,201,420,621,0.4785714285714286
3010,3,660,225,885,2.933333333333333
3010,4,976,633,1609,1.5418641390205372
3010,5,1648,277,1925,5.949458483754513
3010,6,2063,510,2573,4.045098039215686
3010,7,2686,815,3501,3.2957055214723927
3010,8,4163,626,4789,6.6501597444089455
3010,9,4835,589,5424,8.208828522920204
3010,10,5447,830,6277,6.562650602409638
3010,11,6742,726,7468,9.286501377410469
3011,1,29,669,698,0.043348281016442454
3011,2,709,538,1247,1.3178438661710037
3011,3,1267,491,1758,2.580448065173116
3011,4,1784,286,2070,6.2377622377622375
3011,5,2110,574,2684,3.6759581881533103
3011,6,2716,447,3163,6.076062639821029
3011,7,3175,835,4010,3.802395209580838
3011,8,4034,747,4781,5.400267737617135
3011,9,4805,1041,5846,4.615754082612872
3011,10,5882,866,6748,6.7921478060046185
3011,11,6772,793,7565,8.539722572509458
3012,1,142,327,469,0.43425076452599387
3013,1,158,559,717,0.2826475849731664
3013,2,745,457,1202,1.6301969365426696
3013,3,1264,298,1562,4.241610738255034
3014,1,172,359,531,0.479108635097493
3014,2,646,566,1212,1.1413427561837455
3014,3,1229,183,1412,6.715846994535519
3014,4,1660,537,2197,3.091247672253259
3014,5,2202,353,2555,6.237960339943343
3014,6,2570,639,3209,4.021909233176839
3014,7,3227,289,3516,11.166089965397925
3014,8,3523,319,3842,11.043887147335424
3014,9,3850,480,4330,8.020833333333334
3015,1,23,322,345,0.07142857142857142
3015,2,376,465,841,0.8086021505376344
3016,1,32,661,693,0.048411497730711045
3016,2,729,643,1372,1.1337480559875583
3017,1,111,680,791,0.16323529411764706
3017,2,811,289,1100,2.8062283737024223
3018,1,62,313,375,0.19808306709265175
3018,2,400,496,896,0.8064516129032258
3019,1,14,304,318,0.046052631578947366
3019,2,332,250,582,1.328
3020,1,32,326,358,0.09815950920245399
3021,1,170,653,823,0.26033690658499237
3021,2,849,186,1035,4.564516129032258
3021,3,1049,564,1613,1.8599290780141844
3021,4,1657,506,2163,3.274703557312253
3021,5,2209,564,2773,3.9166666666666665
3021,6,2792,493,3285,5.663286004056795
3021,7,3411,637,4048,5.354788069073783
3021,8,4065,649,4714,6.263482280431433
3022,1,73,275,348,0.26545454545454544
3023,1,11,37,48,0.2972972972972973
3023,2,1852,46,1898,40.26086956521739
3023,3,1918,88,2006,21.795454545454547
3023,4,2021,512,2533,3.947265625
3023,5,2549,536,3085,4.755597014925373
3023,6,3108,551,3659,5.64065335753176
3023,7,3674,995,4669,3.692462311557789
3023,8,4677,376,5053,12.438829787234043
3023,9,5101,491,5592,10.389002036659878
3023,10,5694,502,6196,11.342629482071713
3023,11,6204,591,6795,10.49746192893401
3023,12,6803,809,7612,8.409147095179234
3023,13,7620,473,8093,16.109936575052853
3024,1,47,858,905,0.054778554778554776
3024,2,2551,427,2978,5.97423887587822
3024,3,3137,1067,4204,2.9400187441424555
3024,4,4218,1016,5234,4.1515748031496065
3024,5,5288,204,5492,25.92156862745098
3024,6,5539,418,5957,13.251196172248804
3024,7,6032,426,6458,14.15962441314554
3024,8,6513,804,7317,8.100746268656716
3024,9,7372,534,7906,13.805243445692884
3025,1,1056,595,1651,1.7747899159663865
3025,2,1690,955,2645,1.7696335078534031
3025,3,2672,180,2852,14.844444444444445
3025,4,2862,895,3757,3.1977653631284917
3025,5,3781,930,4711,4.065591397849462
3025,6,4714,188,4902,25.074468085106382
3025,7,4973,261,5234,19.053639846743295
3025,8,5251,169,5420,31.071005917159763
3025,9,5460,215,5675,25.3953488372093
3025,10,5696,296,5992,19.243243243243242
3025,11,6036,344,6380,17.546511627906977
3025,12,6413,317,6730,20.230283911671926
3025,13,7020,515,7535,13.631067961165048
3025,14,7583,140,7723,54.16428571428571
3026,1,18,470,488,0.03829787234042553
3027,1,38,78,116,0.48717948717948717
3027,2,148,167,315,0.8862275449101796
3027,3,341,147,488,2.3197278911564627
3027,4,517,183,700,2.8251366120218577
3028,1,860,405,1265,2.123456790123457
3028,2,2358,491,2849,4.802443991853361
3028,3,3710,363,4073,10.22038567493113
3029,1,60,367,427,0.16348773841961853
3030,1,27,608,635,0.044407894736842105
3030,2,692,562,1254,1.2313167259786477
3030,3,1351,675,2026,2.0014814814814814
3030,4,2047,729,2776,2.8079561042524004
3030,5,2810,582,3392,4.828178694158075
3030,6,3419,599,4018,5.707846410684474
3030,7,4029,716,4745,5.627094972067039
3030,8,4780,852,5632,5.610328638497653
3031,1,79,469,548,0.16844349680170576
3031,2,558,686,1244,0.8134110787172012
3031,3,1263,117,1380,10.794871794871796
3031,4,1457,172,1629,8.470930232558139
3031,5,1633,283,1916,5.770318021201414
3031,6,1930,223,2153,8.654708520179373
3031,7,2189,359,2548,6.0974930362116995
3031,8,2584,311,2895,8.308681672025724
3031,9,2946,190,3136,15.505263157894737
3031,10,3244,355,3599,9.138028169014085
3031,11,3684,182,3866,20.24175824175824
3032,1,44,533,577,0.0825515947467167
3032,2,599,339,938,1.766961651917404
3032,3,1373,678,2051,2.0250737463126844
3032,4,2251,1007,3258,2.2353525322740815
3032,5,3343,74,3417,45.17567567567568
3032,6,3529,1027,4556,3.436222005842259
3032,7,4575,137,4712,33.394160583941606
3032,8,4725,1048,5773,4.508587786259542
3032,9,5789,671,6460,8.6274217585693
3032,10,6479,127,6606,51.01574803149607
3032,11,6637,998,7635,6.650300601202405
3033,1,1547,1070,2617,1.4457943925233645
3033,2,2619,430,3049,6.090697674418605
3033,3,3068,682,3750,4.4985337243401755
3033,4,3759,11,3770,341.72727272727275
3033,5,3811,681,4492,5.596182085168869
3033,6,4509,672,5181,6.709821428571429
3033,7,5194,677,5871,7.672082717872969
3033,8,5898,752,6650,7.843085106382978
3033,9,6659,628,7287,10.603503184713375
3033,10,7289,829,8118,8.792521109770808
3034,1,10,293,303,0.034129692832764506
3034,2,318,569,887,0.5588752196836555
3035,1,14,307,321,0.04560260586319218
3035,2,332,645,977,0.5147286821705427
3035,3,987,348,1335,2.836206896551724
3035,4,1405,585,1990,2.4017094017094016
3036,1,38,733,771,0.05184174624829468
3036,2,809,568,1377,1.4242957746478873
3036,3,1389,927,2316,1.4983818770226538
3036,4,2331,354,2685,6.584745762711864
3036,5,2695,433,3128,6.224018475750578
3036,6,3152,703,3855,4.483641536273115
3036,7,3873,977,4850,3.9641760491299896
3036,8,4980,836,5816,5.956937799043062
3036,9,5839,759,6598,7.693017127799736
3036,10,6640,485,7125,13.690721649484535
3036,11,7212,785,7997,9.187261146496816
3037,1,8,78,86,0.10256410256410256
3037,2,99,544,643,0.18198529411764705
3037,3,652,197,849,3.3096446700507616
3037,4,889,436,1325,2.0389908256880735
3037,5,1379,558,1937,2.471326164874552
3038,1,791,816,1607,0.9693627450980392
3038,2,1633,814,2447,2.006142506142506
3038,3,2478,161,2639,15.391304347826088
3038,4,2690,925,3615,2.908108108108108
3038,5,3651,585,4236,6.241025641025641
3038,6,4353,451,4804,9.651884700665189
3039,1,112,487,599,0.2299794661190965
3039,2,620,536,1156,1.1567164179104477
3039,3,1179,713,1892,1.6535764375876578
3039,4,1931,660,2591,2.925757575757576
3039,5,2624,313,2937,8.383386581469649
3039,6,2966,737,3703,4.024423337856174
3040,1,48,880,928,0.05454545454545454
3040,2,952,763,1715,1.2477064220183487
3041,1,969,708,1677,1.36864406779661
3042,1,52,360,412,0.14444444444444443
3043,1,32,515,547,0.062135922330097085
3043,2,616,1752,2368,0.3515981735159817
3044,1,401,423,824,0.9479905437352246
3044,2,836,406,1242,2.0591133004926108
3044,3,1264,404,1668,3.128712871287129
3044,4,1730,347,2077,4.985590778097983
3044,5,2797,450,3247,6.2155555555555555
3044,6,3290,469,3759,7.014925373134329
3044,7,3789,73,3862,51.9041095890411
3044,8,4118,335,4453,12.292537313432836
3044,9,5295,517,5812,10.241779497098646
3044,10,5900,414,6314,14.251207729468598
3045,1,93,28,121,3.3214285714285716
3045,2,2503,31,2534,80.74193548387096
3045,3,3127,365,3492,8.567123287671233
3045,4,3526,69,3595,51.10144927536232
3045,5,5999,130,6129,46.146153846153844
3045,6,6545,106,6651,61.74528301886792
3045,7,6723,47,6770,143.04255319148936
3045,8,6780,365,7145,18.575342465753426
3045,9,7191,685,7876,10.497810218978103
3045,10,7911,2,7913,3955.5
3046,1,111,359,470,0.30919220055710306
3046,2,472,364,836,1.2967032967032968
3046,3,838,369,1207,2.2710027100271004
3046,4,1231,333,1564,3.6966966966966965
3046,5,1566,353,1919,4.436260623229462
3046,6,1921,334,2255,5.751497005988024
3046,7,2257,326,2583,6.923312883435583
3047,1,112,738,850,0.15176151761517614
3048,1,79,627,706,0.12599681020733652
3048,2,806,790,1596,1.0202531645569621
3048,3,1655,791,2446,2.092288242730721
3048,4,2603,825,3428,3.1551515151515153
3048,5,3430,825,4255,4.157575757575757
3048,6,4299,833,5132,5.160864345738295
3048,7,5142,234,5376,21.974358974358974
3048,8,5540,398,5938,13.919597989949748
3048,9,5952,612,6564,9.72549019607843
3048,10,6625,410,7035,16.158536585365855
3048,11,7042,856,7898,8.226635514018692
3048,12,7903,22,7925,359.22727272727275
3049,1,6220,345,6565,18.028985507246375
3049,2,6586,272,6858,24.21323529411765
3049,3,7257,190,7447,38.194736842105264
3049,4,7455,284,7739,26.25
3049,5,7791,349,8140,22.32378223495702
3050,1,688,805,1493,0.8546583850931677
3050,2,1863,463,2326,4.023758099352052
3050,3,2503,27,2530,92.70370370370371
3050,4,5703,644,6347,8.855590062111801
3050,5,6368,936,7304,6.803418803418803
3050,6,7347,154,7501,47.70779220779221
3051,1,30,807,837,0.03717472118959108
3052,1,45,4,49,11.25
3052,2,55,4,59,13.75
3052,3,73,4,77,18.25
3052,4,98,4,102,24.5
3052,5,127,72,199,1.7638888888888888
3053,1,91,608,699,0.14967105263157895
3053,2,716,390,1106,1.8358974358974358
3053,3,1122,363,1485,3.090909090909091
3053,4,1500,612,2112,2.450980392156863
3053,5,2180,698,2878,3.1232091690544412
3053,6,2899,816,3715,3.5526960784313726
3053,7,3824,964,4788,3.966804979253112
3053,8,4796,123,4919,38.99186991869919
3053,9,5010,994,6004,5.040241448692153
3053,10,6012,242,6254,24.84297520661157
3054,1,48,460,508,0.10434782608695652
3054,2,532,204,736,2.607843137254902
3055,1,204,939,1143,0.21725239616613418
3056,1,34,904,938,0.03761061946902655
3057,1,45,867,912,0.05190311418685121
3058,1,137,762,899,0.17979002624671916
3058,2,926,501,1427,1.8483033932135728
3058,3,1447,459,1906,3.1525054466230937
3059,1,2172,35,2207,62.05714285714286
3059,2,3819,216,4035,17.680555555555557
3059,3,4112,745,4857,5.519463087248322
3059,4,4895,340,5235,14.397058823529411
3059,5,6038,678,6716,8.905604719764012
3059,6,6745,82,6827,82.2560975609756
3059,7,7051,401,7452,17.58354114713217
3059,8,7454,203,7657,36.7192118226601
3059,9,7687,167,7854,46.02994011976048
3059,10,7881,33,7914,238.8181818181818
3059,11,7964,7,7971,1137.7142857142858
3060,1,78,969,1047,0.0804953560371517
3060,2,1055,525,1580,2.0095238095238095
3061,1,24,495,519,0.048484848484848485
3061,2,527,369,896,1.4281842818428185
3061,3,906,485,1391,1.868041237113402
3061,4,1399,526,1925,2.659695817490494
3061,5,1946,522,2468,3.7279693486590038
3061,6,2847,195,3042,14.6
3061,7,3047,452,3499,6.741150442477876
3061,8,3504,474,3978,7.3924050632911396
3061,9,3981,467,4448,8.524625267665954
3061,10,4451,542,4993,8.212177121771218
3061,11,4999,490,5489,10.20204081632653
3061,12,5494,347,5841,15.832853025936599
3061,13,5848,550,6398,10.632727272727273
3061,14,6406,504,6910,12.71031746031746
3061,15,6917,522,7439,13.25095785440613
3061,16,7452,460,7912,16.2
3062,1,19,332,351,0.0572289156626506
3062,2,409,1017,1426,0.40216322517207476
3062,3,1528,728,2256,2.098901098901099
3062,4,2389,624,3013,3.828525641025641
3062,5,3053,625,3678,4.8848
3062,6,3719,769,4488,4.836150845253576
3062,7,4564,710,5274,6.428169014084507
3062,8,5310,1021,6331,5.200783545543585
3062,9,6388,436,6824,14.65137614678899
3062,10,6901,601,7502,11.482529118136439
3063,1,22,121,143,0.18181818181818182
3064,1,23,493,516,0.04665314401622718
3065,1,25,691,716,0.0361794500723589
3065,2,725,472,1197,1.5360169491525424
3065,3,1209,475,1684,2.5452631578947367
3066,1,5359,585,5944,9.16068376068376
3067,1,94,961,1055,0.09781477627471384
3067,2,1063,990,2053,1.0737373737373737
3067,3,2072,779,2851,2.6598202824133503
3067,4,2980,956,3936,3.1171548117154813
3067,5,3944,934,4878,4.222698072805139
3068,1,111,887,998,0.12514092446448705
3068,2,1018,325,1343,3.1323076923076925
3068,3,1357,271,1628,5.007380073800738
3068,4,1661,169,1830,9.828402366863905
3068,5,1839,393,2232,4.679389312977099
3068,6,2251,673,2924,3.3447251114413077
3068,7,2980,921,3901,3.235613463626493
3068,8,3903,284,4187,13.742957746478874
3068,9,4230,499,4729,8.47695390781563
3068,10,4778,267,5045,17.89513108614232
3068,11,5069,944,6013,5.369703389830509
3068,12,6015,230,6245,26.152173913043477
3068,13,6256,350,6606,17.874285714285715
3068,14,6647,896,7543,7.418526785714286
3069,1,11,97,108,0.1134020618556701
3069,2,112,666,778,0.16816816816816818
3069,3,786,925,1711,0.8497297297297297
3070,1,34,682,716,0.04985337243401759
3071,1,17,215,232,0.07906976744186046
3071,2,247,413,660,0.5980629539951574
3071,3,1079,294,1373,3.6700680272108843
3071,4,1397,314,1711,4.449044585987261
3071,5,1713,261,1974,6.563218390804598
3071,6,2021,286,2307,7.066433566433567
3071,7,2309,391,2700,5.90537084398977
3071,8,2712,33,2745,82.18181818181819
3071,9,2758,95,2853,29.03157894736842
3072,1,12,424,436,0.02830188679245283
3072,2,452,617,1069,0.7325769854132901
3072,3,1087,632,1719,1.7199367088607596
3072,4,1730,286,2016,6.048951048951049
3072,5,2025,307,2332,6.596091205211726
3072,6,2353,485,2838,4.851546391752577
3072,7,2848,444,3292,6.414414414414415
3072,8,3312,184,3496,18.0
3072,9,3509,159,3668,22.069182389937108
3072,10,3683,219,3902,16.817351598173516
3072,11,3929,268,4197,14.66044776119403
3072,12,4216,674,4890,6.255192878338279
3072,13,4923,593,5516,8.30185497470489
3072,14,5538,396,5934,13.984848484848484
3072,15,5952,224,6176,26.571428571428573
3073,1,14,313,327,0.04472843450479233
3074,1,79,531,610,0.1487758945386064
3074,2,671,273,944,2.457875457875458
3074,3,983,384,1367,2.5598958333333335
3075,1,42,534,576,0.07865168539325842
3076,1,4694,199,4893,23.587939698492463
3076,2,7663,72,7735,106.43055555555556
3077,1,24,313,337,0.07667731629392971
3077,2,344,583,927,0.5900514579759862
3077,3,935,840,1775,1.1130952380952381
3078,1,59,690,749,0.08550724637681159
3078,2,775,777,1552,0.9974259974259975
3079,1,1658,602,2260,2.7541528239202657
3080,1,17,311,328,0.05466237942122187
3080,2,337,221,558,1.5248868778280542
3080,3,740,125,865,5.92
3080,4,877,138,1015,6.355072463768116
3080,5,1056,321,1377,3.289719626168224
3080,6,1795,319,2114,5.6269592476489025
3080,7,2133,337,2470,6.329376854599406
3080,8,2501,699,3200,3.5779685264663805
3081,1,23,424,447,0.054245283018867926
3082,1,1767,755,2522,2.3403973509933773
3082,2,2643,1083,3726,2.440443213296399
3082,3,3729,1196,4925,3.117892976588629
3083,1,343,11,354,31.181818181818183
3083,2,371,152,523,2.4407894736842106
3083,3,694,723,1417,0.9598893499308437
3083,4,1470,568,2038,2.5880281690140845
3083,5,2085,404,2489,5.160891089108911
3083,6,2585,551,3136,4.691470054446461
3083,7,3154,775,3929,4.069677419354838
3084,1,270,76,346,3.5526315789473686
3084,2,397,303,700,1.3102310231023102
3084,3,733,572,1305,1.2814685314685315
3084,4,1331,529,1860,2.5160680529300565
3084,5,1970,785,2755,2.5095541401273884
3084,6,2798,889,3687,3.1473565804274464
3085,1,905,103,1008,8.78640776699029
3085,2,1020,261,1281,3.9080459770114944
3085,3,1290,246,1536,5.2439024390243905
3085,4,1547,283,1830,5.46643109540636
3086,1,61,631,692,0.09667194928684628
3086,2,715,883,1598,0.8097395243488109
3086,3,1605,876,2481,1.832191780821918
3086,4,2505,366,2871,6.844262295081967
3087,1,22,847,869,0.025974025974025976
3087,2,887,1014,1901,0.8747534516765286
3087,3,1911,1029,2940,1.8571428571428572
3087,4,2959,903,3862,3.276854928017719
3087,5,3869,110,3979,35.17272727272727
3087,6,3992,151,4143,26.43708609271523
3088,1,18,205,223,0.08780487804878048
3088,2,297,406,703,0.7315270935960592
3089,1,9,831,840,0.010830324909747292
3089,2,853,465,1318,1.8344086021505377
3089,3,1328,888,2216,1.4954954954954955
3089,4,2229,832,3061,2.6790865384615383
3089,5,3104,983,4087,3.157680569684639
3089,6,4098,802,4900,5.109725685785536
3089,7,4914,978,5892,5.024539877300613
3089,8,5910,668,6578,8.847305389221557
3089,9,6591,684,7275,9.635964912280702
3090,1,26,251,277,0.10358565737051793
3090,2,297,354,651,0.8389830508474576
3090,3,673,380,1053,1.7710526315789474
3091,1,30,917,947,0.03271537622682661
3091,2,962,916,1878,1.0502183406113537
3092,1,1148,758,1906,1.5145118733509235
3092,2,3001,957,3958,3.135841170323929
3092,3,4010,672,4682,5.967261904761905
3092,4,4707,641,5348,7.343213728549142
3092,5,6611,104,6715,63.56730769230769
3092,6,6733,58,6791,116.08620689655173
3093,1,19,785,804,0.024203821656050957
3093,2,818,120,938,6.816666666666666
3093,3,953,485,1438,1.9649484536082473
3093,4,1533,768,2301,1.99609375
3093,5,2315,308,2623,7.516233766233766
3093,6,2639,55,2694,47.981818181818184
3093,7,2704,123,2827,21.983739837398375
3093,8,2850,120,2970,23.75
3093,9,2981,320,3301,9.315625
3093,10,3320,296,3616,11.216216216216216
3093,11,3634,425,4059,8.550588235294118
3093,12,4086,234,4320,17.46153846153846
3093,13,4369,230,4599,18.995652173913044
3093,14,4626,244,4870,18.959016393442624
3094,1,114,520,634,0.21923076923076923
3094,2,639,534,1173,1.196629213483146
3094,3,1178,534,1712,2.2059925093632957
3094,4,1717,517,2234,3.3210831721470018
3094,5,2239,511,2750,4.38160469667319
3094,6,2755,297,3052,9.276094276094277
3094,7,3288,597,3885,5.507537688442211
3094,8,3890,681,4571,5.7121879588839946
3094,9,4576,602,5178,7.601328903654485
3094,10,5248,619,5867,8.478190630048465
3094,11,5872,652,6524,9.006134969325153
3094,12,6529,315,6844,20.726984126984128
3094,13,6885,354,7239,19.449152542372882
3095,1,895,208,1103,4.302884615384615
3095,2,1111,84,1195,13.226190476190476
3095,3,1203,146,1349,8.23972602739726
3095,4,1351,338,1689,3.997041420118343
3095,5,1718,231,1949,7.437229437229437
3095,6,1957,112,2069,17.473214285714285
3095,7,2083,178,2261,11.702247191011235
3095,8,2269,139,2408,16.323741007194243
3095,9,2410,375,2785,6.426666666666667
3095,10,2801,194,2995,14.438144329896907
3095,11,3003,79,3082,38.0126582278481
3095,12,3094,231,3325,13.393939393939394
3095,13,3327,245,3572,13.579591836734695
3095,14,3587,315,3902,11.387301587301588
3095,15,3911,110,4021,35.554545454545455
3095,16,4051,325,4376,12.464615384615385
3095,17,4417,466,4883,9.478540772532188
3095,18,4893,420,5313,11.65
3095,19,5321,77,5398,69.1038961038961
3095,20,5414,258,5672,20.984496124031008
3095,21,5682,206,5888,27.58252427184466
3095,22,5896,226,6122,26.088495575221238
3095,23,6160,475,6635,12.968421052631578
3095,24,6659,416,7075,16.00721153846154
3095,25,7113,504,7617,14.113095238095237
3095,26,7627,148,7775,51.53378378378378
3096,1,51,26,77,1.9615384615384615
3096,2,99,167,266,0.592814371257485
3096,3,346,603,949,0.5737976782752903
3096,4,1080,191,1271,5.654450261780105
3096,5,1458,618,2076,2.3592233009708736
3096,6,2263,542,2805,4.175276752767528
3096,7,3035,775,3810,3.9161290322580644
3096,8,4005,634,4639,6.317034700315458
3096,9,4841,555,5396,8.722522522522523
3096,10,5489,404,5893,13.586633663366337
3096,11,5933,63,5996,94.17460317460318
3096,12,6034,60,6094,100.56666666666666
3096,13,6141,66,6207,93.04545454545455
3096,14,6254,53,6307,118.0
3096,15,6346,64,6410,99.15625
3096,16,6454,319,6773,20.231974921630094
3097,1,31,821,852,0.037758830694275276
3098,1,7,397,404,0.017632241813602016
3099,1,32,505,537,0.06336633663366337
3099,2,543,779,1322,0.6970474967907574
3099,3,1328,758,2086,1.7519788918205805
3099,4,2092,991,3083,2.1109989909182643
3099,5,3087,494,3581,6.248987854251012
3099,6,3598,532,4130,6.7631578947368425
3100,1,121,747,868,0.16198125836680052
3101,1,48,635,683,0.07559055118110236
3102,1,36,38,74,0.9473684210526315
3102,2,587,122,709,4.811475409836065
3102,3,744,591,1335,1.2588832487309645
3102,4,1348,698,2046,1.9312320916905443
3102,5,2059,1023,3082,2.0127077223851417
3102,6,3090,425,3515,7.270588235294118
3102,7,3537,962,4499,3.676715176715177
3102,8,4507,638,5145,7.064263322884012
3102,9,5194,773,5967,6.719275549805951
3103,1,12,143,155,0.08391608391608392
3103,2,171,337,508,0.5074183976261127
3103,3,537,71,608,7.563380281690141
3103,4,631,70,701,9.014285714285714
3103,5,852,154,1006,5.532467532467533
3103,6,1012,132,1144,7.666666666666667
3103,7,1415,211,1626,6.706161137440758
3103,8,1824,179,2003,10.189944134078212
3103,9,2009,65,2074,30.907692307692308
3103,10,2165,239,2404,9.05857740585774
3103,11,2415,615,3030,3.926829268292683
3104,1,64,26,90,2.4615384615384617
3104,2,329,496,825,0.6633064516129032
3104,3,1032,363,1395,2.84297520661157
3104,4,1468,431,1899,3.406032482598608
3104,5,2126,445,2571,4.777528089887641
3104,6,2991,241,3232,12.410788381742739
3104,7,3521,321,3842,10.968847352024921
3104,8,3894,253,4147,15.391304347826088
3104,9,4493,316,4809,14.218354430379748
3104,10,7758,312,8070,24.865384615384617
3105,1,102,179,281,0.5698324022346368
3105,2,284,163,447,1.7423312883435582
3105,3,452,204,656,2.215686274509804
3105,4,666,51,717,13.058823529411764
3105,5,726,108,834,6.722222222222222
3105,6,840,40,880,21.0
3105,7,888,75,963,11.84
3105,8,978,267,1245,3.662921348314607
3105,9,1270,465,1735,2.7311827956989245
3105,10,1807,100,1907,18.07
3105,11,1920,171,2091,11.228070175438596
3105,12,2217,173,2390,12.815028901734104
3105,13,2430,474,2904,5.1265822784810124
3105,14,2978,481,3459,6.1912681912681915
3105,15,3516,471,3987,7.464968152866242
3105,16,4046,397,4443,10.191435768261965
3105,17,4479,476,4955,9.409663865546218
3106,1,99,45,144,2.2
3106,2,150,89,239,1.6853932584269662
3106,3,334,436,770,0.7660550458715596
3106,4,793,241,1034,3.2904564315352696
3106,5,1077,446,1523,2.414798206278027
3107,1,1949,688,2637,2.832848837209302
3108,1,22,48,70,0.4583333333333333
3109,1,79,297,376,0.265993265993266
3109,2,469,655,1124,0.716030534351145
3109,3,1183,745,1928,1.5879194630872484
3110,1,62,355,417,0.17464788732394365
3110,2,430,169,599,2.544378698224852
3110,3,611,397,1008,1.5390428211586902
3111,1,2573,585,3158,4.398290598290599
3111,2,3170,539,3709,5.8812615955473095
3111,3,3723,596,4319,6.246644295302014
3111,4,4337,777,5114,5.581724581724582
3111,5,5129,848,5977,6.048349056603773
3111,6,6012,712,6724,8.4438202247191
3112,1,38,30,68,1.2666666666666666
3112,2,132,447,579,0.2953020134228188
3113,1,55,556,611,0.09892086330935251
3113,2,666,137,803,4.861313868613139
3113,3,1230,193,1423,6.373056994818653
3113,4,1442,587,2029,2.4565587734241907
3113,5,2060,568,2628,3.6267605633802815
3113,6,2649,911,3560,2.907793633369923
3113,7,4886,193,5079,25.316062176165804
3113,8,5102,234,5336,21.803418803418804
3113,9,5376,494,5870,10.882591093117409
3114,1,876,273,1149,3.208791208791209
3115,1,942,1152,2094,0.8177083333333334
3115,2,2142,1279,3421,1.6747458952306489
3115,3,6987,881,7868,7.930760499432463
3116,1,69,837,906,0.08243727598566308
3117,1,35,2018,2053,0.01734390485629336
3117,2,2105,1606,3711,1.3107098381070983
3118,1,36,194,230,0.18556701030927836
3118,2,234,224,458,1.0446428571428572
3118,3,486,439,925,1.1070615034168565
3118,4,939,175,1114,5.365714285714286
3118,5,1150,287,1437,4.006968641114983
3119,1,1052,212,1264,4.962264150943396
3119,2,1273,552,1825,2.306159420289855
3119,3,3393,126,3519,26.928571428571427
3119,4,3524,580,4104,6.075862068965518
3120,1,77,625,702,0.1232
3121,1,4350,995,5345,4.371859296482412
3122,1,95,538,633,0.17657992565055763
3122,2,728,537,1265,1.355679702048417
3122,3,1362,590,1952,2.3084745762711862
3122,4,1989,919,2908,2.1643090315560394
3123,1,252,155,407,1.6258064516129032
3123,2,410,218,628,1.8807339449541285
3123,3,644,204,848,3.156862745098039
3123,4,858,158,1016,5.430379746835443
3123,5,1027,155,1182,6.625806451612903
3124,1,11,230,241,0.04782608695652174
3124,2,249,219,468,1.1369863013698631
3124,3,485,125,610,3.88
3124,4,618,309,927,2.0
3124,5,934,168,1102,5.559523809523809
3124,6,1114,187,1301,5.957219251336898
3125,1,117,65,182,1.8
3125,2,279,118,397,2.364406779661017
3125,3,452,180,632,2.511111111111111
3125,4,656,200,856,3.28
3125,5,946,335,1281,2.8238805970149254
3125,6,1316,160,1476,8.225
3126,1,743,78,821,9.525641025641026
3126,2,908,466,1374,1.9484978540772533
3126,3,1438,457,1895,3.1466083150984683
3126,4,1968,706,2674,2.7875354107648724
3126,5,2721,881,3602,3.0885357548240635
3127,1,30,711,741,0.04219409282700422
3127,2,751,748,1499,1.0040106951871657
3128,1,126,683,809,0.18448023426061494
3128,2,848,368,1216,2.3043478260869565
3129,1,37,668,705,0.05538922155688623
3130,1,24,1040,1064,0.023076923076923078
3130,2,1123,1232,2355,0.911525974025974
3130,3,2401,2431,4832,0.9876593994241053
3130,4,4947,3058,8005,1.6177240026160888
3131,1,47,593,640,0.07925801011804384
3131,2,657,592,1249,1.1097972972972974
3131,3,1366,1020,2386,1.3392156862745097
3131,4,2488,1034,3522,2.4061895551257253
3132,1,31,529,560,0.05860113421550094
3132,2,1502,743,2245,2.0215343203230147
3132,3,2276,387,2663,5.881136950904393
3132,4,2685,1115,3800,2.408071748878924
3132,5,3815,997,4812,3.8264794383149447
3132,6,4825,997,5822,4.839518555667001
3132,7,5836,460,6296,12.68695652173913
3133,1,25,457,482,0.05470459518599562
3133,2,492,467,959,1.0535331905781584
3133,3,984,444,1428,2.2162162162162162
3133,4,1452,377,1829,3.8514588859416445
3133,5,1843,505,2348,3.6495049504950496
3133,6,2361,622,2983,3.7958199356913185
3133,7,2998,901,3899,3.327413984461709
3133,8,3918,664,4582,5.900602409638554
3133,9,4613,535,5148,8.622429906542056
3133,10,5161,657,5818,7.8554033485540335
3133,11,5837,699,6536,8.350500715307582
3133,12,6562,740,7302,8.867567567567567
3133,13,7333,466,7799,15.736051502145923
3134,1,60,155,215,0.3870967741935484
3135,1,204,531,735,0.384180790960452
3136,1,1979,881,2860,2.246311010215664
3136,2,2862,924,3786,3.0974025974025974
3136,3,3788,175,3963,21.645714285714284
3136,4,3964,43,4007,92.18604651162791
3137,1,62,3,65,20.666666666666668
3137,2,77,50,127,1.54
3137,3,155,3,158,51.666666666666664
3138,1,253,281,534,0.900355871886121
3139,1,93,764,857,0.12172774869109948
3139,2,933,549,1482,1.6994535519125684
3139,3,1573,891,2464,1.7654320987654322
3139,4,2471,615,3086,4.017886178861788
3139,5,3182,890,4072,3.5752808988764047
3139,6,4079,777,4856,5.24967824967825
3140,1,132,89,221,1.4831460674157304
3141,1,31,40,71,0.775
3141,2,90,189,279,0.47619047619047616
3141,3,288,130,418,2.2153846153846155
3141,4,434,135,569,3.214814814814815
3142,1,621,259,880,2.3976833976833976
3142,2,906,325,1231,2.787692307692308
3142,3,1253,87,1340,14.402298850574713
3142,4,1594,334,1928,4.772455089820359
3142,5,2073,972,3045,2.132716049382716
3142,6,3804,12,3816,317.0
3142,7,4163,10,4173,416.3
3142,8,4472,11,4483,406.54545454545456
3142,9,4501,598,5099,7.526755852842809
3142,10,5543,3,5546,1847.6666666666667
3142,11,6142,8,6150,767.75
3142,12,6176,232,6408,26.620689655172413
3142,13,6483,370,6853,17.521621621621623
3142,14,6864,250,7114,27.456
3142,15,7120,314,7434,22.67515923566879
3142,16,7439,215,7654,34.6
3143,1,19,369,388,0.051490514905149054
3144,1,236,567,803,0.41622574955908287
3144,2,864,643,1507,1.343701399688958
3144,3,1516,83,1599,18.265060240963855
3144,4,1612,248,1860,6.5
3145,1,58,418,476,0.13875598086124402
3145,2,727,329,1056,2.209726443768997
3145,3,1627,436,2063,3.731651376146789
3146,1,3456,304,3760,11.368421052631579
3146,2,3961,703,4664,5.634423897581792
3146,3,5617,102,5719,55.068627450980394
3146,4,6218,698,6916,8.908309455587393
3147,1,24,478,502,0.0502092050209205
3147,2,572,137,709,4.175182481751825
3147,3,888,390,1278,2.276923076923077
3147,4,1318,723,2041,1.8229598893499308
3148,1,337,634,971,0.5315457413249212
3148,2,981,343,1324,2.860058309037901
3148,3,1338,339,1677,3.9469026548672566
3148,4,1703,402,2105,4.236318407960199
3149,1,13,97,110,0.13402061855670103
3149,2,1569,721,2290,2.176144244105409
3149,3,2336,573,2909,4.076788830715532
3149,4,2952,354,3306,8.338983050847459
3149,5,3413,465,3878,7.339784946236559
3150,1,12,262,274,0.04580152671755725
3151,1,56,47,103,1.1914893617021276
3151,2,232,116,348,2.0
3151,3,613,208,821,2.9471153846153846
3151,4,1048,212,1260,4.943396226415095
3151,5,1340,70,1410,19.142857142857142
3151,6,1471,62,1533,23.725806451612904
3151,7,1732,162,1894,10.691358024691358
3151,8,2006,106,2112,18.92452830188679
3151,9,2239,117,2356,19.136752136752136
3151,10,2491,152,2643,16.388157894736842
3151,11,2682,37,2719,72.48648648648648
3151,12,2777,46,2823,60.369565217391305
3151,13,2994,160,3154,18.7125
3151,14,3308,149,3457,22.201342281879196
3151,15,3568,80,3648,44.6
3151,16,3694,23,3717,160.6086956521739
3151,17,3893,188,4081,20.70744680851064
3151,18,4096,9,4105,455.1111111111111
3151,19,4291,200,4491,21.455
3151,20,4751,269,5020,17.66171003717472
3151,21,5304,170,5474,31.2
3151,22,5699,197,5896,28.928934010152282
3151,23,6136,217,6353,28.276497695852534
3151,24,6548,203,6751,32.25615763546798
3151,25,6909,154,7063,44.86363636363637
3151,26,7212,195,7407,36.98461538461538
3151,27,7511,137,7648,54.824817518248175
3151,28,7770,144,7914,53.958333333333336
3152,1,23,309,332,0.0744336569579288
3152,2,346,1023,1369,0.33822091886608013
3153,1,126,1242,1368,0.10144927536231885
3153,2,1377,1145,2522,1.2026200873362445
3154,1,295,56,351,5.267857142857143
3154,2,371,250,621,1.484
3155,1,243,507,750,0.47928994082840237
3155,2,782,478,1260,1.6359832635983265
3155,3,1343,609,1952,2.2052545155993433
3155,4,1991,612,2603,3.253267973856209
3155,5,2624,505,3129,5.196039603960396
3155,6,3139,409,3548,7.67481662591687
3155,7,4011,479,4490,8.373695198329854
3155,8,4507,169,4676,26.668639053254438
3155,9,4738,424,5162,11.174528301886792
3155,10,5228,572,5800,9.13986013986014
3155,11,5819,467,6286,12.460385438972162
3155,12,6295,279,6574,22.56272401433692
3155,13,6617,951,7568,6.957939011566772
3156,1,15,452,467,0.033185840707964605
3156,2,677,518,1195,1.306949806949807
3156,3,1212,522,1734,2.32183908045977
3156,4,1830,488,2318,3.75
3156,5,2436,477,2913,5.1069182389937104
3156,6,2922,466,3388,6.2703862660944205
3156,7,3430,494,3924,6.94331983805668
3156,8,4049,199,4248,20.34673366834171
3156,9,4282,255,4537,16.7921568627451
3156,10,4566,525,5091,8.697142857142858
3156,11,5135,508,5643,10.108267716535433
3156,12,5713,557,6270,10.25673249551167
3156,13,6292,558,6850,11.275985663082437
3156,14,6878,198,7076,34.73737373737374
3156,15,7096,669,7765,10.606875934230194
3156,16,7802,91,7893,85.73626373626374
3157,1,485,722,1207,0.6717451523545707
3158,1,25,407,432,0.06142506142506143
3159,1,590,1223,1813,0.48242027800490594
3159,2,2207,1090,3297,2.024770642201835
3159,3,3722,1099,4821,3.386715195632393
3159,4,5516,883,6399,6.246885617214043
3159,5,6815,1247,8062,5.465116279069767
3160,1,46,1068,1114,0.04307116104868914
3160,2,1137,1047,2184,1.0859598853868195
3160,3,2190,433,2623,5.0577367205542725
3161,1,147,188,335,0.7819148936170213
3161,2,435,333,768,1.3063063063063063
3161,3,990,452,1442,2.190265486725664
3161,4,1659,402,2061,4.126865671641791
3161,5,2280,432,2712,5.277777777777778
3161,6,2726,245,2971,11.126530612244897
3161,7,2981,56,3037,53.232142857142854
3162,1,29,766,795,0.037859007832898174
3162,2,803,684,1487,1.1739766081871346
3163,1,19,109,128,0.1743119266055046
3164,1,96,802,898,0.11970074812967581
3164,2,1025,675,1700,1.5185185185185186
3164,3,1758,288,2046,6.104166666666667
3164,4,2058,38,2096,54.1578947368421
3164,5,2114,143,2257,14.783216783216783
3164,6,2332,134,2466,17.402985074626866
3164,7,2496,147,2643,16.979591836734695
3164,8,2672,70,2742,38.17142857142857
3164,9,2799,156,2955,17.942307692307693
3165,1,224,1014,1238,0.22090729783037474
3165,2,1246,913,2159,1.3647316538882803
3165,3,2186,343,2529,6.373177842565598
3165,4,2574,331,2905,7.77643504531722
3165,5,2929,153,3082,19.143790849673202
3165,6,3126,909,4035,3.438943894389439
3165,7,4106,930,5036,4.41505376344086
3166,1,78,969,1047,0.0804953560371517
3167,1,262,112,374,2.3392857142857144
3167,2,941,130,1071,7.2384615384615385
3167,3,1077,295,1372,3.6508474576271186
3167,4,1378,739,2117,1.86468200270636
3167,5,2123,860,2983,2.468604651162791
3167,6,2989,648,3637,4.612654320987654
3167,7,3643,927,4570,3.929881337648328
3167,8,4576,706,5282,6.481586402266289
3167,9,5288,992,6280,5.330645161290323
3167,10,6286,787,7073,7.9872935196950445
3167,11,7079,1004,8083,7.050796812749004
3168,1,378,43,421,8.790697674418604
3168,2,439,95,534,4.621052631578947
3168,3,557,101,658,5.514851485148514
3168,4,677,101,778,6.702970297029703
3168,5,801,91,892,8.802197802197803
3168,6,913,103,1016,8.864077669902912
3168,7,1048,113,1161,9.274336283185841
3168,8,1190,112,1302,10.625
3168,9,1326,109,1435,12.1651376146789
3168,10,1472,114,1586,12.912280701754385
3168,11,1607,108,1715,14.87962962962963
3168,12,1739,106,1845,16.40566037735849
3169,1,115,249,364,0.46184738955823296
3169,2,502,499,1001,1.006012024048096
3170,1,85,712,797,0.11938202247191011
3170,2,854,779,1633,1.0962772785622592
3170,3,1650,351,2001,4.700854700854701
3171,1,571,93,664,6.139784946236559
3171,2,694,214,908,3.2429906542056073
3171,3,979,53,1032,18.471698113207548
3171,4,1143,167,1310,6.844311377245509
3171,5,1381,139,1520,9.93525179856115
3171,6,1590,132,1722,12.045454545454545
3171,7,1801,309,2110,5.828478964401294
3171,8,2180,177,2357,12.31638418079096
3171,9,2417,119,2536,20.310924369747898
3171,10,2600,144,2744,18.055555555555557
3171,11,2826,280,3106,10.092857142857143
3172,1,16,622,638,0.02572347266881029
3173,1,205,303,508,0.6765676567656765
3174,1,44,644,688,0.06832298136645963
3175,1,152,581,733,0.26161790017211706
3175,2,737,828,1565,0.8900966183574879
3175,3,1569,487,2056,3.2217659137577
3175,4,2060,754,2814,2.7320954907161803
3175,5,2832,778,3610,3.640102827763496
3175,6,3659,661,4320,5.535552193645991
3175,7,4324,99,4423,43.676767676767675
3175,8,4426,13,4439,340.46153846153845
3175,9,4591,824,5415,5.571601941747573
3175,10,5419,780,6199,6.947435897435898
3175,11,6203,705,6908,8.798581560283688
3176,1,44,608,652,0.07236842105263158
3176,2,706,590,1296,1.1966101694915254
3176,3,1306,192,1498,6.802083333333333
3177,1,15,64,79,0.234375
3177,2,469,295,764,1.5898305084745763
3177,3,794,417,1211,1.9040767386091126
3177,4,1218,430,1648,2.832558139534884
3177,5,1700,435,2135,3.9080459770114944
3177,6,2142,52,2194,41.19230769230769
3177,7,6513,480,6993,13.56875
3177,8,7009,156,7165,44.92948717948718
3177,9,7198,283,7481,25.434628975265017
3177,10,7517,331,7848,22.709969788519636
3177,11,7866,222,8088,35.432432432432435
3178,1,83,553,636,0.15009041591320071
3179,1,226,406,632,0.5566502463054187
3179,2,640,408,1048,1.5686274509803921
3179,3,1056,417,1473,2.5323741007194243
3179,4,1481,209,1690,7.086124401913875
3179,5,1715,424,2139,4.044811320754717
3179,6,2147,420,2567,5.1119047619047615
3179,7,2575,389,2964,6.619537275064268
3179,8,2972,453,3425,6.560706401766004
3179,9,3433,220,3653,15.604545454545455
3180,1,24,571,595,0.04203152364273205
3181,1,242,970,1212,0.24948453608247423
3181,2,1220,637,1857,1.915227629513344
3181,3,1926,1453,3379,1.3255333792154165
3181,4,3447,892,4339,3.8643497757847536
3181,5,4541,558,5099,8.137992831541219
3181,6,5236,976,6212,5.364754098360656
3181,7,6333,1000,7333,6.333
3182,1,81,229,310,0.3537117903930131
3182,2,339,948,1287,0.3575949367088608
3182,3,1311,651,1962,2.013824884792627
3183,1,9,407,416,0.022113022113022112
3183,2,426,410,836,1.0390243902439025
3184,1,22,692,714,0.031791907514450865
3184,2,774,782,1556,0.989769820971867
3184,3,1566,76,1642,20.605263157894736
3184,4,1745,702,2447,2.4857549857549857
3184,5,2493,847,3340,2.9433293978748525
3184,6,3377,344,3721,9.81686046511628
3184,7,3756,936,4692,4.012820512820513
3184,8,4724,1028,5752,4.595330739299611
3184,9,5867,962,6829,6.098752598752599
3184,10,6865,1028,7893,6.678015564202335
3185,1,51,449,500,0.11358574610244988
3185,2,502,423,925,1.1867612293144207
3186,1,2352,200,2552,11.76
3186,2,2635,713,3348,3.6956521739130435
3186,3,3422,940,4362,3.6404255319148935
3186,4,4654,361,5015,12.89196675900277
3186,5,5057,391,5448,12.933503836317136
3186,6,5589,880,6469,6.351136363636364
3186,7,6809,834,7643,8.164268585131895
3187,1,35,653,688,0.05359877488514548
3187,2,709,782,1491,0.9066496163682864
3187,3,1502,546,2048,2.750915750915751
3187,4,2066,250,2316,8.264
3187,5,2428,746,3174,3.254691689008043
3187,6,3199,908,4107,3.5231277533039647
3187,7,4126,431,4557,9.57308584686775
3187,8,4564,412,4976,11.077669902912621
3187,9,4992,419,5411,11.914081145584726
3187,10,5440,659,6099,8.254931714719271
3188,1,21,251,272,0.08366533864541832
3188,2,277,358,635,0.7737430167597765
3188,3,640,234,874,2.735042735042735
3188,4,879,256,1135,3.43359375
3188,5,1140,228,1368,5.0
3188,6,1403,133,1536,10.548872180451127
3188,7,1571,361,1932,4.351800554016621
3188,8,1937,348,2285,5.566091954022989
3188,9,2290,206,2496,11.116504854368932
3188,10,2558,368,2926,6.951086956521739
3188,11,2931,377,3308,7.774535809018568
3188,12,3313,287,3600,11.543554006968641
3188,13,3645,302,3947,12.06953642384106
3188,14,3952,245,4197,16.13061224489796
3188,15,4221,544,4765,7.759191176470588
3188,16,4770,482,5252,9.896265560165975
3188,17,5281,296,5577,17.841216216216218
3188,18,5582,84,5666,66.45238095238095
3188,19,5695,346,6041,16.459537572254334
3188,20,6046,184,6230,32.858695652173914
3188,21,6322,319,6641,19.818181818181817
3188,22,6646,8,6654,830.75
3188,23,6698,416,7114,16.10096153846154
3188,24,7144,141,7285,50.666666666666664
3188,25,7291,89,7380,81.92134831460675
3189,1,144,568,712,0.2535211267605634
3189,2,802,353,1155,2.271954674220963
3189,3,1265,541,1806,2.3382624768946396
3190,1,214,522,736,0.4099616858237548
3190,2,814,669,1483,1.2167414050822123
3190,3,2353,270,2623,8.714814814814815
3190,4,2667,923,3590,2.8894907908992415
3190,5,3628,186,3814,19.50537634408602
3190,6,3845,190,4035,20.236842105263158
3190,7,4070,231,4301,17.61904761904762
3190,8,4394,267,4661,16.45692883895131
3190,9,4715,37,4752,127.43243243243244
3190,10,4801,40,4841,120.025
3190,11,4866,183,5049,26.59016393442623
3190,12,5060,181,5241,27.955801104972377
3190,13,5259,238,5497,22.096638655462186
3190,14,5571,174,5745,32.01724137931034
3190,15,5840,290,6130,20.137931034482758
3190,16,6424,415,6839,15.479518072289157
3190,17,6855,73,6928,93.9041095890411
3190,18,6938,38,6976,182.57894736842104
3190,19,6991,66,7057,105.92424242424242
3190,20,7117,91,7208,78.20879120879121
3190,21,7265,62,7327,117.1774193548387
3190,22,7331,43,7374,170.48837209302326
3190,23,7401,39,7440,189.76923076923077
3190,24,7456,364,7820,20.483516483516482
3190,25,7884,40,7924,197.1
3190,26,7944,53,7997,149.88679245283018
3191,1,2443,862,3305,2.8341067285382833
3191,2,3307,853,4160,3.876905041031653
3191,3,4162,549,4711,7.581056466302368
3191,4,6373,863,7236,7.384704519119351
3191,5,7238,543,7781,13.329650092081032
3192,1,11,27,38,0.4074074074074074
3192,2,63,64,127,0.984375
3192,3,376,277,653,1.3574007220216606
3192,4,942,878,1820,1.072892938496583
3192,5,1877,876,2753,2.1426940639269407
3192,6,2852,873,3725,3.2668957617411225
3192,7,3866,881,4747,4.388195232690125
3192,8,4801,869,5670,5.524741081703107
3192,9,5740,707,6447,8.118811881188119
3192,10,6524,660,7184,9.884848484848485
3192,11,7261,613,7874,11.845024469820554
3193,1,290,321,611,0.9034267912772586
3193,2,622,277,899,2.2454873646209386
3194,1,31,615,646,0.05040650406504065
3194,2,669,468,1137,1.4294871794871795
3194,3,1166,196,1362,5.948979591836735
3194,4,1371,427,1798,3.210772833723653
3194,5,1828,198,2026,9.232323232323232
3194,6,2053,477,2530,4.30398322851153
3195,1,1357,702,2059,1.933048433048433
3195,2,2074,815,2889,2.5447852760736196
3196,1,112,565,677,0.19823008849557522
3196,2,784,566,1350,1.3851590106007068
3196,3,1367,243,1610,5.625514403292181
3197,1,129,147,276,0.8775510204081632
3198,1,505,151,656,3.3443708609271523
3198,2,724,77,801,9.402597402597403
3198,3,835,174,1009,4.7988505747126435
3199,1,25,94,119,0.26595744680851063
3199,2,131,149,280,0.8791946308724832
3199,3,298,34,332,8.764705882352942
3199,4,340,91,431,3.7362637362637363
3199,5,442,269,711,1.6431226765799256
3200,1,128,469,597,0.27292110874200426
3200,2,712,415,1127,1.7156626506024097
3200,3,1171,373,1544,3.1394101876675604
3200,4,1603,552,2155,2.903985507246377
3200,5,2195,481,2676,4.5634095634095635
3200,6,2721,531,3252,5.124293785310734
3200,7,3264,437,3701,7.469107551487414
3200,8,3785,612,4397,6.184640522875817
3200,9,4424,496,4920,8.919354838709678
3200,10,4980,402,5382,12.388059701492537
3200,11,5421,477,5898,11.364779874213836
3200,12,5928,463,6391,12.803455723542116
3200,13,6626,496,7122,13.358870967741936
3200,14,7143,433,7576,16.496535796766743
3200,15,7599,470,8069,16.16808510638298
3201,1,495,149,644,3.3221476510067114
3201,2,665,123,788,5.40650406504065
3201,3,797,123,920,6.479674796747967
3201,4,933,149,1082,6.261744966442953
3201,5,1102,140,1242,7.871428571428571
3201,6,1248,122,1370,10.229508196721312
3201,7,1401,40,1441,35.025
3201,8,1534,135,1669,11.362962962962962
3201,9,1682,108,1790,15.574074074074074
3201,10,1802,93,1895,19.376344086021504
3201,11,2241,63,2304,35.57142857142857
3202,1,229,270,499,0.8481481481481481
3203,1,195,610,805,0.319672131147541
3203,2,824,754,1578,1.0928381962864722
3203,3,1600,653,2253,2.450229709035222
3203,4,2278,747,3025,3.0495314591700136
3203,5,3041,1072,4113,2.8367537313432836
3203,6,4120,288,4408,14.305555555555555
3203,7,4423,388,4811,11.399484536082474
3203,8,4823,388,5211,12.43041237113402
3203,9,5221,1082,6303,4.82532347504621
3203,10,6308,303,6611,20.818481848184817
3203,11,6864,779,7643,8.811296534017972
3203,12,7648,3,7651,2549.3333333333335
3204,1,13,654,667,0.019877675840978593
3204,2,2602,653,3255,3.98468606431853
3204,3,3265,485,3750,6.731958762886598
3204,4,3766,671,4437,5.612518628912071
3205,1,39,21,60,1.8571428571428572
3205,2,90,335,425,0.26865671641791045
3205,3,465,942,1407,0.49363057324840764
3205,4,1421,395,1816,3.59746835443038
3205,5,1842,542,2384,3.3985239852398523
3205,6,2428,176,2604,13.795454545454545
3205,7,2662,425,3087,6.263529411764706
3205,8,3155,437,3592,7.219679633867277
3205,9,3623,265,3888,13.671698113207547
3206,1,45,932,977,0.048283261802575105
3206,2,985,461,1446,2.1366594360086766
3207,1,12,65,77,0.18461538461538463
3207,2,92,335,427,0.2746268656716418
3207,3,442,303,745,1.4587458745874586
3207,4,763,339,1102,2.2507374631268435
3207,5,1120,342,1462,3.2748538011695905
3207,6,1479,335,1814,4.414925373134328
3207,7,1834,384,2218,4.776041666666667
3208,1,229,161,390,1.4223602484472049
3209,1,41,546,587,0.07509157509157509
3210,1,70,384,454,0.18229166666666666
3210,2,533,349,882,1.527220630372493
3210,3,933,296,1229,3.152027027027027
3210,4,1236,49,1285,25.224489795918366
3210,5,1298,529,1827,2.4536862003780717
3211,1,219,963,1182,0.22741433021806853
3211,2,1222,627,1849,1.9489633173843701
3211,3,1862,1020,2882,1.8254901960784313
3211,4,2898,858,3756,3.3776223776223775
3211,5,3786,693,4479,5.463203463203463
3212,1,15,280,295,0.05357142857142857
3212,2,376,553,929,0.6799276672694394
3212,3,962,431,1393,2.2320185614849186
3212,4,1405,102,1507,13.77450980392157
3212,5,1513,69,1582,21.92753623188406
3212,6,1658,500,2158,3.316
3212,7,2186,351,2537,6.227920227920228
3212,8,2549,74,2623,34.445945945945944
3212,9,2633,104,2737,25.317307692307693
3213,1,3983,774,4757,5.145994832041343
3213,2,4776,821,5597,5.817295980511571
3213,3,5665,710,6375,7.97887323943662
3213,4,6433,670,7103,9.601492537313433
3213,5,7108,9,7117,789.7777777777778
3214,1,24,79,103,0.3037974683544304
3215,1,1410,551,1961,2.558983666061706
3216,1,31,95,126,0.3263157894736842
3217,1,122,903,1025,0.13510520487264674
3217,2,1032,37,1069,27.89189189189189
3217,3,1086,741,1827,1.465587044534413
3217,4,1851,483,2334,3.8322981366459627
3217,5,2364,382,2746,6.18848167539267
3217,6,2772,880,3652,3.15
3217,7,3674,308,3982,11.928571428571429
3218,1,22,673,695,0.03268945022288262
3218,2,744,900,1644,0.8266666666666667
3219,1,1158,447,1605,2.5906040268456376
3219,2,1709,666,2375,2.566066066066066
3219,3,2813,682,3495,4.124633431085044
3219,4,3785,745,4530,5.080536912751678
3219,5,4736,794,5530,5.964735516372796
3219,6,5634,847,6481,6.651711924439197
3219,7,6633,857,7490,7.7397899649941655
3220,1,36,71,107,0.5070422535211268
3221,1,617,15,632,41.13333333333333
3221,2,1485,15,1500,99.0
3221,3,2996,15,3011,199.73333333333332
3221,4,3248,489,3737,6.642126789366054
3221,5,3757,749,4506,5.0160213618157545
3222,1,34,448,482,0.07589285714285714
3222,2,517,480,997,1.0770833333333334
3222,3,1009,543,1552,1.858195211786372
3222,4,1573,282,1855,5.578014184397163
3223,1,60,760,820,0.07894736842105263
3223,2,831,283,1114,2.9363957597173145
3223,3,1125,604,1729,1.8625827814569536
3223,4,1740,536,2276,3.246268656716418
3223,5,2287,719,3006,3.180806675938804
3223,6,3017,757,3774,3.9854689564068693
3223,7,3785,790,4575,4.791139240506329
3223,8,4586,802,5388,5.7182044887780545
3223,9,5399,824,6223,6.552184466019417
3223,10,6234,832,7066,7.492788461538462
3224,1,147,382,529,0.38481675392670156
3224,2,1228,845,2073,1.4532544378698224
3224,3,2098,454,2552,4.621145374449339
3224,4,2573,449,3022,5.7305122494432075
3224,5,3048,461,3509,6.611713665943601
3224,6,3564,444,4008,8.027027027027026
3224,7,4086,441,4527,9.26530612244898
3224,8,4545,357,4902,12.731092436974789
3224,9,5019,882,5901,5.690476190476191
3224,10,5924,888,6812,6.671171171171171
3224,11,6862,866,7728,7.923787528868361
3224,12,7764,302,8066,25.70860927152318
3225,1,19,310,329,0.06129032258064516
3225,2,332,260,592,1.2769230769230768
3226,1,535,105,640,5.095238095238095
3226,2,688,107,795,6.429906542056075
3227,1,1443,46,1489,31.369565217391305
3227,2,3039,15,3054,202.6
3227,3,4187,28,4215,149.53571428571428
3227,4,4863,738,5601,6.5894308943089435
3227,5,5624,597,6221,9.420435510887772
3228,1,1880,942,2822,1.9957537154989384
3228,2,2840,630,3470,4.507936507936508
3228,3,3481,994,4475,3.5020120724346078
3228,4,4537,994,5531,4.564386317907445
3228,5,5568,993,6561,5.6072507552870094
3228,6,6582,431,7013,15.271461716937354
3228,7,7061,996,8057,7.089357429718875
3229,1,33,505,538,0.06534653465346535
3229,2,559,444,1003,1.259009009009009
3229,3,1012,509,1521,1.9882121807465618
3229,4,1540,510,2050,3.019607843137255
3230,1,38,46,84,0.8260869565217391
3230,2,227,585,812,0.38803418803418804
3230,3,911,5,916,182.2
3230,4,1428,5,1433,285.6
3230,5,3160,5,3165,632.0
3230,6,4489,5,4494,897.8
3230,7,6692,5,6697,1338.4
3230,8,8014,5,8019,1602.8
3231,1,203,173,376,1.1734104046242775
3231,2,461,348,809,1.3247126436781609
3231,3,811,326,1137,2.4877300613496933
3231,4,1160,340,1500,3.411764705882353
3231,5,1528,186,1714,8.21505376344086
3231,6,1852,290,2142,6.386206896551724
3232,1,41,839,880,0.04886769964243146
3233,1,694,74,768,9.378378378378379
3233,2,1375,77,1452,17.857142857142858
3233,3,1493,424,1917,3.5212264150943398
3233,4,1988,503,2491,3.952286282306163
3233,5,2524,383,2907,6.590078328981723
3233,6,2932,207,3139,14.16425120772947
3233,7,3172,581,3753,5.459552495697074
3233,8,3778,372,4150,10.155913978494624
3233,9,4196,423,4619,9.919621749408984
3233,10,4635,728,5363,6.366758241758242
3233,11,5412,563,5975,9.61278863232682
3233,12,5990,386,6376,15.518134715025907
3233,13,6394,508,6902,12.586614173228346
3233,14,6926,634,7560,10.92429022082019
3234,1,135,661,796,0.2042360060514372
3234,2,813,655,1468,1.2412213740458016
3234,3,1498,808,2306,1.853960396039604
3234,4,2336,832,3168,2.8076923076923075
3234,5,3195,643,3838,4.968895800933126
3234,6,3856,592,4448,6.513513513513513
3235,1,15,170,185,0.08823529411764706
3235,2,193,203,396,0.9507389162561576
3235,3,406,631,1037,0.6434231378763867
3235,4,1045,238,1283,4.390756302521009
3235,5,1293,194,1487,6.664948453608248
3236,1,27,202,229,0.13366336633663367
3236,2,246,147,393,1.6734693877551021
3236,3,448,210,658,2.1333333333333333
3236,4,667,194,861,3.4381443298969074
3237,1,27,331,358,0.08157099697885196
3237,2,419,376,795,1.1143617021276595
3237,3,799,276,1075,2.8949275362318843
3237,4,1204,358,1562,3.363128491620112
3237,5,1564,383,1947,4.0835509138381205
3237,6,1986,319,2305,6.225705329153605
3237,7,2307,324,2631,7.12037037037037
3237,8,2633,311,2944,8.466237942122186
3237,9,2962,367,3329,8.0708446866485
3237,10,3331,391,3722,8.51918158567775
3237,11,3756,365,4121,10.29041095890411
3237,12,4135,367,4502,11.267029972752043
3237,13,4504,227,4731,19.841409691629956
3238,1,15,208,223,0.07211538461538461
3238,2,237,320,557,0.740625
3238,3,605,400,1005,1.5125
3238,4,1223,502,1725,2.4362549800796813
3238,5,1838,521,2359,3.5278310940499042
3238,6,2413,470,2883,5.134042553191489
3238,7,2897,200,3097,14.485
3238,8,3160,257,3417,12.295719844357977
3238,9,3468,540,4008,6.4222222222222225
3238,10,4144,967,5111,4.285418821096174
3239,1,29,58,87,0.5
3239,2,128,151,279,0.847682119205298
3239,3,286,200,486,1.43
3239,4,532,386,918,1.378238341968912
3239,5,937,439,1376,2.134396355353075
3239,6,1472,26,1498,56.61538461538461
3239,7,1690,465,2155,3.6344086021505375
3239,8,2169,465,2634,4.664516129032258
3239,9,2878,340,3218,8.464705882352941
3239,10,3245,462,3707,7.023809523809524
3239,11,3729,598,4327,6.235785953177258
3239,12,4351,652,5003,6.673312883435583
3240,1,391,469,860,0.8336886993603412
3240,2,874,591,1465,1.478849407783418
3240,3,1478,622,2100,2.3762057877813505
3241,1,40,824,864,0.04854368932038835
3241,2,1307,749,2056,1.7449933244325768
3241,3,2088,739,2827,2.825439783491204
3241,4,2879,861,3740,3.343786295005807
3241,5,4494,860,5354,5.225581395348837
3241,6,5406,1287,6693,4.200466200466201
3241,7,6710,248,6958,27.056451612903224
3241,8,7056,382,7438,18.471204188481675
3242,1,32,486,518,0.06584362139917696
3242,2,533,464,997,1.1487068965517242
3242,3,1016,344,1360,2.953488372093023
3242,4,1375,393,1768,3.4987277353689565
3242,5,1796,181,1977,9.922651933701658
3242,6,1999,331,2330,6.039274924471299
3242,7,2356,334,2690,7.053892215568863
3243,1,23,1008,1031,0.022817460317460316
3243,2,1033,521,1554,1.982725527831094
3244,1,111,680,791,0.16323529411764706
3245,1,58,389,447,0.14910025706940874
3245,2,537,955,1492,0.562303664921466
3245,3,1499,648,2147,2.3132716049382718
3246,1,709,434,1143,1.6336405529953917
3246,2,1189,465,1654,2.556989247311828
3246,3,1684,465,2149,3.621505376344086
3246,4,2508,880,3388,2.85
3246,5,3486,1220,4706,2.857377049180328
3246,6,4816,1196,6012,4.026755852842809
3247,1,228,184,412,1.2391304347826086
3247,2,443,240,683,1.8458333333333334
3247,3,707,196,903,3.607142857142857
3247,4,946,200,1146,4.73
3247,5,1166,235,1401,4.961702127659574
3247,6,1433,220,1653,6.513636363636364
3247,7,1681,225,1906,7.471111111111111
3247,8,1933,214,2147,9.032710280373832
3247,9,2170,219,2389,9.908675799086758
3248,1,98,11,109,8.909090909090908
3248,2,149,117,266,1.2735042735042734
3248,3,279,64,343,4.359375
3248,4,358,550,908,0.6509090909090909
3248,5,917,50,967,18.34
3249,1,184,593,777,0.3102866779089376
3250,1,217,831,1048,0.2611311672683514
3250,2,1087,909,1996,1.1958195819581958
3250,3,2003,454,2457,4.4118942731277535
3250,4,2532,733,3265,3.4542974079126876
3251,1,23,475,498,0.04842105263157895
3251,2,507,501,1008,1.0119760479041917
3251,3,1035,356,1391,2.907303370786517
3251,4,1423,428,1851,3.324766355140187
3251,5,1879,382,2261,4.9188481675392675
3252,1,129,39,168,3.3076923076923075
3252,2,172,79,251,2.1772151898734178
3252,3,978,505,1483,1.9366336633663366
3253,1,86,283,369,0.303886925795053
3253,2,384,598,982,0.6421404682274248
3253,3,994,999,1993,0.994994994994995
3253,4,2018,733,2751,2.753069577080491
3253,5,2775,552,3327,5.0271739130434785
3254,1,1015,500,1515,2.03
3255,1,27,160,187,0.16875
3255,2,238,1201,1439,0.19816819317235637
3255,3,1568,1112,2680,1.410071942446043
3255,4,2729,1167,3896,2.3384747215081405
3255,5,4016,578,4594,6.948096885813149
3255,6,4648,629,5277,7.389507154213036
3255,7,5322,1080,6402,4.927777777777778
3255,8,6479,969,7448,6.686274509803922
3255,9,7501,602,8103,12.460132890365449
3256,1,73,425,498,0.17176470588235293
3256,2,513,353,866,1.453257790368272
3256,3,984,332,1316,2.963855421686747
3256,4,1342,371,1713,3.6172506738544477
3256,5,1739,308,2047,5.646103896103896
3256,6,2055,385,2440,5.337662337662338
3256,7,2473,479,2952,5.162839248434238
3256,8,2963,431,3394,6.874709976798144
3256,9,3397,485,3882,7.004123711340206
3256,10,3904,479,4383,8.150313152400836
3256,11,4394,339,4733,12.96165191740413
3256,12,4830,456,5286,10.592105263157896
3256,13,5307,410,5717,12.94390243902439
3256,14,5850,485,6335,12.061855670103093
3256,15,6344,595,6939,10.66218487394958
3256,16,6947,48,6995,144.72916666666666
3257,1,11,356,367,0.03089887640449438
3257,2,397,338,735,1.1745562130177514
3257,3,741,317,1058,2.3375394321766563
3257,4,1064,297,1361,3.5824915824915826
3257,5,1367,181,1548,7.552486187845304
3257,6,1554,192,1746,8.09375
3257,7,1752,184,1936,9.521739130434783
3257,8,2016,361,2377,5.584487534626039
3257,9,2384,350,2734,6.811428571428571
3257,10,2741,199,2940,13.773869346733669
3257,11,3018,363,3381,8.314049586776859
3257,12,3388,391,3779,8.664961636828645
3257,13,3786,341,4127,11.102639296187684
3257,14,4134,336,4470,12.303571428571429
3257,15,4477,133,4610,33.661654135338345
3257,16,4707,355,5062,13.259154929577464
3257,17,5081,371,5452,13.695417789757412
3257,18,5459,254,5713,21.492125984251967
3257,19,5753,378,6131,15.21957671957672
3257,20,6138,369,6507,16.634146341463413
3257,21,6514,136,6650,47.89705882352941
3257,22,6688,452,7140,14.79646017699115
3257,23,7147,405,7552,17.646913580246913
3257,24,7558,126,7684,59.98412698412698
3258,1,27,633,660,0.04265402843601896
3258,2,682,575,1257,1.1860869565217391
3258,3,1322,800,2122,1.6525
3258,4,2150,77,2227,27.92207792207792
3258,5,2268,492,2760,4.609756097560975
3258,6,2902,612,3514,4.741830065359477
3258,7,3548,624,4172,5.685897435897436
3258,8,4297,599,4896,7.173622704507513
3258,9,4993,738,5731,6.765582655826559
3258,10,5812,713,6525,8.151472650771389
3258,11,6557,388,6945,16.899484536082475
3259,1,72,2628,2700,0.0273972602739726
3260,1,20,971,991,0.02059732234809475
3260,2,1003,684,1687,1.4663742690058479
3260,3,1806,939,2745,1.9233226837060702
3260,4,2770,566,3336,4.893992932862191
3260,5,3358,469,3827,7.159914712153518
3260,6,3868,727,4595,5.320495185694636
3260,7,4628,294,4922,15.741496598639456
3260,8,4959,303,5262,16.366336633663366
3260,9,5296,222,5518,23.855855855855857
3260,10,5535,916,6451,6.042576419213974
3260,11,6501,692,7193,9.394508670520231
3260,12,7214,637,7851,11.324960753532181
3261,1,627,963,1590,0.6510903426791277
3261,2,1662,648,2310,2.564814814814815
3261,3,2349,802,3151,2.928927680798005
3261,4,3290,649,3939,5.0693374422187985
3261,5,3988,1021,5009,3.9059745347698334
3261,6,5093,1025,6118,4.968780487804878
3261,7,6126,271,6397,22.605166051660518
3261,8,6575,262,6837,25.095419847328245
3262,1,809,41,850,19.73170731707317
3263,1,92,29,121,3.1724137931034484
3263,2,712,446,1158,1.5964125560538116
3263,3,1186,725,1911,1.6358620689655172
3264,1,19,97,116,0.1958762886597938
3264,2,192,477,669,0.4025157232704403
3264,3,684,659,1343,1.0379362670713201
3264,4,1361,623,1984,2.1845906902086676
3264,5,2001,331,2332,6.045317220543807
3265,1,10,599,609,0.01669449081803005
3265,2,640,926,1566,0.6911447084233261
3265,3,1613,760,2373,2.1223684210526317
3265,4,2428,1172,3600,2.0716723549488054
3265,5,3623,628,4251,5.769108280254777
3265,6,4283,183,4466,23.404371584699454
3265,7,4527,527,5054,8.590132827324478
3265,8,5106,517,5623,9.876208897485494
3265,9,5713,290,6003,19.7
3265,10,6023,571,6594,10.54816112084063
3265,11,6620,658,7278,10.060790273556231
3266,1,33,789,822,0.04182509505703422
3266,2,858,760,1618,1.1289473684210527
3266,3,1702,540,2242,3.151851851851852
3266,4,2316,532,2848,4.353383458646617
3266,5,2922,461,3383,6.3383947939262475
3266,6,3413,507,3920,6.731755424063117
3266,7,3951,450,4401,8.78
3266,8,4429,486,4915,9.113168724279836
3266,9,4948,481,5429,10.286902286902286
3266,10,5461,336,5797,16.25297619047619
3266,11,5838,654,6492,8.926605504587156
3266,12,6527,661,7188,9.874432677760968
3266,13,7225,420,7645,17.202380952380953
3267,1,65,650,715,0.1
3268,1,199,1100,1299,0.1809090909090909
3268,2,3530,617,4147,5.721231766612642
3268,3,4160,566,4726,7.34982332155477
3268,4,4808,1040,5848,4.623076923076923
3268,5,5977,496,6473,12.050403225806452
3269,1,62,950,1012,0.06526315789473684
3269,2,1016,644,1660,1.5776397515527951
3270,1,421,397,818,1.0604534005037782
3270,2,829,326,1155,2.542944785276074
3270,3,1166,332,1498,3.5120481927710845
3271,1,271,956,1227,0.2834728033472803
3271,2,1235,948,2183,1.3027426160337552
3271,3,2191,453,2644,4.836644591611479
3272,1,94,648,742,0.14506172839506173
3272,2,791,251,1042,3.151394422310757
3273,1,92,37,129,2.4864864864864864
3273,2,1057,807,1864,1.3097893432465924
3274,1,391,469,860,0.8336886993603412
3274,2,874,591,1465,1.478849407783418
3274,3,1478,622,2100,2.3762057877813505
3274,4,2116,643,2759,3.2908242612752723
3274,5,2760,34,2794,81.17647058823529
3275,1,37,760,797,0.04868421052631579
3275,2,2063,815,2878,2.5312883435582823
3276,1,164,87,251,1.8850574712643677
3276,2,261,144,405,1.8125
3276,3,426,111,537,3.8378378378378377
3276,4,576,86,662,6.6976744186046515
3276,5,686,86,772,7.976744186046512
3276,6,792,129,921,6.1395348837209305
3276,7,928,122,1050,7.60655737704918
3277,1,124,1620,1744,0.07654320987654321
3278,1,803,664,1467,1.2093373493975903
3278,2,1536,778,2314,1.974293059125964
3278,3,2325,705,3030,3.297872340425532
3279,1,41,589,630,0.06960950764006792
3280,1,83,819,902,0.10134310134310134
3280,2,914,819,1733,1.115995115995116
3280,3,1774,807,2581,2.198265179677819
3280,4,2641,359,3000,7.3565459610027855
3280,5,3012,297,3309,10.141414141414142
3281,1,27,436,463,0.06192660550458716
3281,2,494,473,967,1.0443974630021142
3281,3,977,305,1282,3.2032786885245903
3282,1,39,13,52,3.0
3282,2,185,1010,1195,0.18316831683168316
3282,3,1197,256,1453,4.67578125
3282,4,1469,670,2139,2.192537313432836
3283,1,36,582,618,0.061855670103092786
3283,2,633,582,1215,1.0876288659793814
3283,3,1234,291,1525,4.240549828178694
3283,4,1542,651,2193,2.3686635944700463
3283,5,2234,498,2732,4.485943775100401
3284,1,432,624,1056,0.6923076923076923
3285,1,1535,1001,2536,1.5334665334665334
3285,2,2561,596,3157,4.296979865771812
3285,3,3235,789,4024,4.100126742712294
3285,4,4104,746,4850,5.501340482573727
3286,1,324,1090,1414,0.29724770642201837
3286,2,1424,229,1653,6.218340611353712
3286,3,1669,722,2391,2.311634349030471
3286,4,2415,215,2630,11.232558139534884
3286,5,2643,115,2758,22.982608695652175
3287,1,17,186,203,0.0913978494623656
3287,2,430,714,1144,0.6022408963585434
3287,3,1215,843,2058,1.4412811387900355
3287,4,2129,973,3102,2.188078108941418
3287,5,3106,357,3463,8.700280112044817
3287,6,3490,229,3719,15.240174672489083
3287,7,3838,664,4502,5.780120481927711
3287,8,4516,631,5147,7.15689381933439
3287,9,5481,464,5945,11.8125
3287,10,6439,745,7184,8.642953020134229
3287,11,7253,206,7459,35.20873786407767
3287,12,7639,371,8010,20.590296495956874
3288,1,43,404,447,0.10643564356435643
3288,2,470,598,1068,0.7859531772575251
3289,1,360,692,1052,0.5202312138728323
3289,2,1083,910,1993,1.19010989010989
3290,1,19,185,204,0.10270270270270271
3290,2,260,564,824,0.46099290780141844
3290,3,880,649,1529,1.3559322033898304
3291,1,542,455,997,1.1912087912087912
3291,2,1010,505,1515,2.0
3291,3,1528,526,2054,2.9049429657794676
3291,4,2067,546,2613,3.7857142857142856
3291,5,2626,539,3165,4.871985157699443
3291,6,3178,560,3738,5.675
3291,7,3776,576,4352,6.555555555555555
3291,8,4365,611,4976,7.144026186579378
3291,9,5131,452,5583,11.351769911504425
3291,10,5598,606,6204,9.237623762376238
3292,1,276,156,432,1.7692307692307692
3293,1,62,783,845,0.07918263090676884
3293,2,886,960,1846,0.9229166666666667
3293,3,1854,413,2267,4.4891041162227605
3294,1,81,164,245,0.49390243902439024
3295,1,117,158,275,0.740506329113924
3295,2,292,426,718,0.6854460093896714
3295,3,771,584,1355,1.3202054794520548
3295,4,1415,849,2264,1.6666666666666667
3295,5,2277,306,2583,7.4411764705882355
3295,6,2592,635,3227,4.081889763779528
3295,7,3237,233,3470,13.892703862660944
3295,8,3493,636,4129,5.4921383647798745
3295,9,4139,430,4569,9.625581395348837
3295,10,4590,805,5395,5.701863354037267
3295,11,5405,196,5601,27.5765306122449
3295,12,5606,617,6223,9.085899513776337
3295,13,6295,382,6677,16.479057591623036
3295,14,6687,204,6891,32.779411764705884
3295,15,6898,556,7454,12.406474820143885
3295,16,7468,515,7983,14.500970873786407
3296,1,246,250,496,0.984
3297,1,542,492,1034,1.1016260162601625
3297,2,1044,771,1815,1.3540856031128405
3297,3,1835,427,2262,4.297423887587822
3297,4,2265,513,2778,4.415204678362573
3297,5,2781,551,3332,5.047186932849365
3297,6,3334,474,3808,7.033755274261603
3297,7,3811,535,4346,7.123364485981308
3297,8,4352,525,4877,8.289523809523809
3297,9,4879,551,5430,8.85480943738657
3297,10,5432,523,5955,10.38623326959847
3297,11,5957,418,6375,14.251196172248804
3297,12,6379,528,6907,12.081439393939394
3297,13,6909,544,7453,12.700367647058824
3297,14,7475,540,8015,13.842592592592593
3298,1,370,450,820,0.8222222222222222
3298,2,825,420,1245,1.9642857142857142
3298,3,1339,422,1761,3.1729857819905214
3298,4,1777,237,2014,7.4978902953586495
3298,5,2025,268,2293,7.5559701492537314
3299,1,36,798,834,0.045112781954887216
3299,2,879,1056,1935,0.8323863636363636
3299,3,1969,1041,3010,1.8914505283381364
3299,4,3065,1259,4324,2.4344718030182686
3300,1,381,439,820,0.8678815489749431
3300,2,1201,483,1684,2.4865424430641823
3300,3,1998,312,2310,6.403846153846154
3300,4,2576,293,2869,8.791808873720136
3300,5,3465,449,3914,7.717149220489977
3300,6,3921,301,4222,13.0265780730897
3300,7,4235,323,4558,13.111455108359133
3300,8,4587,473,5060,9.69767441860465
3300,9,5340,256,5596,20.859375
3301,1,233,780,1013,0.2987179487179487
3301,2,1023,646,1669,1.58359133126935
3301,3,1888,783,2671,2.4112388250319285
3301,4,2688,761,3449,3.5321944809461234
3301,5,3669,792,4461,4.632575757575758
3301,6,4478,755,5233,5.9311258278145695
3301,7,5460,755,6215,7.231788079470198
3301,8,6232,782,7014,7.969309462915601
3301,9,7031,118,7149,59.58474576271186
3302,1,14,93,107,0.15053763440860216
3302,2,121,53,174,2.2830188679245285
3302,3,224,414,638,0.5410628019323671
3302,4,641,107,748,5.990654205607477
3303,1,60,64,124,0.9375
3303,2,557,492,1049,1.1321138211382114
3304,1,9,51,60,0.17647058823529413
3304,2,74,657,731,0.1126331811263318
3304,3,742,873,1615,0.849942726231386
3305,1,90,206,296,0.4368932038834951
3305,2,305,181,486,1.6850828729281768
3305,3,515,233,748,2.2103004291845494
3306,1,31,648,679,0.047839506172839504
3307,1,83,819,902,0.10134310134310134
3307,2,914,819,1733,1.115995115995116
3307,3,1774,807,2581,2.198265179677819
3307,4,2641,359,3000,7.3565459610027855
3307,5,3012,297,3309,10.141414141414142
3307,6,3348,471,3819,7.10828025477707
3307,7,3832,332,4164,11.542168674698795
3307,8,4208,433,4641,9.71824480369515
3307,9,4669,355,5024,13.152112676056339
3307,10,5035,308,5343,16.3474025974026
3308,1,102,616,718,0.16558441558441558
3309,1,15,308,323,0.048701298701298704
3309,2,351,326,677,1.0766871165644172
3309,3,692,294,986,2.3537414965986394
3309,4,1008,421,1429,2.3942992874109263
3309,5,1452,420,1872,3.4571428571428573
3310,1,94,275,369,0.3418181818181818
3310,2,388,90,478,4.311111111111111
3310,3,496,192,688,2.5833333333333335
3311,1,43,550,593,0.07818181818181819
3311,2,641,538,1179,1.191449814126394
3311,3,1229,601,1830,2.0449251247920133
3312,1,68,265,333,0.25660377358490566
3312,2,406,306,712,1.326797385620915
3312,3,736,438,1174,1.6803652968036529
3312,4,1208,512,1720,2.359375
3312,5,1732,636,2368,2.7232704402515724
3312,6,2399,786,3185,3.0521628498727735
3312,7,3230,409,3639,7.897310513447433
3312,8,3662,402,4064,9.109452736318408
3312,9,4156,620,4776,6.703225806451613
3312,10,4865,466,5331,10.439914163090128
3313,1,189,933,1122,0.20257234726688103
3313,2,1124,510,1634,2.203921568627451
3313,3,1636,608,2244,2.6907894736842106
3313,4,2246,606,2852,3.706270627062706
3313,5,2854,682,3536,4.18475073313783
3314,1,66,70,136,0.9428571428571428
3314,2,145,81,226,1.7901234567901234
3315,1,63,362,425,0.17403314917127072
3315,2,481,366,847,1.314207650273224
3316,1,58,432,490,0.13425925925925927
3316,2,517,313,830,1.6517571884984026
3316,3,880,319,1199,2.7586206896551726
3316,4,1221,223,1444,5.475336322869955
3316,5,1471,255,1726,5.768627450980392
3316,6,1749,375,2124,4.664
3316,7,2171,165,2336,13.157575757575758
3317,1,67,779,846,0.08600770218228498
3317,2,849,499,1348,1.7014028056112225
3318,1,281,896,1177,0.31361607142857145
3318,2,1182,938,2120,1.2601279317697227
3318,3,2125,849,2974,2.502944640753828
3318,4,2981,223,3204,13.367713004484305
3318,5,3231,595,3826,5.430252100840336
3319,1,137,74,211,1.8513513513513513
3319,2,237,55,292,4.3090909090909095
3319,3,384,768,1152,0.5
3319,4,1208,911,2119,1.3260153677277717
3319,5,2164,207,2371,10.454106280193237
3319,6,2471,592,3063,4.173986486486487
3319,7,3120,767,3887,4.067796610169491
3319,8,3897,402,4299,9.694029850746269
3319,9,4302,838,5140,5.133651551312649
3319,10,5266,742,6008,7.097035040431267
3319,11,6124,613,6737,9.99021207177814
3319,12,6821,864,7685,7.894675925925926
3319,13,7725,182,7907,42.44505494505494
3320,1,33,858,891,0.038461538461538464
3320,2,968,837,1805,1.1565113500597373
3320,3,1903,867,2770,2.1949250288350632
3320,4,2781,368,3149,7.557065217391305
3321,1,121,814,935,0.14864864864864866
3321,2,977,614,1591,1.5912052117263844
3321,3,1641,808,2449,2.030940594059406
3322,1,26,586,612,0.04436860068259386
3323,1,11,342,353,0.03216374269005848
3323,2,355,344,699,1.0319767441860466
3323,3,702,335,1037,2.0955223880597016
3323,4,1040,348,1388,2.9885057471264367
3323,5,1390,83,1473,16.746987951807228
3323,6,1489,338,1827,4.405325443786983
3323,7,1829,337,2166,5.427299703264095
3323,8,2168,82,2250,26.4390243902439
3324,1,109,36,145,3.0277777777777777
3324,2,212,115,327,1.8434782608695652
3324,3,380,326,706,1.165644171779141
3325,1,34,941,975,0.036131774707757705
3326,1,84,344,428,0.2441860465116279
3326,2,541,340,881,1.5911764705882352
3326,3,897,326,1223,2.7515337423312882
3326,4,1239,266,1505,4.657894736842105
3326,5,1571,8,1579,196.375
3326,6,1651,252,1903,6.551587301587301
3326,7,1988,214,2202,9.289719626168225
3326,8,2254,927,3181,2.431499460625674
3327,1,230,864,1094,0.2662037037037037
3328,1,22,631,653,0.03486529318541997
3328,2,665,355,1020,1.8732394366197183
3329,1,100,397,497,0.2518891687657431
3329,2,510,424,934,1.2028301886792452
3329,3,946,464,1410,2.038793103448276
3329,4,1426,263,1689,5.422053231939164
3330,1,9,724,733,0.012430939226519336
3330,2,744,308,1052,2.4155844155844157
3330,3,1074,402,1476,2.671641791044776
3330,4,1502,654,2156,2.2966360856269112
3331,1,775,759,1534,1.0210803689064558
3332,1,65,710,775,0.09154929577464789
3332,2,811,561,1372,1.445632798573975
3333,1,38,692,730,0.05491329479768786
3334,1,36,1022,1058,0.03522504892367906
3334,2,1069,338,1407,3.162721893491124
3334,3,1425,1026,2451,1.3888888888888888
3334,4,4195,427,4622,9.824355971896955
3334,5,5174,232,5406,22.301724137931036
3334,6,6889,274,7163,25.142335766423358
3334,7,7455,164,7619,45.457317073170735
3335,1,18,198,216,0.09090909090909091
3336,1,64,385,449,0.16623376623376623
3336,2,492,309,801,1.5922330097087378
3336,3,826,264,1090,3.128787878787879
3336,4,1107,291,1398,3.804123711340206
3336,5,1408,243,1651,5.794238683127572
3336,6,1668,55,1723,30.327272727272728
3337,1,27,331,358,0.08157099697885196
3337,2,419,376,795,1.1143617021276595
3337,3,799,276,1075,2.8949275362318843
3337,4,1204,358,1562,3.363128491620112
3337,5,1564,383,1947,4.0835509138381205
3337,6,1986,319,2305,6.225705329153605
3337,7,2307,324,2631,7.12037037037037
3337,8,2633,311,2944,8.466237942122186
3338,1,14,782,796,0.017902813299232736
3338,2,807,514,1321,1.5700389105058365
3339,1,74,586,660,0.12627986348122866
3339,2,680,573,1253,1.1867364746945899
3340,1,10,568,578,0.017605633802816902
3340,2,594,78,672,7.615384615384615
3340,3,698,262,960,2.66412213740458
3340,4,996,230,1226,4.3304347826086955
3341,1,54,914,968,0.05908096280087528
3341,2,973,857,1830,1.1353558926487748
3341,3,1872,806,2678,2.3225806451612905
3341,4,2700,899,3599,3.0033370411568407
3341,5,3627,903,4530,4.016611295681063
3341,6,4535,849,5384,5.341578327444052
3341,7,5466,901,6367,6.066592674805771
3341,8,6403,899,7302,7.1223581757508345
3342,1,64,395,459,0.1620253164556962
3342,2,470,397,867,1.1838790931989924
3342,3,891,358,1249,2.488826815642458
3343,1,13,59,72,0.22033898305084745
3343,2,79,92,171,0.8586956521739131
3343,3,175,280,455,0.625
3343,4,487,376,863,1.2952127659574468
3344,1,9,50,59,0.18
3344,2,67,250,317,0.268
3345,1,178,135,313,1.3185185185185184
3345,2,333,52,385,6.403846153846154
3345,3,406,33,439,12.303030303030303
3345,4,454,36,490,12.61111111111111
3345,5,526,72,598,7.305555555555555
3345,6,618,48,666,12.875
3345,7,685,55,740,12.454545454545455
3345,8,749,65,814,11.523076923076923
3345,9,833,88,921,9.465909090909092
3346,1,47,919,966,0.051142546245919476
3346,2,969,155,1124,6.251612903225807
3346,3,1266,668,1934,1.8952095808383234
3346,4,2123,786,2909,2.7010178117048347
3346,5,3071,709,3780,4.331452750352609
3346,6,3991,730,4721,5.467123287671233
3346,7,4893,711,5604,6.881856540084388
3346,8,5762,724,6486,7.958563535911602
3346,9,6567,871,7438,7.539609644087256
3346,10,7441,92,7533,80.8804347826087
3346,11,7571,433,8004,17.484988452655887
3346,12,8007,54,8061,148.27777777777777
3347,1,25,732,757,0.03415300546448088
3348,1,115,952,1067,0.1207983193277311
3348,2,1891,849,2740,2.227326266195524
3348,3,2796,947,3743,2.9524815205913413
3348,4,3755,102,3857,36.81372549019608
3348,5,3952,694,4646,5.694524495677234
3348,6,4700,725,5425,6.482758620689655
3348,7,5446,784,6230,6.946428571428571
3348,8,6365,100,6465,63.65
3348,9,6614,949,7563,6.969441517386723
3349,1,25,607,632,0.04118616144975288
3349,2,660,684,1344,0.9649122807017544
3350,1,47,811,858,0.05795314426633785
3351,1,38,592,630,0.06418918918918919
3351,2,657,469,1126,1.4008528784648189
3351,3,1182,496,1678,2.3830645161290325
3351,4,1687,567,2254,2.9753086419753085
3351,5,2263,517,2780,4.3771760154738875
3351,6,2789,554,3343,5.034296028880866
3351,7,3352,504,3856,6.650793650793651
3351,8,3865,494,4359,7.823886639676114
3351,9,4368,500,4868,8.736
3351,10,4877,501,5378,9.734530938123752
3351,11,5387,529,5916,10.18336483931947
3351,12,5925,492,6417,12.042682926829269
3351,13,6426,507,6933,12.674556213017752
3351,14,6942,491,7433,14.138492871690428
3351,15,7442,513,7955,14.50682261208577
3352,1,213,117,330,1.8205128205128205
3352,2,359,114,473,3.1491228070175437
3353,1,182,674,856,0.27002967359050445
3354,1,28,705,733,0.03971631205673759
3354,2,767,505,1272,1.5188118811881188
3354,3,1312,554,1866,2.368231046931408
3354,4,1936,461,2397,4.199566160520607
3354,5,2427,354,2781,6.8559322033898304
3354,6,2820,677,3497,4.165435745937962
3355,1,92,303,395,0.30363036303630364
3355,2,430,176,606,2.4431818181818183
3355,3,612,359,971,1.7047353760445683
3355,4,984,187,1171,5.262032085561497
3356,1,27,22,49,1.2272727272727273
3356,2,199,550,749,0.3618181818181818
3356,3,795,35,830,22.714285714285715
3356,4,1718,658,2376,2.6109422492401215
3356,5,3294,701,3995,4.699001426533523
3356,6,4005,31,4036,129.19354838709677
3356,7,4997,720,5717,6.940277777777778
3356,8,5784,643,6427,8.995334370139968
3356,9,6473,350,6823,18.494285714285713
3356,10,6852,649,7501,10.557781201848998
3356,11,7556,503,8059,15.021868787276341
3357,1,106,399,505,0.2656641604010025
3357,2,525,566,1091,0.9275618374558304
3357,3,1110,998,2108,1.1122244488977955
3357,4,2141,602,2743,3.5564784053156147
3357,5,2761,583,3344,4.735849056603773
3357,6,3364,854,4218,3.939110070257611
3357,7,4224,540,4764,7.822222222222222
3357,8,4773,598,5371,7.981605351170568
3358,1,278,175,453,1.5885714285714285
3358,2,730,326,1056,2.2392638036809815
3358,3,1126,408,1534,2.7598039215686274
3358,4,1581,411,1992,3.846715328467153
3359,1,64,3,67,21.333333333333332
3359,2,1469,81,1550,18.135802469135804
3359,3,1582,69,1651,22.92753623188406
3359,4,1788,963,2751,1.8566978193146417
3359,5,2860,3,2863,953.3333333333334
3360,1,163,954,1117,0.1708595387840671
3360,2,1153,1007,2160,1.1449851042701091
3360,3,2202,997,3199,2.208625877632899
3360,4,3236,1042,4278,3.105566218809981
3360,5,4312,892,5204,4.834080717488789
3360,6,5239,939,6178,5.579339723109691
3360,7,6215,836,7051,7.434210526315789
3360,8,7083,792,7875,8.943181818181818
3361,1,1173,622,1795,1.8858520900321543
3361,2,1860,513,2373,3.625730994152047
3361,3,2400,604,3004,3.9735099337748343
3361,4,3032,615,3647,4.930081300813008
3361,5,3665,605,4270,6.0578512396694215
3361,6,4299,537,4836,8.005586592178771
3361,7,4884,709,5593,6.8885754583921015
3361,8,5607,960,6567,5.840625
3361,9,6569,465,7034,14.126881720430108
3362,1,309,594,903,0.5202020202020202
3362,2,1221,172,1393,7.098837209302325
3363,1,421,397,818,1.0604534005037782
3363,2,829,326,1155,2.542944785276074
3363,3,1166,332,1498,3.5120481927710845
3364,1,197,18,215,10.944444444444445
3364,2,287,40,327,7.175
3364,3,354,54,408,6.555555555555555
3364,4,438,65,503,6.7384615384615385
3364,5,553,72,625,7.680555555555555
3364,6,670,87,757,7.7011494252873565
3365,1,22,189,211,0.1164021164021164
3366,1,92,943,1035,0.0975609756097561
3366,2,1043,668,1711,1.561377245508982
3367,1,1181,741,1922,1.5937921727395412
3367,2,1966,740,2706,2.656756756756757
3367,3,2721,258,2979,10.546511627906977
3368,1,82,566,648,0.14487632508833923
3368,2,667,199,866,3.351758793969849
3368,3,892,348,1240,2.5632183908045976
3369,1,527,555,1082,0.9495495495495495
3369,2,1095,782,1877,1.4002557544757033
3369,3,1891,11,1902,171.9090909090909
3369,4,2834,321,3155,8.828660436137072
3370,1,32,484,516,0.06611570247933884
3371,1,43,38,81,1.131578947368421
3371,2,100,411,511,0.24330900243309003
3371,3,529,123,652,4.300813008130081
3372,1,17,399,416,0.042606516290726815
3372,2,1143,524,1667,2.181297709923664
3372,3,2387,620,3007,3.85
3372,4,3490,580,4070,6.017241379310345
3372,5,4138,663,4801,6.24132730015083
3372,6,4838,563,5401,8.593250444049733
3372,7,5459,306,5765,17.83986928104575
3372,8,5781,366,6147,15.795081967213115
3373,1,126,790,916,0.15949367088607594
3373,2,937,603,1540,1.5538971807628523
3373,3,1592,162,1754,9.82716049382716
3373,4,1789,142,1931,12.598591549295774
3374,1,172,359,531,0.479108635097493
3374,2,646,566,1212,1.1413427561837455
3375,1,427,338,765,1.2633136094674555
3376,1,111,598,709,0.18561872909698995
3377,1,1168,362,1530,3.226519337016575
3377,2,1554,163,1717,9.533742331288343
3378,1,427,180,607,2.3722222222222222
3378,2,619,42,661,14.738095238095237
3378,3,666,44,710,15.136363636363637
3378,4,717,47,764,15.25531914893617
3378,5,786,152,938,5.171052631578948
3378,6,958,35,993,27.37142857142857
3378,7,1057,52,1109,20.326923076923077
3379,1,1241,955,2196,1.2994764397905758
3380,1,36,411,447,0.08759124087591241
3380,2,481,443,924,1.0857787810383748
3380,3,974,91,1065,10.703296703296703
3380,4,1114,553,1667,2.0144665461121156
3380,5,1691,546,2237,3.097069597069597
3380,6,2388,693,3081,3.445887445887446
3380,7,3338,406,3744,8.22167487684729
3380,8,4259,583,4842,7.305317324185249
3380,9,4977,582,5559,8.551546391752577
3380,10,5621,439,6060,12.804100227790434
3380,11,6543,522,7065,12.53448275862069
3380,12,7116,948,8064,7.506329113924051
3381,1,747,293,1040,2.5494880546075085
3382,1,35,319,354,0.109717868338558
3383,1,783,778,1561,1.006426735218509
3383,2,1607,775,2382,2.0735483870967744
3383,3,2412,878,3290,2.7471526195899774
3383,4,3294,204,3498,16.147058823529413
3383,5,3542,655,4197,5.407633587786259
3383,6,4214,532,4746,7.921052631578948
3383,7,4773,800,5573,5.96625
3383,8,5591,724,6315,7.722375690607735
3383,9,6464,621,7085,10.40901771336554
3384,1,1086,648,1734,1.6759259259259258
3385,1,2283,490,2773,4.659183673469387
3386,1,30,115,145,0.2608695652173913
3386,2,148,30,178,4.933333333333334
3386,3,184,22,206,8.363636363636363
3386,4,208,14,222,14.857142857142858
3386,5,492,77,569,6.3896103896103895
3386,6,592,31,623,19.096774193548388
3386,7,1010,29,1039,34.827586206896555
3386,8,1413,34,1447,41.55882352941177
3386,9,1720,34,1754,50.588235294117645
3386,10,2123,30,2153,70.76666666666667
3386,11,2416,27,2443,89.48148148148148
3386,12,2456,197,2653,12.467005076142131
3386,13,3011,30,3041,100.36666666666666
3386,14,3059,302,3361,10.129139072847682
3386,15,3374,344,3718,9.80813953488372
3386,16,3736,253,3989,14.766798418972332
3386,17,4014,391,4405,10.265984654731458
3386,18,4443,438,4881,10.143835616438356
3386,19,4895,381,5276,12.847769028871392
3387,1,82,599,681,0.13689482470784642
3387,2,788,595,1383,1.3243697478991596
3387,3,1414,978,2392,1.4458077709611452
3387,4,2409,707,3116,3.407355021216407
3387,5,3145,677,3822,4.6454948301329395
3388,1,1072,544,1616,1.9705882352941178
3388,2,1683,542,2225,3.1051660516605164
3389,1,24,231,255,0.1038961038961039
3389,2,268,368,636,0.7282608695652174
3390,1,168,237,405,0.7088607594936709
3390,2,466,216,682,2.1574074074074074
3390,3,746,208,954,3.5865384615384617
3390,4,1020,235,1255,4.340425531914893
3390,5,1323,239,1562,5.535564853556485
3390,6,1632,240,1872,6.8
3390,7,1937,247,2184,7.842105263157895
3390,8,2252,237,2489,9.50210970464135
3390,9,2553,236,2789,10.817796610169491
3390,10,2855,254,3109,11.240157480314961
3390,11,3183,250,3433,12.732
3391,1,70,898,968,0.0779510022271715
3391,2,976,868,1844,1.1244239631336406
3391,3,1852,135,1987,13.718518518518518
3392,1,72,751,823,0.09587217043941411
3392,2,837,740,1577,1.1310810810810812
3392,3,1597,539,2136,2.962894248608534
3392,4,2154,217,2371,9.926267281105991
3392,5,2386,561,2947,4.253119429590018
3393,1,191,440,631,0.4340909090909091
3393,2,652,193,845,3.378238341968912
3393,3,899,505,1404,1.7801980198019802
3393,4,1430,454,1884,3.149779735682819
3393,5,1964,518,2482,3.7915057915057915
3393,6,2711,720,3431,3.765277777777778
3393,7,3461,464,3925,7.459051724137931
3393,8,3985,527,4512,7.561669829222011
3393,9,4585,382,4967,12.002617801047121
3393,10,4976,209,5185,23.80861244019139
3393,11,5201,288,5489,18.05902777777778
3393,12,5504,557,6061,9.881508078994614
3393,13,6107,539,6646,11.330241187384045
3393,14,6656,598,7254,11.130434782608695
3393,15,7375,623,7998,11.837881219903691
3394,1,197,958,1155,0.2056367432150313
3395,1,116,1112,1228,0.10431654676258993
3395,2,1231,1112,2343,1.1070143884892085
3395,3,2346,797,3143,2.943538268506901
3396,1,34,290,324,0.11724137931034483
3396,2,356,620,976,0.5741935483870968
3396,3,1004,583,1587,1.7221269296740995
3396,4,1608,492,2100,3.268292682926829
3397,1,339,583,922,0.58147512864494
3397,2,933,583,1516,1.6003430531732419
3397,3,1537,35,1572,43.91428571428571
3397,4,1581,709,2290,2.229901269393512
3398,1,122,304,426,0.40131578947368424
3398,2,442,326,768,1.3558282208588956
3398,3,821,302,1123,2.718543046357616
3398,4,1135,303,1438,3.745874587458746
3398,5,1451,310,1761,4.680645161290323
3398,6,1802,298,2100,6.046979865771812
3398,7,2120,306,2426,6.928104575163399
3398,8,2447,307,2754,7.970684039087948
3398,9,2787,248,3035,11.237903225806452
3399,1,3113,43,3156,72.3953488372093
3399,2,4292,31,4323,138.4516129032258
3399,3,4436,345,4781,12.857971014492753
3399,4,4788,135,4923,35.46666666666667
3399,5,4967,330,5297,15.05151515151515
3399,6,5304,395,5699,13.427848101265823
3399,7,5706,313,6019,18.230031948881788
3399,8,6060,344,6404,17.61627906976744
3399,9,6411,257,6668,24.945525291828794
3400,1,12,818,830,0.014669926650366748
3400,2,845,935,1780,0.9037433155080213
3400,3,1813,790,2603,2.2949367088607593
3400,4,2640,973,3613,2.7132579650565263
3400,5,3668,1007,4675,3.6425024826216483
3400,6,4684,436,5120,10.743119266055047
3400,7,5162,1037,6199,4.977820636451302
3401,1,52,373,425,0.13941018766756033
3401,2,432,434,866,0.9953917050691244
3401,3,925,373,1298,2.479892761394102
3401,4,1328,418,1746,3.1770334928229667
3401,5,1774,343,2117,5.17201166180758
3401,6,2171,348,2519,6.238505747126437
3401,7,2608,203,2811,12.847290640394089
3401,8,2869,213,3082,13.469483568075118
3401,9,3134,334,3468,9.383233532934131
3401,10,3475,357,3832,9.733893557422968
3402,1,207,568,775,0.3644366197183099
3402,2,791,628,1419,1.2595541401273886
3403,1,556,831,1387,0.6690734055354994
3403,2,1466,889,2355,1.6490438695163105
3404,1,35,80,115,0.4375
3404,2,1647,32,1679,51.46875
3404,3,2496,54,2550,46.22222222222222
3404,4,3522,43,3565,81.90697674418605
3404,5,3938,29,3967,135.79310344827587
3404,6,4869,25,4894,194.76
3404,7,4937,23,4960,214.65217391304347
3404,8,5466,33,5499,165.63636363636363
3404,9,6382,46,6428,138.7391304347826
3404,10,6695,548,7243,12.217153284671532
3404,11,7337,660,7997,11.116666666666667
3405,1,197,44,241,4.4772727272727275
3405,2,499,195,694,2.5589743589743588
3406,1,194,635,829,0.30551181102362207
3406,2,1065,618,1683,1.7233009708737863
3406,3,1724,837,2561,2.0597371565113503
3406,4,2587,736,3323,3.514945652173913
3407,1,109,28,137,3.892857142857143
3407,2,243,928,1171,0.26185344827586204
3408,1,28,939,967,0.029818956336528223
3408,2,991,730,1721,1.3575342465753424
3408,3,1750,942,2692,1.8577494692144374
3408,4,2738,905,3643,3.0254143646408838
3408,5,3651,919,4570,3.9727965179542983
3408,6,4577,412,4989,11.109223300970873
3409,1,257,476,733,0.5399159663865546
3410,1,79,531,610,0.1487758945386064
3410,2,671,273,944,2.457875457875458
3410,3,983,384,1367,2.5598958333333335
3410,4,1705,480,2185,3.5520833333333335
3411,1,88,1058,1146,0.0831758034026465
3411,2,1154,562,1716,2.0533807829181496
3411,3,1747,1075,2822,1.6251162790697675
3411,4,2838,717,3555,3.9581589958158996
3411,5,3618,992,4610,3.6471774193548385
3411,6,4618,624,5242,7.4006410256410255
3411,7,5266,1074,6340,4.9031657355679705
3411,8,6356,958,7314,6.634655532359082
3411,9,7350,487,7837,15.092402464065708
3412,1,276,613,889,0.45024469820554647
3413,1,53,553,606,0.09584086799276673
3413,2,640,417,1057,1.5347721822541966
3413,3,1073,444,1517,2.4166666666666665
3413,4,1527,435,1962,3.510344827586207
3413,5,1971,413,2384,4.772397094430993
3414,1,216,300,516,0.72
3414,2,521,289,810,1.8027681660899655
3414,3,1139,253,1392,4.5019762845849804
3414,4,1397,264,1661,5.291666666666667
3414,5,1667,330,1997,5.051515151515152
3414,6,2002,198,2200,10.11111111111111
3414,7,2420,281,2701,8.612099644128113
3414,8,2707,258,2965,10.492248062015504
3414,9,2970,207,3177,14.347826086956522
3414,10,3182,138,3320,23.057971014492754
3414,11,3858,204,4062,18.91176470588235
3414,12,4067,308,4375,13.204545454545455
3414,13,4381,272,4653,16.106617647058822
3414,14,4658,212,4870,21.971698113207548
3415,1,36,200,236,0.18
3415,2,268,212,480,1.2641509433962264
3416,1,114,831,945,0.1371841155234657
3417,1,103,729,832,0.1412894375857339
3417,2,840,610,1450,1.3770491803278688
3417,3,1591,818,2409,1.9449877750611246
3417,4,2417,259,2676,9.332046332046332
3417,5,2823,879,3702,3.21160409556314
3417,6,3710,463,4173,8.012958963282937
3417,7,4313,827,5140,5.215235792019347
3417,8,5148,260,5408,19.8
3417,9,5550,858,6408,6.468531468531468
3417,10,6416,469,6885,13.680170575692964
3417,11,7036,828,7864,8.497584541062801
3418,1,80,822,902,0.09732360097323602
3418,2,911,909,1820,1.0022002200220022
3418,3,1828,1062,2890,1.7212806026365348
3418,4,2910,346,3256,8.410404624277456
3420,1,1232,341,1573,3.6129032258064515
3421,1,115,512,627,0.224609375
3422,1,15,836,851,0.017942583732057416
3422,2,879,326,1205,2.696319018404908
3422,3,1227,596,1823,2.0587248322147653
3422,4,1841,94,1935,19.585106382978722
3422,5,1993,679,2672,2.9351988217967597
3422,6,2703,631,3334,4.283676703645008
3422,7,3349,363,3712,9.225895316804408
3422,8,3717,593,4310,6.2681281618887015
3422,9,4322,272,4594,15.889705882352942
3422,10,4611,560,5171,8.23392857142857
3422,11,5179,321,5500,16.133956386292834
3422,12,5508,474,5982,11.620253164556962
3422,13,6020,101,6121,59.603960396039604
3422,14,6142,74,6216,83.0
3422,15,6224,385,6609,16.166233766233766
3422,16,6684,787,7471,8.493011435832274
3422,17,7489,454,7943,16.495594713656388
3423,1,94,494,588,0.1902834008097166
3423,2,632,479,1111,1.3194154488517744
3423,3,1170,515,1685,2.2718446601941746
3423,4,1705,617,2322,2.7633711507293355
3423,5,2329,578,2907,4.029411764705882
3423,6,2934,164,3098,17.890243902439025
3423,7,3128,196,3324,15.959183673469388
3424,1,11,623,634,0.01765650080256822
3425,1,55,94,149,0.5851063829787234
3425,2,163,459,622,0.355119825708061
3426,1,271,15,286,18.066666666666666
3426,2,322,15,337,21.466666666666665
3426,3,340,269,609,1.2639405204460967
3427,1,74,876,950,0.08447488584474885
3427,2,975,480,1455,2.03125
3427,3,1472,595,2067,2.473949579831933
3427,4,2085,639,2724,3.2629107981220655
3427,5,2767,413,3180,6.699757869249395
3427,6,3274,613,3887,5.3409461663947795
3427,7,3897,619,4516,6.295638126009693
3427,8,4582,726,5308,6.311294765840221
3428,1,17,35,52,0.4857142857142857
3428,2,94,120,214,0.7833333333333333
3429,1,149,591,740,0.2521150592216582
3429,2,785,384,1169,2.0442708333333335
3429,3,1226,431,1657,2.8445475638051043
3430,1,96,815,911,0.11779141104294479
3430,2,976,892,1868,1.094170403587444
3430,3,1933,909,2842,2.1265126512651267
3430,4,2850,489,3339,5.828220858895706
3431,1,338,403,741,0.8387096774193549
3432,1,46,55,101,0.8363636363636363
3432,2,106,34,140,3.1176470588235294
3432,3,145,51,196,2.843137254901961
3432,4,220,56,276,3.9285714285714284
3432,5,310,62,372,5.0
3432,6,397,50,447,7.94
3432,7,467,46,513,10.152173913043478
3432,8,549,39,588,14.076923076923077
3432,9,606,29,635,20.896551724137932
3432,10,640,29,669,22.06896551724138
3432,11,677,39,716,17.358974358974358
3432,12,721,32,753,22.53125
3432,13,771,34,805,22.676470588235293
3432,14,832,26,858,32.0
3433,1,32,550,582,0.05818181818181818
3434,1,959,157,1116,6.10828025477707
3435,1,17,35,52,0.4857142857142857
3435,2,704,423,1127,1.6643026004728132
3435,3,1145,310,1455,3.693548387096774
3435,4,2232,700,2932,3.1885714285714286
3436,1,279,462,741,0.6038961038961039
3437,1,569,279,848,2.039426523297491
3437,2,859,381,1240,2.254593175853018
3438,1,1791,346,2137,5.176300578034682
3438,2,2140,490,2630,4.36734693877551
3438,3,2633,354,2987,7.437853107344632
3438,4,2990,330,3320,9.06060606060606
3438,5,3323,221,3544,15.036199095022624
3438,6,3547,168,3715,21.113095238095237
3438,7,3718,190,3908,19.568421052631578
3438,8,3911,173,4084,22.606936416184972
3438,9,4094,434,4528,9.433179723502304
3438,10,4531,116,4647,39.060344827586206
3438,11,4673,190,4863,24.594736842105263
3438,12,4884,376,5260,12.98936170212766
3438,13,5263,210,5473,25.061904761904763
3438,14,5476,221,5697,24.778280542986426
3438,15,5800,257,6057,22.56809338521401
3438,16,6060,306,6366,19.80392156862745
3438,17,6369,234,6603,27.21794871794872
3438,18,6621,403,7024,16.429280397022332
3438,19,7027,203,7230,34.61576354679803
3438,20,7256,361,7617,20.099722991689752
3438,21,7640,308,7948,24.805194805194805
3439,1,81,229,310,0.3537117903930131
3439,2,339,948,1287,0.3575949367088608
3439,3,1311,651,1962,2.013824884792627
3440,1,24,565,589,0.04247787610619469
3441,1,21,539,560,0.03896103896103896
3441,2,603,503,1106,1.1988071570576542
3442,1,18,309,327,0.05825242718446602
3442,2,335,513,848,0.6530214424951267
3442,3,859,564,1423,1.5230496453900708
3443,1,10,541,551,0.018484288354898338
3444,1,167,269,436,0.620817843866171
3445,1,57,608,665,0.09375
3446,1,12,641,653,0.0187207488299532
3447,1,34,59,93,0.576271186440678
3447,2,99,253,352,0.391304347826087
3447,3,355,216,571,1.6435185185185186
3448,1,15,913,928,0.01642935377875137
3449,1,414,215,629,1.9255813953488372
3449,2,663,293,956,2.262798634812287
3449,3,1514,568,2082,2.665492957746479
3449,4,2156,662,2818,3.256797583081571
3449,5,5640,534,6174,10.561797752808989
3449,6,6220,453,6673,13.730684326710817
3449,7,6717,633,7350,10.611374407582938
3450,1,24,903,927,0.026578073089700997
3450,2,932,927,1859,1.0053937432578208
3450,3,1864,264,2128,7.0606060606060606
3450,4,2143,626,2769,3.42332268370607
3451,1,108,919,1027,0.117519042437432
3451,2,1053,901,1954,1.1687014428412874
3451,3,1958,366,2324,5.3497267759562845
3452,1,32,770,802,0.04155844155844156
3452,2,857,928,1785,0.9234913793103449
3452,3,1793,465,2258,3.8559139784946237
3453,1,60,52,112,1.1538461538461537
3453,2,118,96,214,1.2291666666666667
3453,3,223,215,438,1.0372093023255815
3453,4,444,276,720,1.608695652173913
3453,5,727,278,1005,2.615107913669065
3453,6,1012,195,1207,5.18974358974359
3453,7,1222,387,1609,3.157622739018088
3453,8,1621,467,2088,3.4710920770877944
3453,9,2112,563,2675,3.7513321492007106
3454,1,252,611,863,0.41243862520458263
3454,2,913,708,1621,1.28954802259887
3454,3,1881,1226,3107,1.534257748776509
3454,4,3315,685,4000,4.839416058394161
3454,5,4417,425,4842,10.392941176470588
3454,6,4863,922,5785,5.274403470715835
3454,7,6285,667,6952,9.422788605697152
3454,8,7208,487,7695,14.80082135523614
3455,1,73,669,742,0.10911808669656203
3456,1,166,83,249,2.0
3456,2,268,107,375,2.5046728971962615
3456,3,379,113,492,3.353982300884956
3456,4,514,118,632,4.3559322033898304
3456,5,640,122,762,5.245901639344262
3457,1,63,195,258,0.3230769230769231
3457,2,284,203,487,1.3990147783251232
3457,3,508,212,720,2.3962264150943398
3458,1,14,58,72,0.2413793103448276
3458,2,89,525,614,0.16952380952380952
3459,1,42,388,430,0.10824742268041238
3459,2,447,475,922,0.9410526315789474
3460,1,24,636,660,0.03773584905660377
3460,2,691,687,1378,1.0058224163027656
3460,3,1408,582,1990,2.4192439862542954
3460,4,2006,240,2246,8.358333333333333
3460,5,2272,532,2804,4.2706766917293235
3460,6,2826,740,3566,3.8189189189189188
3460,7,3574,390,3964,9.164102564102564
3460,8,3987,274,4261,14.55109489051095
3460,9,5059,305,5364,16.58688524590164
3460,10,5383,137,5520,39.29197080291971
3460,11,6170,85,6255,72.58823529411765
3460,12,6272,130,6402,48.246153846153845
3460,13,6453,225,6678,28.68
3460,14,6698,229,6927,29.24890829694323
3460,15,6963,183,7146,38.049180327868854
3460,16,7174,170,7344,42.2
3460,17,7360,179,7539,41.11731843575419
3460,18,7557,467,8024,16.182012847965737
3461,1,14,224,238,0.0625
3461,2,255,107,362,2.383177570093458
3461,3,367,136,503,2.698529411764706
3462,1,757,600,1357,1.2616666666666667
3462,2,1498,544,2042,2.7536764705882355
3462,3,2127,902,3029,2.358093126385809
3462,4,3034,496,3530,6.116935483870968
3462,5,3586,729,4315,4.919067215363512
3462,6,4344,397,4741,10.942065491183879
3462,7,4758,497,5255,9.57344064386318
3462,8,5263,111,5374,47.414414414414416
3462,9,5381,556,5937,9.678057553956835
3463,1,148,1789,1937,0.08272778088317496
3463,2,1980,770,2750,2.5714285714285716
3463,3,2773,785,3558,3.532484076433121
3463,4,3578,731,4309,4.894664842681259
3463,5,4337,756,5093,5.7367724867724865
3464,1,819,736,1555,1.1127717391304348
3464,2,2060,656,2716,3.1402439024390243
3464,3,2911,574,3485,5.071428571428571
3464,4,3537,965,4502,3.665284974093264
3464,5,4798,643,5441,7.461897356143079
3464,6,5715,608,6323,9.399671052631579
3465,1,318,294,612,1.0816326530612246
3465,2,621,388,1009,1.6005154639175259
3466,1,35,682,717,0.051319648093841645
3466,2,728,834,1562,0.8729016786570744
3466,3,1573,560,2133,2.8089285714285714
3467,1,195,610,805,0.319672131147541
3467,2,824,754,1578,1.0928381962864722
3467,3,1600,653,2253,2.450229709035222
3467,4,2278,747,3025,3.0495314591700136
3467,5,3041,1072,4113,2.8367537313432836
3467,6,4120,288,4408,14.305555555555555
3467,7,4423,388,4811,11.399484536082474
3467,8,4823,388,5211,12.43041237113402
3467,9,5221,1082,6303,4.82532347504621
3467,10,6308,303,6611,20.818481848184817
3467,11,6864,779,7643,8.811296534017972
3467,12,7648,11,7659,695.2727272727273
3468,1,452,315,767,1.434920634920635
3468,2,830,200,1030,4.15
3468,3,1059,322,1381,3.2888198757763973
3468,4,1446,302,1748,4.788079470198675
3468,5,1895,341,2236,5.557184750733138
3468,6,2265,296,2561,7.652027027027027
3468,7,2618,687,3305,3.8107714701601165
3468,8,3376,552,3928,6.115942028985507
3468,9,3955,502,4457,7.878486055776892
3468,10,4530,437,4967,10.366132723112129
3468,11,5053,458,5511,11.032751091703057
3468,12,5627,519,6146,10.842003853564547
3468,13,6322,473,6795,13.365750528541227
3468,14,6824,448,7272,15.232142857142858
3469,1,212,44,256,4.818181818181818
3469,2,352,103,455,3.4174757281553396
3469,3,588,369,957,1.5934959349593496
3469,4,1217,505,1722,2.40990099009901
3469,5,2026,100,2126,20.26
3469,6,2211,544,2755,4.064338235294118
3469,7,2982,519,3501,5.745664739884393
3469,8,3745,554,4299,6.759927797833935
3469,9,4729,127,4856,37.23622047244095
3469,10,5128,617,5745,8.311183144246353
3469,11,6164,117,6281,52.68376068376068
3469,12,6386,584,6970,10.934931506849315
3470,1,1346,446,1792,3.0179372197309418
3470,2,2598,632,3230,4.110759493670886
3471,1,56,1046,1102,0.05353728489483748
3471,2,1110,1081,2191,1.026827012025902
3471,3,2202,361,2563,6.099722991689751
3471,4,2602,465,3067,5.595698924731183
3471,5,3098,687,3785,4.5094614264919946
3471,6,3799,1085,4884,3.501382488479263
3471,7,4895,592,5487,8.26858108108108
3471,8,5492,752,6244,7.303191489361702
3471,9,6295,569,6864,11.063268892794376
3471,10,6870,407,7277,16.87960687960688
3471,11,7293,739,8032,9.86874154262517
3472,1,55,431,486,0.12761020881670534
3472,2,509,308,817,1.6525974025974026
3472,3,828,384,1212,2.15625
3472,4,1240,343,1583,3.6151603498542273
3472,5,1594,606,2200,2.6303630363036303
3472,6,2207,443,2650,4.981941309255079
3472,7,2659,458,3117,5.8056768558951966
3472,8,3126,159,3285,19.660377358490567
3472,9,3294,227,3521,14.51101321585903
3472,10,3557,506,4063,7.029644268774703
3473,1,56,735,791,0.0761904761904762
3473,2,847,756,1603,1.1203703703703705
3473,3,1672,752,2424,2.223404255319149
3473,4,2485,733,3218,3.390177353342428
3473,5,3286,778,4064,4.223650385604113
3473,6,4121,808,4929,5.100247524752476
3473,7,4987,729,5716,6.840877914951989
3473,8,5779,748,6527,7.725935828877005
3473,9,6585,731,7316,9.008207934336525
3474,1,145,947,1092,0.15311510031678988
3474,2,1152,294,1446,3.9183673469387754
3474,3,1486,806,2292,1.8436724565756824
3474,4,2301,98,2399,23.479591836734695
3474,5,2481,57,2538,43.526315789473685
3474,6,2814,47,2861,59.87234042553192
3474,7,4072,926,4998,4.397408207343412
3474,8,5044,191,5235,26.408376963350786
3474,9,5293,610,5903,8.677049180327868
3474,10,5994,859,6853,6.977881257275902
3474,11,6902,681,7583,10.135095447870778
3475,1,93,475,568,0.1957894736842105
3475,2,577,96,673,6.010416666666667
3475,3,686,377,1063,1.8196286472148542
3475,4,1081,423,1504,2.5555555555555554
3476,1,841,319,1160,2.6363636363636362
3476,2,2072,71,2143,29.183098591549296
3476,3,2213,561,2774,3.944741532976827
3476,4,2811,610,3421,4.608196721311476
3476,5,3453,659,4112,5.239757207890744
3476,6,4191,611,4802,6.859247135842881
3476,7,4857,734,5591,6.61716621253406
3477,1,48,570,618,0.08421052631578947
3477,2,645,242,887,2.665289256198347
3477,3,934,108,1042,8.648148148148149
3477,4,1096,112,1208,9.785714285714286
3478,1,54,45,99,1.2
3478,2,167,488,655,0.3422131147540984
3478,3,671,485,1156,1.3835051546391752
3479,1,686,613,1299,1.1190864600326265
3479,2,1334,559,1893,2.3864042933810374
3479,3,1922,513,2435,3.746588693957115
3479,4,2464,614,3078,4.013029315960912
3479,5,3105,947,4052,3.2787750791974655
3479,6,4062,463,4525,8.773218142548597
3479,7,4613,308,4921,14.977272727272727
3479,8,5196,390,5586,13.323076923076924
3480,1,1318,997,2315,1.3219658976930793
3480,2,2353,795,3148,2.959748427672956
3481,1,33,690,723,0.04782608695652174
3481,2,747,570,1317,1.3105263157894738
3481,3,1370,988,2358,1.3866396761133604
3481,4,2376,588,2964,4.040816326530612
3481,5,2990,648,3638,4.614197530864198
3481,6,3666,653,4319,5.614088820826953
3481,7,4332,313,4645,13.840255591054314
3481,8,4668,797,5465,5.856963613550816
3481,9,5524,497,6021,11.114688128772636
3481,10,6065,894,6959,6.784116331096197
3481,11,7317,441,7758,16.591836734693878
3482,1,2389,22,2411,108.5909090909091
3482,2,5544,724,6268,7.657458563535911
3482,3,6410,934,7344,6.862955032119914
3482,4,7392,714,8106,10.352941176470589
3483,1,110,422,532,0.26066350710900477
3483,2,557,656,1213,0.8490853658536586
3483,3,1296,543,1839,2.386740331491713
3483,4,1956,390,2346,5.015384615384615
3483,5,2490,465,2955,5.354838709677419
3483,6,2962,438,3400,6.762557077625571
3483,7,3407,468,3875,7.27991452991453
3483,8,3882,392,4274,9.903061224489797
3483,9,4326,427,4753,10.131147540983607
3483,10,4760,468,5228,10.17094017094017
3483,11,5235,402,5637,13.022388059701493
3483,12,5681,738,6419,7.697831978319783
3484,1,72,376,448,0.19148936170212766
3485,1,8,78,86,0.10256410256410256
3485,2,99,544,643,0.18198529411764705
3485,3,652,197,849,3.3096446700507616
3485,4,889,436,1325,2.0389908256880735
3486,1,196,84,280,2.3333333333333335
3486,2,314,419,733,0.7494033412887828
3486,3,814,345,1159,2.3594202898550725
3486,4,1168,263,1431,4.44106463878327
3486,5,1751,94,1845,18.627659574468087
3486,6,1918,451,2369,4.252771618625277
3486,7,2372,151,2523,15.708609271523178
3486,8,2701,256,2957,10.55078125
3486,9,2995,405,3400,7.395061728395062
3486,10,3441,49,3490,70.22448979591837
3486,11,3587,11,3598,326.09090909090907
3486,12,3617,199,3816,18.175879396984925
3486,13,3847,222,4069,17.32882882882883
3486,14,4191,370,4561,11.327027027027027
3486,15,4603,210,4813,21.919047619047618
3486,16,4859,532,5391,9.13345864661654
3486,17,5423,519,5942,10.448940269749519
3486,18,6063,409,6472,14.8239608801956
3486,19,6504,357,6861,18.218487394957982
3486,20,6950,66,7016,105.3030303030303
3486,21,7117,746,7863,9.540214477211796
3487,1,21,343,364,0.061224489795918366
3488,1,20,347,367,0.05763688760806916
3488,2,431,445,876,0.9685393258426966
3488,3,1064,794,1858,1.3400503778337531
3489,1,111,492,603,0.22560975609756098
3489,2,623,259,882,2.4054054054054053
3490,1,2318,476,2794,4.869747899159663
3490,2,2824,679,3503,4.159057437407953
3490,3,3544,561,4105,6.31729055258467
3490,4,5440,493,5933,11.03448275862069
3491,1,47,27,74,1.7407407407407407
3491,2,80,42,122,1.9047619047619047
3491,3,135,210,345,0.6428571428571429
3491,4,357,80,437,4.4625
3492,1,37,895,932,0.041340782122905026
3492,2,948,318,1266,2.981132075471698
3492,3,1306,722,2028,1.8088642659279779
3492,4,2063,1021,3084,2.020568070519099
3492,5,3087,247,3334,12.497975708502024
3492,6,3379,580,3959,5.825862068965518
3492,7,3992,719,4711,5.552155771905424
3492,8,4722,211,4933,22.379146919431278
3492,9,4972,716,5688,6.944134078212291
3492,10,5713,726,6439,7.869146005509642
3492,11,6477,605,7082,10.705785123966942
3492,12,7104,432,7536,16.444444444444443
3493,1,258,218,476,1.18348623853211
3493,2,903,563,1466,1.6039076376554173
3494,1,948,378,1326,2.507936507936508
3494,2,1820,998,2818,1.8236472945891784
3494,3,3468,591,4059,5.868020304568528
3494,4,4232,526,4758,8.045627376425855
3494,5,4796,505,5301,9.497029702970297
3494,6,5432,529,5961,10.26843100189036
3494,7,6074,754,6828,8.055702917771884
3494,8,6917,780,7697,8.867948717948718
3495,1,41,810,851,0.050617283950617285
3496,1,373,658,1031,0.5668693009118541
3497,1,7,177,184,0.03954802259887006
3497,2,194,376,570,0.5159574468085106
3497,3,648,609,1257,1.064039408866995
3498,1,132,945,1077,0.13968253968253969
3498,2,1083,391,1474,2.7698209718670075
3498,3,1518,166,1684,9.144578313253012
3499,1,89,838,927,0.10620525059665871
3499,2,1307,1068,2375,1.2237827715355805
3499,3,2549,697,3246,3.6571018651362985
3499,4,3594,1160,4754,3.0982758620689657
3499,5,4756,159,4915,29.91194968553459
3500,1,65,440,505,0.14772727272727273
3501,1,80,469,549,0.17057569296375266
3502,1,688,889,1577,0.7739032620922385
3503,1,218,337,555,0.6468842729970327
3503,2,575,301,876,1.910299003322259
3503,3,882,298,1180,2.959731543624161
3503,4,1201,277,1478,4.335740072202166
3503,5,1483,95,1578,15.610526315789473
3503,6,1591,196,1787,8.11734693877551
3503,7,1855,326,2181,5.690184049079755
3503,8,4341,329,4670,13.19452887537994
3503,9,4672,84,4756,55.61904761904762
3503,10,4769,148,4917,32.222972972972975
3503,11,5028,117,5145,42.97435897435897
3503,12,6329,281,6610,22.523131672597867
3503,13,7072,263,7335,26.88973384030418
3503,14,7372,251,7623,29.37051792828685
3503,15,7742,102,7844,75.90196078431373
3504,1,49,118,167,0.4152542372881356
3504,2,1723,416,2139,4.141826923076923
3504,3,2170,179,2349,12.12290502793296
3504,4,2358,328,2686,7.189024390243903
3504,5,2723,109,2832,24.98165137614679
3504,6,2865,353,3218,8.11614730878187
3504,7,3235,178,3413,18.174157303370787
3504,8,3426,229,3655,14.960698689956331
3504,9,3682,381,4063,9.664041994750656
3504,10,4071,189,4260,21.53968253968254
3504,11,4278,259,4537,16.517374517374517
3504,12,4553,228,4781,19.969298245614034
3504,13,4798,233,5031,20.59227467811159
3504,14,5039,258,5297,19.531007751937985
3504,15,5321,164,5485,32.44512195121951
3504,16,5494,228,5722,24.096491228070175
3504,17,5732,249,5981,23.02008032128514
3504,18,5997,320,6317,18.740625
3504,19,6358,328,6686,19.384146341463413
3504,20,6701,414,7115,16.185990338164252
3504,21,7148,274,7422,26.087591240875913
3504,22,7435,272,7707,27.334558823529413
3504,23,7741,260,8001,29.773076923076925
3505,1,63,511,574,0.1232876712328767
3505,2,614,811,1425,0.7570900123304563
3505,3,1461,516,1977,2.8313953488372094
3505,4,1989,448,2437,4.439732142857143
3505,5,2498,733,3231,3.407912687585266
3505,6,3236,689,3925,4.696661828737301
3505,7,3930,670,4600,5.865671641791045
3505,8,4604,624,5228,7.378205128205129
3505,9,5235,556,5791,9.41546762589928
3505,10,5795,708,6503,8.185028248587571
3505,11,6506,684,7190,9.511695906432749
3505,12,7193,692,7885,10.394508670520231
3506,1,62,348,410,0.1781609195402299
3506,2,422,68,490,6.205882352941177
3506,3,505,381,886,1.3254593175853018
3506,4,905,361,1266,2.5069252077562325
3507,1,9,20,29,0.45
3507,2,88,49,137,1.7959183673469388
3507,3,149,368,517,0.4048913043478261
3507,4,526,93,619,5.655913978494624
3507,5,623,145,768,4.296551724137931
3507,6,816,306,1122,2.6666666666666665
3507,7,1169,198,1367,5.904040404040404
3507,8,1405,171,1576,8.216374269005849
3507,9,1628,39,1667,41.743589743589745
3507,10,1734,27,1761,64.22222222222223
3507,11,1769,163,1932,10.85276073619632
3507,12,1967,125,2092,15.736
3508,1,564,303,867,1.8613861386138615
3508,2,1081,1203,2284,0.8985868661679135
3508,3,2526,1075,3601,2.349767441860465
3508,4,4349,796,5145,5.46356783919598
3509,1,13,132,145,0.09848484848484848
3510,1,44,295,339,0.14915254237288136
3510,2,352,103,455,3.4174757281553396
3510,3,471,98,569,4.8061224489795915
3511,1,459,577,1036,0.7954939341421143
3511,2,1563,571,2134,2.7373029772329245
3511,3,2581,837,3418,3.08363201911589
3511,4,3957,768,4725,5.15234375
3512,1,1204,482,1686,2.4979253112033195
3513,1,19,394,413,0.048223350253807105
3514,1,30,686,716,0.043731778425655975
3515,1,63,925,988,0.0681081081081081
3516,1,56,553,609,0.10126582278481013
3516,2,642,416,1058,1.5432692307692308
3516,3,1082,649,1731,1.6671802773497688
3516,4,1755,621,2376,2.8260869565217392
3516,5,2398,519,2917,4.6204238921001926
3516,6,2938,621,3559,4.731078904991948
3516,7,3584,1056,4640,3.393939393939394
3516,8,4665,861,5526,5.418118466898955
3517,1,27,676,703,0.03994082840236687
3517,2,727,458,1185,1.5873362445414847
3517,3,1203,588,1791,2.045918367346939
3517,4,1801,682,2483,2.6407624633431084
3518,1,19,760,779,0.025
3518,2,788,551,1339,1.4301270417422867
3519,1,20,720,740,0.027777777777777776
3520,1,16,85,101,0.18823529411764706
3520,2,119,602,721,0.19767441860465115
3520,3,739,261,1000,2.8314176245210727
3520,4,1014,652,1666,1.5552147239263803
3520,5,1680,426,2106,3.943661971830986
3521,1,10,415,425,0.024096385542168676
3522,1,1850,517,2367,3.5783365570599615
3522,2,4221,428,4649,9.86214953271028
3522,3,6511,390,6901,16.694871794871794
3523,1,85,851,936,0.099882491186839
3523,2,938,505,1443,1.8574257425742575
3523,3,1463,417,1880,3.5083932853717026
3524,1,398,472,870,0.8432203389830508
3524,2,1554,546,2100,2.8461538461538463
3524,3,2201,1205,3406,1.8265560165975103
3524,4,3411,18,3429,189.5
3524,5,3437,508,3945,6.765748031496063
3524,6,3960,91,4051,43.51648351648352
3524,7,4068,107,4175,38.018691588785046
3524,8,4197,103,4300,40.74757281553398
3524,9,4308,70,4378,61.542857142857144
3525,1,27,1072,1099,0.025186567164179104
3525,2,1107,795,1902,1.3924528301886792
3525,3,1926,1071,2997,1.7983193277310925
3525,4,3005,395,3400,7.6075949367088604
3525,5,3408,623,4031,5.470304975922954
3526,1,112,309,421,0.36245954692556637
3527,1,145,20,165,7.25
3527,2,198,28,226,7.071428571428571
3527,3,357,54,411,6.611111111111111
3527,4,519,57,576,9.105263157894736
3527,5,663,236,899,2.809322033898305
3527,6,966,401,1367,2.4089775561097255
3527,7,1423,232,1655,6.133620689655173
3527,8,1673,447,2120,3.742729306487696
3528,1,129,147,276,0.8775510204081632
3528,2,296,508,804,0.5826771653543307
3529,1,213,443,656,0.48081264108352145
3529,2,664,433,1097,1.533487297921478
3529,3,1105,568,1673,1.9454225352112675
3529,4,1685,251,1936,6.713147410358566
3529,5,1947,321,2268,6.065420560747664
3530,1,71,540,611,0.13148148148148148
3530,2,620,527,1147,1.1764705882352942
3531,1,75,513,588,0.14619883040935672
3532,1,83,528,611,0.1571969696969697
3532,2,622,900,1522,0.6911111111111111
3532,3,1535,188,1723,8.164893617021276
3532,4,1756,557,2313,3.1526032315978454
3532,5,2320,614,2934,3.778501628664495
3532,6,2942,422,3364,6.971563981042654
3533,1,81,194,275,0.4175257731958763
3533,2,282,210,492,1.3428571428571427
3533,3,510,230,740,2.217391304347826
3533,4,753,191,944,3.9424083769633507
3533,5,1041,150,1191,6.94
3533,6,1272,236,1508,5.389830508474576
3533,7,1516,78,1594,19.435897435897434
3533,8,1612,349,1961,4.6189111747851
3533,9,1964,41,2005,47.90243902439025
3534,1,815,290,1105,2.810344827586207
3535,1,23,611,634,0.03764320785597381
3536,1,37,482,519,0.07676348547717843
3537,1,65,754,819,0.08620689655172414
3537,2,830,609,1439,1.3628899835796386
3537,3,1498,889,2387,1.68503937007874
3537,4,2395,437,2832,5.480549199084668
3538,1,488,244,732,2.0
3539,1,194,345,539,0.5623188405797102
3539,2,542,295,837,1.8372881355932202
3539,3,841,93,934,9.043010752688172
3539,4,1074,278,1352,3.8633093525179856
3539,5,1395,313,1708,4.456869009584665
3539,6,1741,358,2099,4.863128491620111
3539,7,2102,295,2397,7.125423728813559
3539,8,2517,390,2907,6.453846153846154
3539,9,2910,363,3273,8.016528925619834
3539,10,3276,368,3644,8.902173913043478
3539,11,3720,341,4061,10.909090909090908
3539,12,4064,322,4386,12.621118012422361
3539,13,4417,328,4745,13.466463414634147
3539,14,4748,136,4884,34.911764705882355
3539,15,5010,353,5363,14.192634560906516
3539,16,5366,211,5577,25.43127962085308
3539,17,5644,313,5957,18.031948881789138
3539,18,5976,344,6320,17.372093023255815
3539,19,6369,334,6703,19.068862275449103
3539,20,6770,332,7102,20.39156626506024
3539,21,7105,289,7394,24.58477508650519
3539,22,7397,136,7533,54.38970588235294
3540,1,18,87,105,0.20689655172413793
3540,2,116,71,187,1.6338028169014085
3540,3,1418,1101,2519,1.287920072661217
3540,4,2530,1074,3604,2.355679702048417
3540,5,3615,372,3987,9.71774193548387
3540,6,4030,1036,5066,3.88996138996139
3540,7,5077,491,5568,10.340122199592669
3540,8,5590,867,6457,6.447520184544406
3540,9,6475,107,6582,60.51401869158879
3540,10,6631,190,6821,34.9
3540,11,6836,767,7603,8.91264667535854
3540,12,7616,135,7751,56.41481481481482
3540,13,7764,171,7935,45.40350877192982
3541,1,136,354,490,0.384180790960452
3541,2,498,327,825,1.5229357798165137
3541,3,833,339,1172,2.4572271386430677
3542,1,16,537,553,0.0297951582867784
3542,2,581,625,1206,0.9296
3542,3,1216,248,1464,4.903225806451613
3542,4,1473,114,1587,12.921052631578947
3542,5,1598,39,1637,40.97435897435897
3542,6,1647,39,1686,42.23076923076923
3542,7,1693,65,1758,26.046153846153846
3543,1,29,774,803,0.037467700258397935
3543,2,829,906,1735,0.9150110375275938
3543,3,1766,976,2742,1.8094262295081966
3543,4,2767,930,3697,2.975268817204301
3543,5,3732,825,4557,4.5236363636363635
3544,1,7,231,238,0.030303030303030304
3545,1,18,147,165,0.12244897959183673
3545,2,184,205,389,0.8975609756097561
3545,3,398,199,597,2.0
3545,4,608,295,903,2.0610169491525423
3545,5,918,92,1010,9.978260869565217
3546,1,152,494,646,0.3076923076923077
3546,2,648,46,694,14.08695652173913
3546,3,759,406,1165,1.8694581280788178
3546,4,1167,226,1393,5.163716814159292
3546,5,1419,369,1788,3.845528455284553
3547,1,79,676,755,0.11686390532544379
3547,2,783,503,1286,1.5566600397614314
3547,3,1295,688,1983,1.882267441860465
3547,4,2005,197,2202,10.17766497461929
3547,5,2210,569,2779,3.8840070298769773
3547,6,2813,10,2823,281.3
3547,7,2834,443,3277,6.397291196388262
3547,8,3368,554,3922,6.07942238267148
3547,9,3970,967,4937,4.105480868665977
3547,10,4947,909,5856,5.442244224422442
3547,11,5875,748,6623,7.85427807486631
3547,12,6646,662,7308,10.039274924471298
3548,1,91,618,709,0.14724919093851133
3549,1,129,667,796,0.1934032983508246
3549,2,860,910,1770,0.945054945054945
3549,3,1900,733,2633,2.592087312414734
3549,4,2651,581,3232,4.562822719449225
3550,1,208,586,794,0.35494880546075086
3550,2,831,566,1397,1.4681978798586572
3550,3,1433,507,1940,2.826429980276134
3551,1,18,320,338,0.05625
3551,2,1347,997,2344,1.3510531594784354
3551,3,2388,1053,3441,2.2678062678062676
3551,4,3541,678,4219,5.222713864306785
3552,1,1423,929,2352,1.5317545748116255
3552,2,2360,911,3271,2.5905598243688255
3552,3,3287,263,3550,12.49809885931559
3552,4,4155,37,4192,112.29729729729729
3552,5,4806,338,5144,14.218934911242604
3553,1,794,65,859,12.215384615384615
3553,2,871,146,1017,5.965753424657534
3554,1,32,781,813,0.040973111395646605
3554,2,834,1025,1859,0.8136585365853658
3554,3,1869,209,2078,8.942583732057416
3554,4,2123,437,2560,4.85812356979405
3554,5,2597,322,2919,8.065217391304348
3555,1,37,429,466,0.08624708624708624
3555,2,502,308,810,1.62987012987013
3556,1,227,930,1157,0.24408602150537634
3556,2,1170,574,1744,2.038327526132404
3556,3,1818,638,2456,2.8495297805642634
3556,4,2471,620,3091,3.985483870967742
3556,5,3106,554,3660,5.606498194945848
3557,1,22,122,144,0.18032786885245902
3557,2,163,514,677,0.31712062256809337
3557,3,730,512,1242,1.42578125
3557,4,1245,602,1847,2.068106312292359
3558,1,129,147,276,0.8775510204081632
3558,2,296,508,804,0.5826771653543307
3558,3,822,215,1037,3.8232558139534882
3559,1,19,985,1004,0.019289340101522844
3559,2,1066,881,1947,1.209988649262202
3560,1,15,286,301,0.05244755244755245
3561,1,22,1078,1100,0.02040816326530612
3562,1,20,112,132,0.17857142857142858
3562,2,193,82,275,2.3536585365853657
3563,1,19,3,22,6.333333333333333
3564,1,4335,442,4777,9.807692307692308
3564,2,5020,540,5560,9.296296296296296
3564,3,5764,445,6209,12.952808988764044
3564,4,6221,559,6780,11.128801431127012
3564,5,6848,361,7209,18.969529085872576
3564,6,7312,399,7711,18.325814536340854
3565,1,38,46,84,0.8260869565217391
3565,2,227,585,812,0.38803418803418804
3565,3,911,5,916,182.2
3565,4,1428,5,1433,285.6
3565,5,3160,5,3165,632.0
3565,6,4489,5,4494,897.8
3565,7,6692,5,6697,1338.4
3565,8,8014,5,8019,1602.8
3566,1,1137,555,1692,2.0486486486486486
3566,2,2813,472,3285,5.959745762711864
3566,3,4291,476,4767,9.014705882352942
3566,4,5909,574,6483,10.294425087108014
3567,1,27,513,540,0.05263157894736842
3568,1,147,420,567,0.35
3569,1,16,94,110,0.1702127659574468
3569,2,118,92,210,1.2826086956521738
3570,1,1199,418,1617,2.8684210526315788
3570,2,1653,536,2189,3.083955223880597
3570,3,2206,469,2675,4.70362473347548
3570,4,2692,478,3170,5.631799163179917
3570,5,3187,487,3674,6.544147843942505
3570,6,3691,489,4180,7.548057259713701
3570,7,4197,548,4745,7.658759124087592
3570,8,4762,558,5320,8.53405017921147
3570,9,5337,671,6008,7.9538002980625935
3570,10,6025,453,6478,13.300220750551876
3570,11,6514,585,7099,11.135042735042735
3570,12,7144,550,7694,12.989090909090908
3571,1,22,328,350,0.06707317073170732
3571,2,366,362,728,1.011049723756906
3572,1,20,342,362,0.05847953216374269
3573,1,16,385,401,0.04155844155844156
3573,2,410,342,752,1.1988304093567252
3574,1,23,501,524,0.04590818363273453
3574,2,538,477,1015,1.1278825995807127
3575,1,146,923,1069,0.1581798483206934
3575,2,1083,761,1844,1.4231274638633378
3575,3,1860,949,2809,1.9599578503688093
3576,1,232,454,686,0.5110132158590308
3577,1,17,186,203,0.0913978494623656
3577,2,430,714,1144,0.6022408963585434
3577,3,1215,843,2058,1.4412811387900355
3577,4,2129,973,3102,2.188078108941418
3577,5,3106,357,3463,8.700280112044817
3577,6,3490,229,3719,15.240174672489083
3577,7,3838,664,4502,5.780120481927711
3577,8,4516,631,5147,7.15689381933439
3577,9,5481,464,5945,11.8125
3577,10,6439,745,7184,8.642953020134229
3577,11,7253,206,7459,35.20873786407767
3577,12,7639,371,8010,20.590296495956874
3578,1,62,3,65,20.666666666666668
3578,2,77,50,127,1.54
3578,3,150,69,219,2.1739130434782608
3578,4,228,48,276,4.75
3579,1,603,982,1585,0.6140529531568228
3579,2,1601,647,2248,2.474497681607419
3580,1,116,959,1075,0.12095933263816476
3580,2,1077,277,1354,3.888086642599278
3581,1,8,36,44,0.2222222222222222
3582,1,21,735,756,0.02857142857142857
3583,1,56,74,130,0.7567567567567568
3583,2,146,57,203,2.56140350877193
3583,3,2845,737,3582,3.8602442333785616
3583,4,5239,400,5639,13.0975
3583,5,6960,297,7257,23.434343434343436
3583,6,7315,735,8050,9.952380952380953
3584,1,39,502,541,0.07768924302788845
3584,2,547,487,1034,1.1232032854209446
3585,1,93,631,724,0.1473851030110935
3586,1,174,307,481,0.5667752442996743
3587,1,173,79,252,2.189873417721519
3588,1,13,585,598,0.022222222222222223
3588,2,644,911,1555,0.7069154774972558
3588,3,1558,210,1768,7.419047619047619
3588,4,1844,873,2717,2.1122565864833907
3588,5,2719,184,2903,14.777173913043478
3588,6,3014,970,3984,3.107216494845361
3588,7,4013,821,4834,4.887941534713764
3588,8,4868,594,5462,8.195286195286196
3588,9,5532,468,6000,11.820512820512821
3588,10,6039,201,6240,30.044776119402986
3588,11,6352,195,6547,32.57435897435897
3588,12,6581,365,6946,18.03013698630137
3588,13,7025,313,7338,22.44408945686901
3588,14,7403,245,7648,30.216326530612246
3588,15,7692,249,7941,30.89156626506024
3589,1,51,165,216,0.3090909090909091
3590,1,724,574,1298,1.2613240418118468
3590,2,1345,615,1960,2.186991869918699
3590,3,1975,616,2591,3.206168831168831
3590,4,2606,578,3184,4.508650519031142
3591,1,34,557,591,0.06104129263913824
3591,2,631,420,1051,1.5023809523809524
3592,1,123,601,724,0.20465890183028287
3592,2,780,770,1550,1.0129870129870129
3593,1,20,244,264,0.08196721311475409
3593,2,273,84,357,3.25
3593,3,573,268,841,2.138059701492537
3593,4,866,489,1355,1.770961145194274
3593,5,1409,593,2002,2.3760539629005057
3593,6,2106,595,2701,3.5394957983193276
3593,7,2728,616,3344,4.428571428571429
3593,8,3399,442,3841,7.6900452488687785
3593,9,3865,497,4362,7.776659959758551
3594,1,15,573,588,0.02617801047120419
3594,2,600,648,1248,0.9259259259259259
3594,3,1316,703,2019,1.871977240398293
3594,4,2037,719,2756,2.8331015299026427
3594,5,2815,948,3763,2.969409282700422
3594,6,3780,994,4774,3.8028169014084505
3594,7,4781,158,4939,30.259493670886076
3594,8,4953,727,5680,6.81292984869326
3594,9,5690,649,6339,8.767334360554699
3594,10,6374,767,7141,8.310299869621904
3595,1,27,351,378,0.07692307692307693
3595,2,388,495,883,0.7838383838383839
3595,3,897,346,1243,2.592485549132948
3595,4,1266,487,1753,2.59958932238193
3596,1,48,872,920,0.05504587155963303
3596,2,923,463,1386,1.9935205183585314
3596,3,1402,143,1545,9.804195804195805
3596,4,1567,301,1868,5.205980066445183
3596,5,1907,421,2328,4.529691211401425
3597,1,51,540,591,0.09444444444444444
3598,1,99,239,338,0.41422594142259417
3598,2,629,236,865,2.6652542372881354
3598,3,988,756,1744,1.306878306878307
3598,4,1840,501,2341,3.6726546906187623
3598,5,2585,798,3383,3.2393483709273183
3598,6,3667,742,4409,4.942048517520216
3598,7,4463,744,5207,5.998655913978495
3598,8,5269,583,5852,9.037735849056604
3599,1,57,32,89,1.78125
3599,2,111,211,322,0.5260663507109005
3600,1,38,414,452,0.09178743961352658
3600,2,523,475,998,1.1010526315789473
3601,1,50,444,494,0.11261261261261261
3601,2,540,534,1074,1.0112359550561798
3601,3,1120,440,1560,2.5454545454545454
3601,4,1569,566,2135,2.7720848056537104
3601,5,2172,524,2696,4.145038167938932
3601,6,2744,535,3279,5.128971962616823
3601,7,3298,497,3795,6.635814889336016
3601,8,3811,672,4483,5.6711309523809526
3601,9,5335,775,6110,6.883870967741935
3601,10,6201,742,6943,8.357142857142858
3602,1,26,479,505,0.054279749478079335
3602,2,529,718,1247,0.7367688022284122
3602,3,1366,813,2179,1.6801968019680196
3602,4,2211,840,3051,2.632142857142857
3602,5,3116,791,3907,3.939317319848293
3602,6,4130,938,5068,4.402985074626866
3602,7,5081,908,5989,5.595814977973569
3603,1,14,184,198,0.07608695652173914
3603,2,229,398,627,0.5753768844221105
3603,3,718,447,1165,1.6062639821029083
3603,4,1202,569,1771,2.1124780316344465
3603,5,1782,482,2264,3.6970954356846475
3604,1,654,327,981,2.0
3604,2,993,323,1316,3.0743034055727554
3604,3,1352,592,1944,2.2837837837837838
3604,4,1971,360,2331,5.475
3605,1,328,383,711,0.856396866840731
3605,2,877,495,1372,1.7717171717171718
3605,3,1392,425,1817,3.275294117647059
3605,4,1844,466,2310,3.9570815450643777
3605,5,2330,169,2499,13.78698224852071
3606,1,997,253,1250,3.940711462450593
3606,2,1300,335,1635,3.8805970149253732
3606,3,1703,387,2090,4.4005167958656335
3606,4,2135,280,2415,7.625
3606,5,2451,588,3039,4.168367346938775
3606,6,3584,315,3899,11.377777777777778
3606,7,3937,135,4072,29.16296296296296
3606,8,4111,671,4782,6.126676602086438
3606,9,4828,316,5144,15.278481012658228
3606,10,5193,415,5608,12.513253012048192
3606,11,6518,112,6630,58.19642857142857
3606,12,6679,494,7173,13.520242914979757
3606,13,7215,174,7389,41.46551724137931
3606,14,7434,161,7595,46.17391304347826
3607,1,239,546,785,0.43772893772893773
3607,2,795,202,997,3.9356435643564356
3608,1,1056,54,1110,19.555555555555557
3608,2,3061,334,3395,9.164670658682635
3608,3,4102,525,4627,7.8133333333333335
3608,4,5398,623,6021,8.664526484751203
3609,1,173,995,1168,0.17386934673366833
3609,2,1209,511,1720,2.3659491193737767
3610,1,24,401,425,0.059850374064837904
3610,2,451,299,750,1.508361204013378
3610,3,763,519,1282,1.4701348747591523
3610,4,1296,562,1858,2.306049822064057
3610,5,1870,348,2218,5.373563218390805
3610,6,2243,308,2551,7.282467532467533
3610,7,2561,407,2968,6.292383292383293
3610,8,2983,307,3290,9.716612377850163
3610,9,3321,269,3590,12.345724907063197
3610,10,3608,409,4017,8.821515892420537
3610,11,4034,307,4341,13.140065146579804
3611,1,262,112,374,2.3392857142857144
3611,2,1282,105,1387,12.209523809523809
3611,3,1393,185,1578,7.52972972972973
3611,4,1584,592,2176,2.675675675675676
3611,5,2182,526,2708,4.14828897338403
3611,6,2714,556,3270,4.881294964028777
3611,7,3276,490,3766,6.685714285714286
3611,8,3772,462,4234,8.164502164502165
3611,9,4240,213,4453,19.906103286384976
3611,10,4459,796,5255,5.601758793969849
3611,11,5261,772,6033,6.814766839378239
3611,12,6039,805,6844,7.501863354037267
3611,13,6850,646,7496,10.603715170278639
3612,1,64,628,692,0.10191082802547771
3613,1,251,344,595,0.7296511627906976
3613,2,626,349,975,1.7936962750716332
3613,3,984,79,1063,12.455696202531646
3613,4,1071,344,1415,3.113372093023256
3613,5,1692,507,2199,3.337278106508876
3613,6,2213,384,2597,5.763020833333333
3614,1,81,550,631,0.14727272727272728
3615,1,2782,491,3273,5.665987780040733
3615,2,3294,510,3804,6.458823529411765
3615,3,3825,358,4183,10.684357541899441
3615,4,4204,234,4438,17.965811965811966
3616,1,188,472,660,0.3983050847457627
3616,2,684,507,1191,1.349112426035503
3616,3,1211,510,1721,2.3745098039215686
3616,4,1747,62,1809,28.177419354838708
3616,5,5846,104,5950,56.21153846153846
3616,6,5983,78,6061,76.7051282051282
3616,7,6094,53,6147,114.98113207547169
3617,1,42,755,797,0.05562913907284768
3617,2,801,784,1585,1.0216836734693877
3617,3,1602,856,2458,1.8714953271028036
3617,4,2465,837,3302,2.945041816009558
3617,5,3322,30,3352,110.73333333333333
3617,6,3357,529,3886,6.34593572778828
3618,1,4,25,29,0.16
3618,2,59,34,93,1.7352941176470589
3618,3,3433,42,3475,81.73809523809524
3618,4,6262,12,6274,521.8333333333334
3618,5,6393,46,6439,138.97826086956522
3618,6,6564,360,6924,18.233333333333334
3618,7,6932,560,7492,12.378571428571428
3619,1,31,927,958,0.03344120819848975
3620,1,2115,367,2482,5.762942779291553
3620,2,2667,426,3093,6.26056338028169
3620,3,3320,534,3854,6.217228464419476
3621,1,65,30,95,2.1666666666666665
3621,2,188,824,1012,0.22815533980582525
3621,3,1020,232,1252,4.396551724137931
3622,1,262,129,391,2.0310077519379846
3622,2,934,117,1051,7.982905982905983
3622,3,1057,215,1272,4.916279069767442
3622,4,1278,753,2031,1.697211155378486
3622,5,2037,628,2665,3.2436305732484074
3622,6,2671,892,3563,2.9943946188340806
3622,7,3569,590,4159,6.049152542372881
3622,8,4165,837,5002,4.97610513739546
3622,9,5008,638,5646,7.849529780564263
3622,10,5652,863,6515,6.549246813441483
3622,11,6521,397,6918,16.425692695214106
3623,1,58,792,850,0.07323232323232323
3623,2,869,135,1004,6.437037037037037
3623,3,1029,175,1204,5.88
3623,4,1224,108,1332,11.333333333333334
3623,5,1361,1148,2509,1.1855400696864111
3623,6,2514,1123,3637,2.238646482635797
3623,7,3642,1139,4781,3.1975417032484637
3623,8,4808,1060,5868,4.535849056603774
3623,9,5873,1088,6961,5.397977941176471
3623,10,6966,897,7863,7.765886287625418
3623,11,7889,209,8098,37.74641148325359
3624,1,19,565,584,0.033628318584070796
3624,2,592,540,1132,1.0962962962962963
3625,1,926,369,1295,2.5094850948509486
3626,1,26,349,375,0.07449856733524356
3626,2,377,330,707,1.1424242424242423
3626,3,726,351,1077,2.0683760683760686
3626,4,1102,315,1417,3.4984126984126984
3626,5,1444,435,1879,3.3195402298850576
3626,6,1897,317,2214,5.9842271293375395
3626,7,2217,315,2532,7.038095238095238
3626,8,2534,286,2820,8.86013986013986
3626,9,2824,53,2877,53.283018867924525
3626,10,2892,62,2954,46.645161290322584
3627,1,19,332,351,0.0572289156626506
3627,2,409,1017,1426,0.40216322517207476
3628,1,438,685,1123,0.6394160583941606
3628,2,1147,1047,2194,1.0955109837631327
3628,3,2197,239,2436,9.192468619246862
3628,4,2461,793,3254,3.103404791929382
3629,1,118,894,1012,0.1319910514541387
3630,1,41,538,579,0.0762081784386617
3630,2,589,658,1247,0.8951367781155015
3631,1,227,1042,1269,0.21785028790786948
3631,2,1277,826,2103,1.5460048426150121
3631,3,2137,374,2511,5.713903743315508
3632,1,42,860,902,0.04883720930232558
3632,2,1079,693,1772,1.556998556998557
3632,3,1870,661,2531,2.8290468986384267
3632,4,2933,487,3420,6.02258726899384
3632,5,3439,596,4035,5.77013422818792
3632,6,4058,862,4920,4.707656612529003
3632,7,5035,172,5207,29.273255813953487
3632,8,6285,643,6928,9.774494556765163
3632,9,7024,621,7645,11.310789049919485
3633,1,168,209,377,0.8038277511961722
3633,2,488,270,758,1.8074074074074074
3633,3,904,758,1662,1.1926121372031662
3633,4,1772,95,1867,18.652631578947368
3633,5,1912,123,2035,15.544715447154472
3633,6,2156,375,2531,5.749333333333333
3634,1,33,683,716,0.048316251830161056
3634,2,720,797,1517,0.903387703889586
3634,3,1525,712,2237,2.1418539325842696
3634,4,2247,743,2990,3.024226110363392
3634,5,3006,434,3440,6.926267281105991
3635,1,919,218,1137,4.215596330275229
3635,2,1182,36,1218,32.833333333333336
3635,3,1276,33,1309,38.666666666666664
3635,4,1340,40,1380,33.5
3635,5,1471,76,1547,19.355263157894736
3635,6,1647,24,1671,68.625
3635,7,1711,38,1749,45.026315789473685
3636,1,12,351,363,0.03418803418803419
3636,2,372,611,983,0.6088379705400983
3636,3,1007,230,1237,4.378260869565217
3636,4,1250,631,1881,1.9809825673534074
3636,5,1900,835,2735,2.2754491017964074
3636,6,2756,635,3391,4.340157480314961
3636,7,3431,833,4264,4.118847539015606
3636,8,4289,430,4719,9.974418604651163
3636,9,4732,158,4890,29.949367088607595
3636,10,4896,304,5200,16.105263157894736
3636,11,5219,115,5334,45.38260869565217
3636,12,5347,488,5835,10.956967213114755
3636,13,5845,640,6485,9.1328125
3636,14,6497,910,7407,7.13956043956044
3637,1,29,1769,1798,0.01639344262295082
3637,2,1907,1207,3114,1.579950289975145
3637,3,3511,1569,5080,2.2377310388782665
3637,4,5252,1301,6553,4.036894696387394
3638,1,17,469,486,0.03624733475479744
3639,1,23,703,726,0.032716927453769556
3640,1,46,269,315,0.17100371747211895
3640,2,322,412,734,0.7815533980582524
3640,3,753,388,1141,1.940721649484536
3640,4,1220,12,1232,101.66666666666667
3640,5,1245,21,1266,59.285714285714285
3640,6,1293,406,1699,3.184729064039409
3640,7,1727,770,2497,2.242857142857143
3641,1,58,609,667,0.09523809523809523
3642,1,23,265,288,0.08679245283018867
3643,1,421,482,903,0.8734439834024896
3643,2,936,490,1426,1.910204081632653
3643,3,1447,488,1935,2.9651639344262297
3643,4,1982,510,2492,3.8862745098039215
3643,5,2559,512,3071,4.998046875
3644,1,154,747,901,0.20615796519410978
3644,2,938,289,1227,3.245674740484429
3644,3,1264,283,1547,4.46643109540636
3644,4,1576,681,2257,2.31424375917768
3645,1,247,672,919,0.36755952380952384
3646,1,43,575,618,0.07478260869565218
3646,2,688,872,1560,0.7889908256880734
3646,3,1583,769,2352,2.05851755526658
3646,4,2399,613,3012,3.9135399673735725
3646,5,3044,661,3705,4.605143721633888
3646,6,3757,679,4436,5.533136966126657
3646,7,4452,587,5039,7.584327086882453
3646,8,5079,470,5549,10.806382978723404
3646,9,5564,583,6147,9.543739279588337
3646,10,6165,464,6629,13.286637931034482
3646,11,6669,812,7481,8.213054187192117
3646,12,7584,517,8101,14.669245647969053
3647,1,835,892,1727,0.9360986547085202
3647,2,1794,523,2317,3.4302103250478013
3647,3,2370,140,2510,16.928571428571427
3647,4,2545,875,3420,2.9085714285714284
3647,5,3431,534,3965,6.425093632958801
3647,6,3985,595,4580,6.697478991596639
3648,1,25,645,670,0.03875968992248062
3648,2,682,493,1175,1.383367139959432
3648,3,1253,498,1751,2.5160642570281126
3648,4,1780,535,2315,3.3271028037383177
3649,1,502,25,527,20.08
3649,2,542,123,665,4.40650406504065
3649,3,678,123,801,5.512195121951219
3650,1,34,672,706,0.050595238095238096
3650,2,718,539,1257,1.3320964749536177
3650,3,1303,543,1846,2.3996316758747698
3650,4,1881,582,2463,3.231958762886598
3651,1,172,359,531,0.479108635097493
3651,2,646,566,1212,1.1413427561837455
3651,3,1229,183,1412,6.715846994535519
3651,4,1660,537,2197,3.091247672253259
3651,5,2202,353,2555,6.237960339943343
3651,6,2570,639,3209,4.021909233176839
3651,7,3227,289,3516,11.166089965397925
3651,8,3523,319,3842,11.043887147335424
3651,9,3850,480,4330,8.020833333333334
3651,10,4335,188,4523,23.05851063829787
3651,11,4531,429,4960,10.561771561771561
3652,1,113,541,654,0.2088724584103512
3653,1,49,101,150,0.48514851485148514
3653,2,165,158,323,1.0443037974683544
3653,3,339,163,502,2.079754601226994
3653,4,532,478,1010,1.112970711297071
3653,5,1019,525,1544,1.940952380952381
3653,6,1559,82,1641,19.01219512195122
3653,7,3001,499,3500,6.014028056112225
3653,8,7309,59,7368,123.88135593220339
3653,9,7383,30,7413,246.1
3654,1,250,475,725,0.5263157894736842
3655,1,41,419,460,0.09785202863961814
3655,2,612,768,1380,0.796875
3655,3,1551,746,2297,2.079088471849866
3655,4,2754,2846,5600,0.9676739283204497
3656,1,19,487,506,0.039014373716632446
3656,2,563,881,1444,0.6390465380249716
3656,3,1474,821,2295,1.7953714981729598
3656,4,2329,966,3295,2.410973084886128
3656,5,3313,1006,4319,3.29324055666004
3656,6,4375,285,4660,15.350877192982455
3656,7,4714,317,5031,14.870662460567823
3656,8,5131,596,5727,8.609060402684564
3656,9,5762,952,6714,6.052521008403361
3656,10,6782,964,7746,7.035269709543568
3657,1,409,760,1169,0.5381578947368421
3657,2,1203,199,1402,6.045226130653266
3657,3,1521,560,2081,2.7160714285714285
3657,4,2172,700,2872,3.1028571428571428
3657,5,2925,476,3401,6.144957983193278
3657,6,3431,596,4027,5.756711409395973
3657,7,4054,600,4654,6.756666666666667
3658,1,16,686,702,0.023323615160349854
3659,1,565,1028,1593,0.5496108949416343
3659,2,1598,230,1828,6.947826086956522
3660,1,27,22,49,1.2272727272727273
3660,2,199,550,749,0.3618181818181818
3660,3,795,35,830,22.714285714285715
3660,4,1718,658,2376,2.6109422492401215
3660,5,3294,701,3995,4.699001426533523
3660,6,4005,31,4036,129.19354838709677
3660,7,4997,720,5717,6.940277777777778
3660,8,5784,643,6427,8.995334370139968
3660,9,6473,350,6823,18.494285714285713
3660,10,6852,649,7501,10.557781201848998
3660,11,7556,503,8059,15.021868787276341
3661,1,94,648,742,0.14506172839506173
3661,2,791,668,1459,1.1841317365269461
3662,1,9,21,30,0.42857142857142855
3662,2,201,764,965,0.2630890052356021
3662,3,1272,99,1371,12.848484848484848
3662,4,1438,669,2107,2.1494768310911807
3662,5,2109,78,2187,27.03846153846154
3662,6,2241,593,2834,3.779089376053963
3662,7,2860,548,3408,5.218978102189781
3662,8,3434,500,3934,6.868
3662,9,3956,592,4548,6.6824324324324325
3663,1,60,381,441,0.15748031496062992
3664,1,38,542,580,0.07011070110701106
3664,2,622,652,1274,0.9539877300613497
3664,3,1383,573,1956,2.413612565445026
3664,4,2032,574,2606,3.5400696864111496
3664,5,2665,279,2944,9.551971326164875
3664,6,2975,307,3282,9.690553745928339
3664,7,3556,954,4510,3.7274633123689727
3664,8,4551,666,5217,6.833333333333333
3664,9,5233,374,5607,13.991978609625669
3664,10,5618,712,6330,7.890449438202247
3664,11,6501,878,7379,7.404328018223235
3664,12,7394,217,7611,34.07373271889401
3665,1,1042,267,1309,3.902621722846442
3665,2,1344,315,1659,4.266666666666667
3666,1,1222,1005,2227,1.2159203980099502
3666,2,2243,207,2450,10.83574879227053
3666,3,2477,465,2942,5.326881720430108
3666,4,2965,526,3491,5.636882129277566
3666,5,3515,612,4127,5.743464052287582
3666,6,4151,547,4698,7.588665447897624
3666,7,4720,713,5433,6.6199158485273495
3666,8,5456,643,6099,8.485225505443236
3666,9,6114,635,6749,9.628346456692913
3666,10,6771,549,7320,12.333333333333334
3666,11,7337,575,7912,12.76
3667,1,539,669,1208,0.8056801195814649
3667,2,1300,593,1893,2.1922428330522767
3667,3,1945,789,2734,2.465145754119138
3667,4,2786,819,3605,3.4017094017094016
3667,5,4468,900,5368,4.964444444444444
3667,6,5471,903,6374,6.058693244739756
3667,7,6376,305,6681,20.904918032786885
3667,8,7451,443,7894,16.81941309255079
3668,1,89,578,667,0.15397923875432526
3668,2,690,590,1280,1.1694915254237288
3668,3,1308,651,1959,2.0092165898617513
3668,4,1977,948,2925,2.0854430379746836
3669,1,361,179,540,2.016759776536313
3669,2,569,274,843,2.076642335766423
3670,1,308,178,486,1.7303370786516854
3670,2,489,196,685,2.4948979591836733
3670,3,688,184,872,3.739130434782609
3670,4,875,140,1015,6.25
3671,1,11,235,246,0.04680851063829787
3671,2,1131,239,1370,4.7322175732217575
3671,3,1438,672,2110,2.1398809523809526
3672,1,140,58,198,2.413793103448276
3672,2,203,40,243,5.075
3672,3,2304,76,2380,30.31578947368421
3672,4,3346,67,3413,49.940298507462686
3672,5,6280,80,6360,78.5
3672,6,7794,2,7796,3897.0
3673,1,60,407,467,0.14742014742014742
3674,1,92,514,606,0.17898832684824903
3674,2,639,1024,1663,0.6240234375
3674,3,1666,163,1829,10.220858895705522
3675,1,23,821,844,0.028014616321559074
3676,1,158,917,1075,0.1723009814612868
3676,2,1183,531,1714,2.2278719397363465
3676,3,1855,302,2157,6.142384105960265
3676,4,2204,248,2452,8.887096774193548
3676,5,2539,275,2814,9.232727272727272
3676,6,2886,167,3053,17.281437125748504
3676,7,3070,300,3370,10.233333333333333
3676,8,3407,151,3558,22.56291390728477
3676,9,3677,171,3848,21.502923976608187
3676,10,3865,153,4018,25.26143790849673
3676,11,4035,367,4402,10.994550408719347
3676,12,4491,195,4686,23.03076923076923
3676,13,4703,429,5132,10.962703962703962
3677,1,192,844,1036,0.22748815165876776
3677,2,1062,788,1850,1.3477157360406091
3677,3,1951,311,2262,6.273311897106109
3677,4,2295,400,2695,5.7375
3677,5,2755,571,3326,4.824868651488616
3677,6,3394,603,3997,5.628524046434494
3678,1,54,229,283,0.23580786026200873
3678,2,294,184,478,1.5978260869565217
3678,3,489,244,733,2.0040983606557377
3678,4,741,288,1029,2.5729166666666665
3678,5,1037,298,1335,3.4798657718120807
3678,6,1343,353,1696,3.8045325779036827
3678,7,1704,319,2023,5.341692789968652
3678,8,2031,340,2371,5.973529411764706
3678,9,2379,343,2722,6.9358600583090375
3678,10,2730,354,3084,7.711864406779661
3678,11,3092,399,3491,7.74937343358396
3678,12,3499,422,3921,8.291469194312796
3678,13,3929,379,4308,10.366754617414248
3678,14,4311,424,4735,10.16745283018868
3678,15,4738,458,5196,10.344978165938864
3678,16,5199,416,5615,12.497596153846153
3678,17,5618,433,6051,12.97459584295612
3678,18,6054,445,6499,13.604494382022471
3678,19,6502,487,6989,13.351129363449692
3678,20,6992,476,7468,14.6890756302521
3678,21,7471,519,7990,14.394990366088631
3679,1,177,627,804,0.2822966507177033
3679,2,824,519,1343,1.5876685934489403
3679,3,1412,586,1998,2.409556313993174
3679,4,2019,623,2642,3.240770465489567
3680,1,258,89,347,2.898876404494382
3680,2,377,170,547,2.2176470588235295
3680,3,577,309,886,1.867313915857605
3680,4,905,233,1138,3.88412017167382
3680,5,1165,243,1408,4.794238683127572
3680,6,1442,350,1792,4.12
3680,7,1855,354,2209,5.240112994350283
3680,8,2225,269,2494,8.271375464684015
3681,1,44,608,652,0.07236842105263158
3681,2,706,590,1296,1.1966101694915254
3681,3,1306,465,1771,2.8086021505376344
3682,1,15,387,402,0.03875968992248062
3682,2,415,329,744,1.2613981762917934
3682,3,756,498,1254,1.5180722891566265
3682,4,1264,443,1707,2.853273137697517
3683,1,67,907,974,0.07386990077177508
3683,2,982,385,1367,2.550649350649351
3683,3,1408,924,2332,1.5238095238095237
3683,4,2355,932,3287,2.526824034334764
3683,5,3310,908,4218,3.645374449339207
3683,6,4241,930,5171,4.560215053763441
3683,7,5179,836,6015,6.194976076555024
3683,8,6065,711,6776,8.530239099859353
3683,9,6796,907,7703,7.492833517089306
3683,10,7711,319,8030,24.17241379310345
3684,1,448,649,1097,0.6902927580893683
3684,2,1169,218,1387,5.362385321100917
3684,3,1410,64,1474,22.03125
3684,4,1516,130,1646,11.661538461538461
3684,5,1651,59,1710,27.983050847457626
3684,6,1738,201,1939,8.64676616915423
3684,7,1990,248,2238,8.024193548387096
3684,8,2425,382,2807,6.348167539267016
3684,9,2884,545,3429,5.291743119266055
3685,1,28,49,77,0.5714285714285714
3685,2,105,25,130,4.2
3685,3,894,3,897,298.0
3685,4,915,3,918,305.0
3685,5,1231,3,1234,410.3333333333333
3685,6,1252,3,1255,417.3333333333333
3685,7,1771,3,1774,590.3333333333334
3685,8,1792,3,1795,597.3333333333334
3685,9,2623,3,2626,874.3333333333334
3685,10,2659,2,2661,1329.5
3685,11,4524,52,4576,87.0
3685,12,4608,441,5049,10.448979591836734
3685,13,5092,512,5604,9.9453125
3685,14,5616,406,6022,13.832512315270936
3685,15,6087,112,6199,54.348214285714285
3685,16,6211,121,6332,51.33057851239669
3685,17,6348,789,7137,8.045627376425855
3686,1,43,507,550,0.08481262327416174
3686,2,574,529,1103,1.0850661625708884
3686,3,1122,488,1610,2.2991803278688523
3686,4,1622,862,2484,1.8816705336426913
3687,1,129,559,688,0.23076923076923078
3688,1,43,2,45,21.5
3688,2,129,2,131,64.5
3688,3,318,2,320,159.0
3688,4,330,214,544,1.5420560747663552
3688,5,995,2,997,497.5
3688,6,1013,257,1270,3.9416342412451364
3688,7,1407,2,1409,703.5
3688,8,1425,263,1688,5.418250950570342
3688,9,1702,187,1889,9.101604278074866
3688,10,2267,2,2269,1133.5
3688,11,2285,401,2686,5.698254364089776
3688,12,2954,351,3305,8.415954415954415
3688,13,3323,376,3699,8.837765957446809
3688,14,3804,45,3849,84.53333333333333
3688,15,3855,222,4077,17.364864864864863
3688,16,4368,688,5056,6.348837209302325
3689,1,54,365,419,0.14794520547945206
3689,2,443,564,1007,0.7854609929078015
3689,3,1023,497,1520,2.058350100603622
3689,4,1539,660,2199,2.331818181818182
3689,5,2213,378,2591,5.854497354497354
3689,6,2610,587,3197,4.4463373083475295
3689,7,3266,703,3969,4.6458036984352775
3689,8,3987,663,4650,6.013574660633484
3690,1,133,757,890,0.17569352708058125
3690,2,910,803,1713,1.1332503113325032
3690,3,1754,566,2320,3.0989399293286217
3690,4,2352,921,3273,2.553745928338762
3690,5,3279,689,3968,4.7590711175616836
3691,1,111,598,709,0.18561872909698995
3691,2,767,664,1431,1.1551204819277108
3692,1,852,365,1217,2.334246575342466
3692,2,1388,101,1489,13.742574257425742
3692,3,1996,974,2970,2.0492813141683777
3692,4,3047,272,3319,11.202205882352942
3692,5,3341,320,3661,10.440625
3692,6,3728,335,4063,11.128358208955223
3692,7,4097,246,4343,16.65447154471545
3692,8,4366,128,4494,34.109375
3692,9,4516,270,4786,16.725925925925925
3692,10,4982,44,5026,113.22727272727273
3693,1,11,29,40,0.3793103448275862
3693,2,2307,360,2667,6.408333333333333
3693,3,2677,28,2705,95.60714285714286
3693,4,6358,214,6572,29.710280373831775
3693,5,6589,259,6848,25.44015444015444
3694,1,487,294,781,1.6564625850340136
3694,2,796,871,1667,0.9138920780711826
3694,3,1671,603,2274,2.771144278606965
3695,1,99,851,950,0.11633372502937721
3695,2,1030,966,1996,1.0662525879917184
3695,3,2060,790,2850,2.607594936708861
3696,1,167,633,800,0.2638230647709321
3697,1,110,489,599,0.2249488752556237
3698,1,735,386,1121,1.9041450777202074
3698,2,1137,201,1338,5.656716417910448
3698,3,1346,160,1506,8.4125
3698,4,1518,249,1767,6.096385542168675
3698,5,1784,257,2041,6.941634241245136
3698,6,2063,390,2453,5.28974358974359
3698,7,2467,263,2730,9.38022813688213
3698,8,4137,370,4507,11.18108108108108
3698,9,4523,153,4676,29.562091503267975
3698,10,4688,205,4893,22.86829268292683
3698,11,4930,198,5128,24.8989898989899
3698,12,5188,203,5391,25.55665024630542
3698,13,5424,173,5597,31.352601156069365
3699,1,628,14,642,44.857142857142854
3699,2,987,135,1122,7.311111111111111
3699,3,1347,287,1634,4.693379790940766
3699,4,1855,289,2144,6.418685121107266
3699,5,2659,280,2939,9.496428571428572
3699,6,3643,489,4132,7.449897750511248
3699,7,4545,1271,5816,3.5759244689221084
3699,8,6258,553,6811,11.316455696202532
3700,1,12,921,933,0.013029315960912053
3700,2,941,589,1530,1.5976230899830222
3700,3,1541,671,2212,2.2965722801788377
3700,4,2225,394,2619,5.647208121827411
3700,5,2638,719,3357,3.6689847009735743
3700,6,3375,149,3524,22.651006711409394
3700,7,3537,75,3612,47.16
3700,8,3623,139,3762,26.06474820143885
3700,9,3797,110,3907,34.518181818181816
3700,10,3933,143,4076,27.503496503496503
3700,11,4089,148,4237,27.62837837837838
3701,1,23,117,140,0.19658119658119658
3701,2,165,103,268,1.6019417475728155
3701,3,310,496,806,0.625
3702,1,329,400,729,0.8225
3702,2,745,360,1105,2.0694444444444446
3702,3,1145,398,1543,2.8768844221105527
3702,4,1547,177,1724,8.740112994350282
3703,1,537,873,1410,0.6151202749140894
3703,2,1421,861,2282,1.6504065040650406
3703,3,2293,827,3120,2.7726723095525996
3703,4,3131,871,4002,3.5947187141216994
3703,5,4013,678,4691,5.9188790560471976
3704,1,47,765,812,0.06143790849673202
3704,2,821,113,934,7.265486725663717
3704,3,939,110,1049,8.536363636363637
3704,4,1147,618,1765,1.8559870550161812
3704,5,1780,367,2147,4.8501362397820165
3704,6,2245,588,2833,3.818027210884354
3704,7,2847,802,3649,3.5498753117206983
3704,8,3671,749,4420,4.901201602136181
3704,9,4503,768,5271,5.86328125
3705,1,53,944,997,0.05614406779661017
3705,2,1016,223,1239,4.556053811659193
3705,3,1295,583,1878,2.221269296740995
3705,4,1911,1017,2928,1.87905604719764
3705,5,2969,1047,4016,2.835721107927412
3705,6,4033,667,4700,6.04647676161919
3705,7,4743,1039,5782,4.564966313763234
3705,8,5845,1022,6867,5.719178082191781
3705,9,6915,1011,7926,6.839762611275964
3706,1,36,633,669,0.05687203791469194
3706,2,692,319,1011,2.169278996865204
3706,3,1033,382,1415,2.7041884816753927
3706,4,1429,646,2075,2.2120743034055725
3707,1,27,676,703,0.03994082840236687
3707,2,727,458,1185,1.5873362445414847
3707,3,1203,588,1791,2.045918367346939
3707,4,1801,682,2483,2.6407624633431084
3708,1,21,245,266,0.08571428571428572
3708,2,280,112,392,2.5
3708,3,404,180,584,2.2444444444444445
3708,4,611,254,865,2.405511811023622
3708,5,880,294,1174,2.993197278911565
3708,6,1189,279,1468,4.261648745519714
3708,7,1482,322,1804,4.60248447204969
3708,8,1817,334,2151,5.440119760479042
3708,9,2167,370,2537,5.856756756756757
3708,10,2549,216,2765,11.800925925925926
3708,11,2778,334,3112,8.317365269461078
3708,12,3126,299,3425,10.454849498327759
3708,13,3437,311,3748,11.05144694533762
3709,1,16,939,955,0.01703940362087327
3709,2,975,547,1522,1.7824497257769654
3710,1,22,328,350,0.06707317073170732
3710,2,366,362,728,1.011049723756906
3710,3,836,612,1448,1.3660130718954249
3711,1,94,149,243,0.6308724832214765
3711,2,277,239,516,1.1589958158995817
3711,3,590,292,882,2.0205479452054793
3711,4,933,154,1087,6.058441558441558
3712,1,37,58,95,0.6379310344827587
3713,1,35,452,487,0.07743362831858407
3714,1,39,488,527,0.07991803278688525
3714,2,572,575,1147,0.9947826086956522
3714,3,1166,803,1969,1.452054794520548
3714,4,2005,644,2649,3.1133540372670807
3714,5,2690,444,3134,6.058558558558558
3714,6,3201,345,3546,9.278260869565218
3714,7,3624,658,4282,5.507598784194529
3715,1,166,326,492,0.50920245398773
3715,2,511,241,752,2.120331950207469
3715,3,803,283,1086,2.8374558303886928
3715,4,1199,548,1747,2.187956204379562
3715,5,1796,529,2325,3.395085066162571
3715,6,2512,532,3044,4.7218045112781954
3715,7,3158,546,3704,5.783882783882784
3715,8,3751,436,4187,8.603211009174313
3715,9,4210,607,4817,6.9357495881383855
3715,10,5020,310,5330,16.193548387096776
3716,1,48,319,367,0.15047021943573669
3717,1,23,226,249,0.10176991150442478
3717,2,262,457,719,0.5733041575492341
3717,3,755,346,1101,2.1820809248554913
3717,4,1113,411,1524,2.708029197080292
3717,5,1530,196,1726,7.8061224489795915
3717,6,1740,382,2122,4.554973821989528
3717,7,2220,358,2578,6.201117318435754
3717,8,2585,289,2874,8.944636678200691
3718,1,119,642,761,0.1853582554517134
3719,1,30,586,616,0.051194539249146756
3719,2,622,740,1362,0.8405405405405405
3719,3,1387,710,2097,1.9535211267605634
3720,1,954,380,1334,2.5105263157894737
3720,2,1874,617,2491,3.0372771474878446
3720,3,2597,1007,3604,2.5789473684210527
3721,1,43,507,550,0.08481262327416174
3721,2,574,529,1103,1.0850661625708884
3722,1,400,1333,1733,0.30007501875468867
3723,1,457,32,489,14.28125
3723,2,491,182,673,2.697802197802198
3723,3,698,369,1067,1.89159891598916
3723,4,1077,254,1331,4.24015748031496
3723,5,1349,309,1658,4.365695792880259
3723,6,1666,227,1893,7.3392070484581495
3723,7,1896,301,2197,6.299003322259137
3723,8,2213,258,2471,8.577519379844961
3724,1,111,680,791,0.16323529411764706
3724,2,811,289,1100,2.8062283737024223
3724,3,1114,267,1381,4.1722846441947565
3724,4,1414,169,1583,8.366863905325443
3724,5,1592,393,1985,4.0508905852417305
3724,6,2004,673,2677,2.9777117384843983
3724,7,2733,921,3654,2.96742671009772
3724,8,3656,284,3940,12.873239436619718
3724,9,3983,499,4482,7.981963927855712
3724,10,4531,267,4798,16.970037453183522
3724,11,4822,944,5766,5.108050847457627
3724,12,5768,230,5998,25.078260869565216
3724,13,6009,350,6359,17.16857142857143
3724,14,6400,896,7296,7.142857142857143
3725,1,203,541,744,0.3752310536044362
3726,1,81,176,257,0.4602272727272727
3726,2,348,621,969,0.5603864734299517
3726,3,985,539,1524,1.8274582560296846
3726,4,1545,587,2132,2.6320272572402046
3727,1,16,991,1007,0.016145307769929364
3728,1,19,691,710,0.027496382054992764
3728,2,724,468,1192,1.547008547008547
3729,1,841,818,1659,1.028117359413203
3729,2,1675,542,2217,3.0904059040590406
3729,3,2233,612,2845,3.6486928104575163
3729,4,2869,887,3756,3.234498308906426
3729,5,3772,870,4642,4.335632183908046
3729,6,4658,866,5524,5.378752886836028
3729,7,5540,433,5973,12.79445727482679
3729,8,5989,562,6551,10.65658362989324
3729,9,6581,631,7212,10.429477020602219
3729,10,7228,584,7812,12.376712328767123
3730,1,298,632,930,0.47151898734177217
3730,2,1243,533,1776,2.3320825515947465
3730,3,2172,872,3044,2.4908256880733943
3730,4,3166,437,3603,7.244851258581236
3730,5,3634,553,4187,6.571428571428571
3730,6,4201,838,5039,5.013126491646778
3730,7,5136,804,5940,6.388059701492537
3730,8,5964,740,6704,8.05945945945946
3730,9,6991,523,7514,13.367112810707457
3730,10,7688,161,7849,47.75155279503105
3731,1,9,146,155,0.06164383561643835
3731,2,166,205,371,0.8097560975609757
3732,1,125,995,1120,0.12562814070351758
3732,2,1128,828,1956,1.3623188405797102
3732,3,1982,710,2692,2.7915492957746477
3733,1,263,415,678,0.6337349397590362
3733,2,702,364,1066,1.9285714285714286
3733,3,1127,34,1161,33.14705882352941
3734,1,2223,502,2725,4.4282868525896415
3734,2,2734,424,3158,6.44811320754717
3735,1,4,80,84,0.05
3735,2,88,608,696,0.14473684210526316
3735,3,700,697,1397,1.0043041606886658
3736,1,65,318,383,0.20440251572327045
3736,2,395,428,823,0.9228971962616822
3736,3,832,710,1542,1.171830985915493
3736,4,1565,507,2072,3.086785009861933
3736,5,2081,348,2429,5.9798850574712645
3736,6,2442,482,2924,5.066390041493776
3736,7,3458,392,3850,8.821428571428571
3736,8,4559,638,5197,7.14576802507837
3736,9,5209,442,5651,11.785067873303168
3736,10,5777,482,6259,11.985477178423237
3736,11,6320,223,6543,28.340807174887892
3736,12,6564,510,7074,12.870588235294118
3736,13,7085,153,7238,46.30718954248366
3736,14,7257,564,7821,12.867021276595745
3737,1,76,477,553,0.15932914046121593
3737,2,580,420,1000,1.380952380952381
3737,3,1010,247,1257,4.089068825910931
3737,4,1284,230,1514,5.582608695652174
3737,5,1837,485,2322,3.7876288659793813
3737,6,2355,192,2547,12.265625
3737,7,2562,306,2868,8.372549019607844
3737,8,2876,178,3054,16.15730337078652
3737,9,3079,185,3264,16.643243243243244
3737,10,3285,169,3454,19.437869822485208
3738,1,486,447,933,1.087248322147651
3738,2,1005,438,1443,2.2945205479452055
3738,3,1674,159,1833,10.528301886792454
3739,1,128,469,597,0.27292110874200426
3739,2,712,415,1127,1.7156626506024097
3739,3,1171,373,1544,3.1394101876675604
3739,4,1603,552,2155,2.903985507246377
3739,5,2195,481,2676,4.5634095634095635
3739,6,2721,531,3252,5.124293785310734
3739,7,3264,437,3701,7.469107551487414
3739,8,3785,612,4397,6.184640522875817
3739,9,4424,496,4920,8.919354838709678
3739,10,4980,402,5382,12.388059701492537
3739,11,5421,477,5898,11.364779874213836
3739,12,5928,463,6391,12.803455723542116
3739,13,6626,496,7122,13.358870967741936
3739,14,7143,433,7576,16.496535796766743
3739,15,7599,470,8069,16.16808510638298
3740,1,173,887,1060,0.19503945885005636
3741,1,48,72,120,0.6666666666666666
3741,2,1356,245,1601,5.53469387755102
3741,3,2262,285,2547,7.936842105263158
3741,4,2557,170,2727,15.041176470588235
3741,5,2746,263,3009,10.44106463878327
3741,6,3015,330,3345,9.136363636363637
3741,7,3374,651,4025,5.182795698924731
3741,8,4045,369,4414,10.962059620596206
3741,9,4636,363,4999,12.771349862258953
3742,1,73,721,794,0.10124826629680998
3742,2,813,701,1514,1.159771754636234
3742,3,1552,888,2440,1.7477477477477477
3742,4,2458,888,3346,2.768018018018018
3742,5,3484,358,3842,9.731843575418994
3742,6,3892,450,4342,8.648888888888889
3742,7,4365,423,4788,10.319148936170214
3742,8,4818,215,5033,22.409302325581397
3742,9,5324,530,5854,10.045283018867925
3742,10,5871,475,6346,12.36
3742,11,6518,491,7009,13.274949083503055
3742,12,7020,352,7372,19.943181818181817
3742,13,7387,388,7775,19.038659793814432
3742,14,7788,297,8085,26.22222222222222
3743,1,269,420,689,0.6404761904761904
3744,1,4096,27,4123,151.7037037037037
3745,1,38,410,448,0.09268292682926829
3745,2,450,367,817,1.2261580381471389
3745,3,819,195,1014,4.2
3745,4,1016,154,1170,6.597402597402597
3745,5,1176,357,1533,3.2941176470588234
3745,6,1535,258,1793,5.949612403100775
3745,7,1820,388,2208,4.690721649484536
3745,8,2210,370,2580,5.972972972972973
3745,9,2582,88,2670,29.34090909090909
3745,10,2697,383,3080,7.04177545691906
3746,1,98,474,572,0.20675105485232068
3746,2,620,474,1094,1.3080168776371308
3746,3,1127,620,1747,1.8177419354838709
3746,4,1751,635,2386,2.7574803149606297
3746,5,2443,575,3018,4.248695652173913
3746,6,3035,450,3485,6.7444444444444445
3746,7,3503,657,4160,5.331811263318112
3746,8,4178,803,4981,5.202988792029888
3746,9,5125,586,5711,8.745733788395905
3746,10,5729,692,6421,8.278901734104046
3746,11,6440,422,6862,15.260663507109005
3746,12,6868,37,6905,185.6216216216216
3747,1,20,397,417,0.05037783375314862
3747,2,454,449,903,1.0111358574610245
3747,3,920,721,1641,1.2760055478502081
3747,4,1665,768,2433,2.16796875
3747,5,2453,983,3436,2.495422177009156
3747,6,3452,1131,4583,3.052166224580018
3747,7,4594,730,5324,6.293150684931507
3748,1,79,627,706,0.12599681020733652
3748,2,806,790,1596,1.0202531645569621
3748,3,1655,791,2446,2.092288242730721
3748,4,2603,825,3428,3.1551515151515153
3748,5,3430,825,4255,4.157575757575757
3748,6,4299,833,5132,5.160864345738295
3748,7,5142,234,5376,21.974358974358974
3748,8,5540,398,5938,13.919597989949748
3748,9,5952,612,6564,9.72549019607843
3749,1,38,733,771,0.05184174624829468
3749,2,809,568,1377,1.4242957746478873
3749,3,1389,927,2316,1.4983818770226538
3749,4,2331,354,2685,6.584745762711864
3750,1,7,596,603,0.01174496644295302
3750,2,622,634,1256,0.9810725552050473
3750,3,1270,569,1839,2.231985940246046
3750,4,1858,518,2376,3.586872586872587
3750,5,2391,470,2861,5.087234042553192
3750,6,2876,525,3401,5.478095238095238
3750,7,3432,700,4132,4.902857142857143
3750,8,4140,59,4199,70.16949152542372
3750,9,4212,382,4594,11.026178010471204
3750,10,4606,251,4857,18.350597609561753
3750,11,4875,492,5367,9.908536585365853
3750,12,5396,530,5926,10.181132075471698
3750,13,5938,186,6124,31.9247311827957
3750,14,6143,378,6521,16.25132275132275
3750,15,6554,472,7026,13.885593220338983
3750,16,7032,414,7446,16.985507246376812
3751,1,883,287,1170,3.076655052264808
3751,2,1273,515,1788,2.471844660194175
3751,3,1945,434,2379,4.481566820276497
3751,4,2382,363,2745,6.56198347107438
3751,5,2818,316,3134,8.917721518987342
3751,6,3195,345,3540,9.26086956521739
3751,7,3589,410,3999,8.753658536585366
3751,8,4002,341,4343,11.736070381231672
3751,9,4484,431,4915,10.403712296983759
3751,10,4918,161,5079,30.546583850931675
3751,11,5257,386,5643,13.619170984455959
3751,12,5646,287,5933,19.67247386759582
3751,13,6344,419,6763,15.140811455847256
3751,14,6766,355,7121,19.059154929577463
3751,15,7124,349,7473,20.412607449856733
3751,16,7678,386,8064,19.89119170984456
3752,1,50,759,809,0.06587615283267458
3752,2,816,744,1560,1.096774193548387
3752,3,1571,399,1970,3.93734335839599
3752,4,1990,771,2761,2.5810635538262
3752,5,2767,56,2823,49.410714285714285
3752,6,2831,289,3120,9.795847750865052
3752,7,3132,641,3773,4.886115444617785
3753,1,18,623,641,0.028892455858747994
3754,1,1979,735,2714,2.692517006802721
3754,2,2738,852,3590,3.2136150234741785
3754,3,3601,864,4465,4.167824074074074
3754,4,4476,461,4937,9.709327548806941
3755,1,115,964,1079,0.11929460580912864
3756,1,1279,461,1740,2.774403470715835
3756,2,1967,667,2634,2.949025487256372
3756,3,2661,363,3024,7.330578512396694
3757,1,714,803,1517,0.8891656288916563
3757,2,1532,24,1556,63.833333333333336
3757,3,1660,624,2284,2.66025641025641
3757,4,2436,704,3140,3.460227272727273
3757,5,3158,80,3238,39.475
3757,6,3244,86,3330,37.72093023255814
3757,7,3362,69,3431,48.72463768115942
3757,8,3463,587,4050,5.899488926746167
3757,9,4065,56,4121,72.58928571428571
3757,10,4138,67,4205,61.76119402985075
3758,1,82,608,690,0.13486842105263158
3758,2,764,657,1421,1.1628614916286149
3758,3,1462,470,1932,3.1106382978723404
3759,1,148,544,692,0.27205882352941174
3760,1,41,790,831,0.05189873417721519
3760,2,858,443,1301,1.9367945823927766
3760,3,1326,414,1740,3.2028985507246377
3760,4,1763,412,2175,4.279126213592233
3760,5,2196,449,2645,4.89086859688196
3760,6,2711,390,3101,6.9512820512820515
3760,7,3118,576,3694,5.413194444444445
3760,8,3801,547,4348,6.948811700182816
3760,9,4384,461,4845,9.509761388286334
3760,10,4913,958,5871,5.12839248434238
3760,11,5886,493,6379,11.939148073022313
3760,12,6395,343,6738,18.644314868804663
3761,1,16,137,153,0.11678832116788321
3761,2,176,787,963,0.22363405336721728
3762,1,85,66,151,1.2878787878787878
3762,2,176,627,803,0.2807017543859649
3762,3,881,409,1290,2.154034229828851
3762,4,1354,331,1685,4.090634441087613
3762,5,1755,166,1921,10.572289156626505
3763,1,83,339,422,0.2448377581120944
3763,2,437,534,971,0.8183520599250936
3763,3,977,249,1226,3.923694779116466
3763,4,1239,689,1928,1.7982583454281567
3764,1,14,213,227,0.06572769953051644
3764,2,238,688,926,0.34593023255813954
3765,1,39,64,103,0.609375
3765,2,130,820,950,0.15853658536585366
3765,3,975,839,1814,1.162097735399285
3765,4,1882,796,2678,2.364321608040201
3765,5,2714,621,3335,4.37037037037037
3765,6,3356,739,4095,4.54127198917456
3765,7,4141,690,4831,6.001449275362319
3765,8,4892,603,5495,8.112769485903815
3766,1,69,393,462,0.17557251908396945
3766,2,501,325,826,1.5415384615384615
3766,3,886,395,1281,2.2430379746835443
3766,4,1296,379,1675,3.4195250659630605
3767,1,61,784,845,0.0778061224489796
3767,2,848,65,913,13.046153846153846
3767,3,1290,544,1834,2.3713235294117645
3767,4,1879,336,2215,5.592261904761905
3767,5,2266,396,2662,5.722222222222222
3767,6,2713,337,3050,8.050445103857566
3767,7,3091,387,3478,7.987080103359173
3768,1,120,507,627,0.23668639053254437
3769,1,35,69,104,0.5072463768115942
3769,2,124,103,227,1.203883495145631
3769,3,240,92,332,2.608695652173913
3770,1,55,391,446,0.14066496163682865
3771,1,13,780,793,0.016666666666666666
3772,1,114,57,171,2.0
3772,2,218,2446,2664,0.08912510220768602
3773,1,20,809,829,0.024721878862793572
3773,2,850,661,1511,1.285930408472012
3774,1,307,639,946,0.48043818466353677
3774,2,1012,467,1479,2.1670235546038543
3774,3,1582,747,2329,2.1178045515394914
3774,4,2548,723,3271,3.524204702627939
3775,1,50,537,587,0.0931098696461825
3776,1,52,350,402,0.14857142857142858
3776,2,410,418,828,0.9808612440191388
3776,3,876,384,1260,2.28125
3776,4,1268,443,1711,2.8623024830699775
3776,5,1719,301,2020,5.710963455149502
3776,6,2036,364,2400,5.593406593406593
3776,7,2408,472,2880,5.101694915254237
3776,8,2913,355,3268,8.205633802816902
3776,9,3291,394,3685,8.352791878172589
3776,10,3693,144,3837,25.645833333333332
3776,11,3855,401,4256,9.613466334164588
3776,12,4264,419,4683,10.176610978520287
3776,13,4707,411,5118,11.452554744525548
3776,14,5155,379,5534,13.601583113456464
3776,15,5542,397,5939,13.959697732997482
3776,16,5947,375,6322,15.858666666666666
3776,17,6330,395,6725,16.025316455696203
3776,18,6733,320,7053,21.040625
3776,19,7070,470,7540,15.042553191489361
3777,1,47,811,858,0.05795314426633785
3777,2,869,699,1568,1.2432045779685266
3778,1,863,621,1484,1.3896940418679549
3778,2,1736,273,2009,6.358974358974359
3778,3,2094,227,2321,9.224669603524228
3778,4,2634,470,3104,5.604255319148936
3778,5,3111,47,3158,66.19148936170212
3779,1,36,503,539,0.07157057654075547
3779,2,595,509,1104,1.168958742632613
3779,3,1168,467,1635,2.501070663811563
3779,4,1682,466,2148,3.609442060085837
3779,5,2177,610,2787,3.5688524590163935
3779,6,2801,535,3336,5.235514018691589
3779,7,3346,443,3789,7.553047404063205
3779,8,3805,318,4123,11.965408805031446
3779,9,4129,385,4514,10.724675324675324
3780,1,22,87,109,0.25287356321839083
3780,2,152,131,283,1.1603053435114503
3780,3,304,187,491,1.625668449197861
3780,4,509,171,680,2.9766081871345027
3780,5,701,210,911,3.3380952380952382
3780,6,947,234,1181,4.047008547008547
3780,7,1220,146,1366,8.356164383561644
3780,8,1709,256,1965,6.67578125
3780,9,2012,178,2190,11.303370786516854
3780,10,2232,255,2487,8.75294117647059
3780,11,2634,155,2789,16.993548387096773
3780,12,2917,175,3092,16.66857142857143
3780,13,3113,176,3289,17.6875
3780,14,3426,298,3724,11.496644295302014
3781,1,5,386,391,0.012953367875647668
3781,2,410,352,762,1.1647727272727273
3781,3,814,844,1658,0.9644549763033176
3781,4,1687,409,2096,4.124694376528117
3781,5,2125,520,2645,4.086538461538462
3781,6,2689,675,3364,3.9837037037037035
3781,7,3410,609,4019,5.599343185550082
3781,8,4040,730,4770,5.534246575342466
3781,9,4798,843,5641,5.691577698695136
3781,10,5688,847,6535,6.715466351829988
3781,11,6538,437,6975,14.961098398169336
3781,12,6996,412,7408,16.980582524271846
3781,13,7420,247,7667,30.040485829959515
3782,1,646,929,1575,0.6953713670613563
3782,2,1597,387,1984,4.126614987080103
3783,1,41,273,314,0.15018315018315018
3783,2,330,287,617,1.1498257839721255
3783,3,623,243,866,2.5637860082304527
3783,4,880,235,1115,3.74468085106383
3783,5,1134,326,1460,3.478527607361963
3783,6,1530,515,2045,2.970873786407767
3783,7,2068,247,2315,8.37246963562753
3783,8,2328,222,2550,10.486486486486486
3783,9,2566,370,2936,6.935135135135135
3783,10,2938,319,3257,9.210031347962383
3783,11,3336,414,3750,8.057971014492754
3783,12,3758,497,4255,7.561368209255533
3783,13,4265,244,4509,17.479508196721312
3783,14,4540,304,4844,14.93421052631579
3783,15,4852,399,5251,12.160401002506266
3783,16,5282,263,5545,20.083650190114067
3783,17,5552,395,5947,14.055696202531646
3783,18,6038,465,6503,12.98494623655914
3783,19,6514,402,6916,16.203980099502488
3783,20,6921,265,7186,26.116981132075473
3783,21,7208,407,7615,17.71007371007371
3783,22,7647,312,7959,24.509615384615383
3784,1,23,116,139,0.19827586206896552
3784,2,201,420,621,0.4785714285714286
3784,3,660,225,885,2.933333333333333
3784,4,976,633,1609,1.5418641390205372
3784,5,1648,277,1925,5.949458483754513
3784,6,2063,510,2573,4.045098039215686
3784,7,2686,815,3501,3.2957055214723927
3784,8,4163,626,4789,6.6501597444089455
3784,9,4835,589,5424,8.208828522920204
3784,10,5447,830,6277,6.562650602409638
3784,11,6742,726,7468,9.286501377410469
3785,1,9,568,577,0.01584507042253521
3786,1,28,194,222,0.14432989690721648
3786,2,231,101,332,2.287128712871287
3786,3,404,204,608,1.9803921568627452
3786,4,624,637,1261,0.9795918367346939
3786,5,1293,841,2134,1.5374554102259215
3786,6,2191,1051,3242,2.0846812559467174
3786,7,3255,319,3574,10.203761755485893
3786,8,3590,1018,4608,3.5265225933202355
3786,9,4619,598,5217,7.724080267558528
3787,1,109,425,534,0.2564705882352941
3787,2,550,581,1131,0.9466437177280551
3787,3,1148,534,1682,2.149812734082397
3787,4,1697,644,2341,2.6350931677018634
3788,1,37,439,476,0.08428246013667426
3788,2,560,123,683,4.5528455284552845
3788,3,862,251,1113,3.4342629482071714
3788,4,1139,476,1615,2.392857142857143
3788,5,1636,395,2031,4.141772151898734
3789,1,60,90,150,0.6666666666666666
3789,2,520,586,1106,0.8873720136518771
3790,1,122,800,922,0.1525
3790,2,929,95,1024,9.778947368421052
3790,3,1047,372,1419,2.814516129032258
3790,4,1482,533,2015,2.7804878048780486
3790,5,2097,855,2952,2.4526315789473685
3790,6,2959,381,3340,7.766404199475065
3790,7,3413,841,4254,4.058263971462544
3790,8,4261,293,4554,14.542662116040956
3791,1,20,545,565,0.03669724770642202
3791,2,616,512,1128,1.203125
3791,3,1147,521,1668,2.201535508637236
3791,4,1733,688,2421,2.5188953488372094
3792,1,68,430,498,0.15813953488372093
3793,1,15,723,738,0.02074688796680498
3793,2,753,468,1221,1.608974358974359
3794,1,66,933,999,0.0707395498392283
3794,2,1271,407,1678,3.1228501228501226
3794,3,1697,363,2060,4.674931129476584
3795,1,14,468,482,0.029914529914529916
3795,2,960,748,1708,1.2834224598930482
3795,3,1811,847,2658,2.1381345926800472
3795,4,2777,766,3543,3.6253263707571803
3795,5,3559,777,4336,4.5804375804375805
3795,6,4365,1045,5410,4.177033492822966
3796,1,171,432,603,0.3958333333333333
3796,2,611,423,1034,1.4444444444444444
3796,3,1042,464,1506,2.2456896551724137
3796,4,1514,296,1810,5.114864864864865
3797,1,60,64,124,0.9375
3797,2,549,922,1471,0.5954446854663774
3798,1,22,879,901,0.02502844141069397
3798,2,955,678,1633,1.4085545722713864
3798,3,1659,637,2296,2.6043956043956045
3798,4,3892,934,4826,4.167023554603855
3798,5,4836,1040,5876,4.65
3799,1,550,307,857,1.791530944625407
3799,2,1383,264,1647,5.238636363636363
3799,3,1848,298,2146,6.201342281879195
3799,4,2180,950,3130,2.294736842105263
3800,1,303,307,610,0.9869706840390879
3800,2,631,359,990,1.7576601671309193
3801,1,25,342,367,0.07309941520467836
3801,2,389,273,662,1.424908424908425
3801,3,679,553,1232,1.2278481012658229
3801,4,1250,352,1602,3.5511363636363638
3801,5,1614,710,2324,2.2732394366197184
3801,6,2351,343,2694,6.854227405247814
3801,7,2704,89,2793,30.382022471910112
3802,1,44,533,577,0.0825515947467167
3802,2,599,339,938,1.766961651917404
3802,3,1373,678,2051,2.0250737463126844
3802,4,2251,1007,3258,2.2353525322740815
3802,5,3343,74,3417,45.17567567567568
3802,6,3529,1027,4556,3.436222005842259
3802,7,4575,137,4712,33.394160583941606
3802,8,4725,1048,5773,4.508587786259542
3802,9,5789,671,6460,8.6274217585693
3802,10,6479,127,6606,51.01574803149607
3802,11,6637,998,7635,6.650300601202405
3803,1,1447,341,1788,4.243401759530792
3804,1,9,312,321,0.028846153846153848
3804,2,325,154,479,2.1103896103896105
3804,3,498,187,685,2.663101604278075
3804,4,692,405,1097,1.708641975308642
3804,5,1170,467,1637,2.5053533190578157
3804,6,1672,789,2461,2.1191381495564006
3804,7,2492,989,3481,2.519716885743175
3804,8,3496,224,3720,15.607142857142858
3804,9,3774,961,4735,3.927159209157128
3804,10,4762,996,5758,4.781124497991968
3804,11,5761,504,6265,11.430555555555555
3804,12,6295,734,7029,8.576294277929156
3805,1,12,468,480,0.02564102564102564
3805,2,528,239,767,2.209205020920502
3805,3,772,664,1436,1.1626506024096386
3805,4,1498,330,1828,4.539393939393939
3805,5,1890,532,2422,3.5526315789473686
3805,6,2447,567,3014,4.315696649029983
3805,7,3036,331,3367,9.172205438066465
3805,8,3409,273,3682,12.487179487179487
3805,9,3718,290,4008,12.820689655172414
3806,1,381,439,820,0.8678815489749431
3806,2,1201,483,1684,2.4865424430641823
3806,3,1998,312,2310,6.403846153846154
3806,4,2576,293,2869,8.791808873720136
3806,5,3465,449,3914,7.717149220489977
3807,1,271,15,286,18.066666666666666
3807,2,322,15,337,21.466666666666665
3807,3,340,269,609,1.2639405204460967
3807,4,677,15,692,45.13333333333333
3807,5,695,444,1139,1.5653153153153154
3807,6,1181,15,1196,78.73333333333333
3807,7,1199,515,1714,2.3281553398058255
3808,1,87,75,162,1.16
3808,2,210,533,743,0.39399624765478425
3808,3,811,886,1697,0.9153498871331829
3808,4,1736,923,2659,1.8808234019501626
3808,5,2730,921,3651,2.964169381107492
3808,6,3716,1009,4725,3.682854311199207
3808,7,4733,766,5499,6.178851174934726
3809,1,148,338,486,0.4378698224852071
3809,2,499,556,1055,0.8974820143884892
3810,1,89,589,678,0.15110356536502548
3810,2,685,453,1138,1.5121412803532008
3810,3,1148,474,1622,2.4219409282700424
3810,4,1632,414,2046,3.9420289855072466
3810,5,2049,366,2415,5.598360655737705
3810,6,2425,352,2777,6.889204545454546
3810,7,2780,420,3200,6.619047619047619
3811,1,206,11,217,18.727272727272727
3811,2,228,157,385,1.4522292993630572
3811,3,437,195,632,2.241025641025641
3811,4,670,155,825,4.32258064516129
3811,5,827,622,1449,1.3295819935691318
3812,1,22,783,805,0.0280970625798212
3813,1,74,244,318,0.30327868852459017
3813,2,363,71,434,5.112676056338028
3813,3,496,1157,1653,0.428694900605013
3813,4,1680,778,2458,2.159383033419023
3814,1,17,691,708,0.024602026049204053
3814,2,720,391,1111,1.8414322250639386
3814,3,1145,332,1477,3.4487951807228914
3814,4,1521,605,2126,2.5140495867768595
3814,5,2145,685,2830,3.1313868613138687
3814,6,2873,754,3627,3.810344827586207
3814,7,3654,451,4105,8.1019955654102
3814,8,4108,477,4585,8.61215932914046
3814,9,5628,562,6190,10.01423487544484
3814,10,6542,405,6947,16.153086419753087
3815,1,40,19,59,2.1052631578947367
3815,2,101,93,194,1.086021505376344
3815,3,224,89,313,2.5168539325842696
3816,1,442,88,530,5.0227272727272725
3816,2,550,94,644,5.851063829787234
3816,3,656,108,764,6.074074074074074
3816,4,781,163,944,4.791411042944786
3816,5,964,229,1193,4.209606986899563
3816,6,1204,256,1460,4.703125
3817,1,216,680,896,0.3176470588235294
3817,2,975,692,1667,1.4089595375722543
3817,3,1682,236,1918,7.127118644067797
3817,4,1944,566,2510,3.4346289752650176
3817,5,2528,544,3072,4.647058823529412
3818,1,27,22,49,1.2272727272727273
3818,2,199,550,749,0.3618181818181818
3818,3,795,35,830,22.714285714285715
3818,4,1718,658,2376,2.6109422492401215
3818,5,3294,701,3995,4.699001426533523
3818,6,4005,31,4036,129.19354838709677
3818,7,4997,720,5717,6.940277777777778
3818,8,5784,643,6427,8.995334370139968
3818,9,6473,350,6823,18.494285714285713
3818,10,6852,649,7501,10.557781201848998
3818,11,7556,503,8059,15.021868787276341
3819,1,523,680,1203,0.7691176470588236
3819,2,1250,638,1888,1.9592476489028212
3819,3,1910,447,2357,4.272930648769575
3820,1,15,717,732,0.02092050209205021
3820,2,744,522,1266,1.4252873563218391
3821,1,682,666,1348,1.024024024024024
3821,2,1393,645,2038,2.15968992248062
3821,3,2056,388,2444,5.298969072164948
3821,4,2463,546,3009,4.510989010989011
3821,5,3025,609,3634,4.967159277504105
3821,6,3636,395,4031,9.20506329113924
3821,7,4046,1020,5066,3.966666666666667
3821,8,5069,540,5609,9.387037037037038
3821,9,5612,859,6471,6.533178114086147
3822,1,221,165,386,1.3393939393939394
3822,2,410,148,558,2.77027027027027
3822,3,633,145,778,4.36551724137931
3822,4,1209,748,1957,1.6163101604278074
3822,5,2285,218,2503,10.48165137614679
3822,6,3065,203,3268,15.098522167487685
3822,7,3889,713,4602,5.454417952314166
3822,8,4629,38,4667,121.8157894736842
3822,9,4685,889,5574,5.269966254218223
3822,10,5586,340,5926,16.429411764705883
3822,11,5952,101,6053,58.93069306930693
3822,12,6073,46,6119,132.02173913043478
3822,13,6183,754,6937,8.20026525198939
3822,14,7018,156,7174,44.98717948717949
3823,1,53,110,163,0.4818181818181818
3823,2,200,110,310,1.8181818181818181
3823,3,332,112,444,2.9642857142857144
3823,4,453,130,583,3.4846153846153847
3823,5,603,132,735,4.568181818181818
3823,6,749,267,1016,2.805243445692884
3823,7,1034,464,1498,2.228448275862069
3823,8,1524,288,1812,5.291666666666667
3824,1,27,190,217,0.14210526315789473
3825,1,206,11,217,18.727272727272727
3825,2,228,157,385,1.4522292993630572
3825,3,437,195,632,2.241025641025641
3825,4,670,155,825,4.32258064516129
3825,5,827,622,1449,1.3295819935691318
3826,1,29,498,527,0.05823293172690763
3827,1,20,651,671,0.030721966205837174
3827,2,696,548,1244,1.27007299270073
3827,3,1261,464,1725,2.7176724137931036
3828,1,879,343,1222,2.56268221574344
3828,2,1246,427,1673,2.918032786885246
3828,3,1699,548,2247,3.1003649635036497
3828,4,2277,748,3025,3.0441176470588234
3828,5,3056,918,3974,3.3289760348583877
3828,6,4006,434,4440,9.23041474654378
3828,7,4458,577,5035,7.726169844020797
3828,8,5100,685,5785,7.445255474452555
3828,9,5816,491,6307,11.84521384928717
3828,10,6320,240,6560,26.333333333333332
3828,11,6610,355,6965,18.619718309859156
3828,12,7023,320,7343,21.946875
3828,13,7363,402,7765,18.31592039800995
3829,1,93,1011,1104,0.09198813056379822
3829,2,1106,413,1519,2.6779661016949152
3829,3,1546,662,2208,2.3353474320241694
3829,4,2219,328,2547,6.765243902439025
3829,5,2557,391,2948,6.539641943734015
3829,6,2967,623,3590,4.762439807383628
3829,7,3652,964,4616,3.788381742738589
3829,8,4618,224,4842,20.616071428571427
3829,9,4864,677,5541,7.1846381093057605
3829,10,5550,308,5858,18.01948051948052
3829,11,5863,279,6142,21.014336917562723
3829,12,6147,189,6336,32.523809523809526
3829,13,6348,424,6772,14.971698113207546
3829,14,6806,978,7784,6.959100204498977
3830,1,327,660,987,0.4954545454545455
3830,2,1011,474,1485,2.132911392405063
3830,3,1502,497,1999,3.022132796780684
3830,4,2279,997,3276,2.2858575727181543
3830,5,3321,588,3909,5.6479591836734695
3830,6,3936,329,4265,11.963525835866262
3830,7,4300,333,4633,12.912912912912914
3830,8,4754,417,5171,11.400479616306955
3830,9,5257,960,6217,5.476041666666666
3830,10,6279,591,6870,10.624365482233502
3831,1,316,506,822,0.6245059288537549
3831,2,830,264,1094,3.143939393939394
3831,3,1108,123,1231,9.008130081300813
3831,4,1236,177,1413,6.983050847457627
3831,5,1431,194,1625,7.376288659793815
3831,6,1631,186,1817,8.768817204301076
3831,7,1825,166,1991,10.993975903614459
3831,8,1997,197,2194,10.137055837563452
3831,9,2203,120,2323,18.358333333333334
3831,10,2333,175,2508,13.331428571428571
3831,11,2540,262,2802,9.694656488549619
3831,12,2806,166,2972,16.903614457831324
3831,13,2980,156,3136,19.102564102564102
3831,14,3142,153,3295,20.535947712418302
3831,15,3298,196,3494,16.8265306122449
3831,16,3507,186,3693,18.85483870967742
3831,17,3705,209,3914,17.727272727272727
3831,18,3927,123,4050,31.926829268292682
3831,19,4059,220,4279,18.45
3831,20,4289,148,4437,28.97972972972973
3831,21,4442,227,4669,19.568281938325992
3831,22,4683,145,4828,32.296551724137935
3831,23,4836,115,4951,42.052173913043475
3831,24,4960,109,5069,45.5045871559633
3831,25,5079,222,5301,22.87837837837838
3831,26,5307,199,5506,26.668341708542712
3831,27,5522,149,5671,37.060402684563755
3831,28,5680,85,5765,66.82352941176471
3831,29,5777,177,5954,32.63841807909605
3831,30,5967,275,6242,21.69818181818182
3831,31,6249,167,6416,37.41916167664671
3831,32,6425,112,6537,57.36607142857143
3831,33,6543,200,6743,32.715
3831,34,6747,127,6874,53.125984251968504
3831,35,6892,289,7181,23.847750865051903
3831,36,7194,148,7342,48.608108108108105
3831,37,7366,301,7667,24.471760797342192
3831,38,7677,150,7827,51.18
3832,1,205,197,402,1.0406091370558375
3832,2,523,212,735,2.4669811320754715
3832,3,878,106,984,8.283018867924529
3832,4,1049,118,1167,8.889830508474576
3832,5,1229,80,1309,15.3625
3832,6,1352,65,1417,20.8
3832,7,1493,120,1613,12.441666666666666
3832,8,1743,120,1863,14.525
3832,9,2181,269,2450,8.107806691449815
3832,10,2459,149,2608,16.503355704697988
3832,11,2728,209,2937,13.052631578947368
3832,12,3017,43,3060,70.16279069767442
3833,1,2433,433,2866,5.618937644341801
3833,2,2897,158,3055,18.335443037974684
3833,3,3076,323,3399,9.523219814241486
3833,4,3411,305,3716,11.183606557377049
3833,5,3729,366,4095,10.188524590163935
3834,1,12,460,472,0.02608695652173913
3835,1,49,118,167,0.4152542372881356
3835,2,1723,416,2139,4.141826923076923
3835,3,2170,179,2349,12.12290502793296
3835,4,2358,328,2686,7.189024390243903
3835,5,2723,109,2832,24.98165137614679
3835,6,2865,353,3218,8.11614730878187
3835,7,3235,178,3413,18.174157303370787
3835,8,3426,229,3655,14.960698689956331
3835,9,3682,381,4063,9.664041994750656
3835,10,4071,189,4260,21.53968253968254
3835,11,4278,259,4537,16.517374517374517
3835,12,4553,228,4781,19.969298245614034
3835,13,4798,233,5031,20.59227467811159
3835,14,5039,258,5297,19.531007751937985
3835,15,5321,164,5485,32.44512195121951
3835,16,5494,228,5722,24.096491228070175
3835,17,5732,249,5981,23.02008032128514
3835,18,5997,320,6317,18.740625
3835,19,6358,328,6686,19.384146341463413
3835,20,6701,414,7115,16.185990338164252
3835,21,7148,274,7422,26.087591240875913
3835,22,7435,272,7707,27.334558823529413
3835,23,7741,260,8001,29.773076923076925
3836,1,35,398,433,0.08793969849246232
3836,2,480,571,1051,0.840630472854641
3837,1,17,186,203,0.0913978494623656
3837,2,430,714,1144,0.6022408963585434
3837,3,1215,843,2058,1.4412811387900355
3837,4,2129,973,3102,2.188078108941418
3837,5,3106,357,3463,8.700280112044817
3837,6,3490,229,3719,15.240174672489083
3837,7,3838,664,4502,5.780120481927711
3837,8,4516,631,5147,7.15689381933439
3837,9,5481,464,5945,11.8125
3837,10,6439,745,7184,8.642953020134229
3837,11,7253,206,7459,35.20873786407767
3837,12,7639,371,8010,20.590296495956874
3838,1,27,580,607,0.04655172413793104
3838,2,616,536,1152,1.1492537313432836
3838,3,1159,897,2056,1.2920847268673357
3838,4,2064,568,2632,3.6338028169014085
3838,5,2643,225,2868,11.746666666666666
3838,6,2871,930,3801,3.087096774193548
3839,1,434,645,1079,0.6728682170542636
3840,1,11,37,48,0.2972972972972973
3840,2,1852,46,1898,40.26086956521739
3840,3,1918,88,2006,21.795454545454547
3840,4,2021,512,2533,3.947265625
3840,5,2549,536,3085,4.755597014925373
3840,6,3108,551,3659,5.64065335753176
3841,1,228,533,761,0.4277673545966229
3841,2,777,419,1196,1.8544152744630071
3841,3,1230,173,1403,7.109826589595376
3842,1,14,635,649,0.02204724409448819
3842,2,691,386,1077,1.7901554404145077
3842,3,1087,484,1571,2.2458677685950414
3842,4,1591,563,2154,2.8259325044404973
3842,5,2162,708,2870,3.053672316384181
3843,1,486,487,973,0.997946611909651
3843,2,1677,497,2174,3.374245472837022
3844,1,46,1008,1054,0.04563492063492063
3845,1,230,333,563,0.6906906906906907
3845,2,881,888,1769,0.9921171171171171
3845,3,1842,810,2652,2.274074074074074
3845,4,2678,900,3578,2.9755555555555557
3845,5,3605,929,4534,3.8805166846071044
3845,6,4552,234,4786,19.45299145299145
3846,1,1857,786,2643,2.3625954198473282
3846,2,2652,444,3096,5.972972972972973
3847,1,34,811,845,0.04192355117139334
3847,2,904,479,1383,1.8872651356993737
3848,1,143,616,759,0.23214285714285715
3848,2,781,334,1115,2.338323353293413
3848,3,1130,446,1576,2.5336322869955157
3848,4,1584,646,2230,2.4520123839009287
3848,5,2268,129,2397,17.58139534883721
3848,6,2414,258,2672,9.356589147286822
3848,7,2707,3,2710,902.3333333333334
3849,1,787,738,1525,1.0663956639566397
3849,2,1561,1045,2606,1.49377990430622
3849,3,2687,922,3609,2.914316702819957
3849,4,4432,718,5150,6.172701949860724
3849,5,5172,1122,6294,4.609625668449198
3850,1,30,353,383,0.08498583569405099
3850,2,395,474,869,0.8333333333333334
3850,3,891,393,1284,2.267175572519084
3850,4,1295,454,1749,2.852422907488987
3850,5,1760,163,1923,10.797546012269938
3851,1,24,161,185,0.14906832298136646
3852,1,2587,325,2912,7.96
3853,1,287,721,1008,0.39805825242718446
3853,2,1238,1265,2503,0.9786561264822135
3853,3,2558,1030,3588,2.483495145631068
3853,4,3730,868,4598,4.297235023041475
3853,5,5095,909,6004,5.605060506050605
3854,1,935,987,1922,0.9473150962512664
3854,2,1924,1047,2971,1.8376313276026743
3854,3,2975,981,3956,3.032619775739042
3854,4,3958,990,4948,3.997979797979798
3855,1,238,215,453,1.1069767441860465
3855,2,479,203,682,2.3596059113300494
3855,3,710,191,901,3.717277486910995
3855,4,991,247,1238,4.012145748987854
3856,1,53,543,596,0.09760589318600368
3856,2,605,406,1011,1.4901477832512315
3857,1,22,82,104,0.2682926829268293
3858,1,214,522,736,0.4099616858237548
3858,2,814,669,1483,1.2167414050822123
3858,3,2353,270,2623,8.714814814814815
3858,4,2667,923,3590,2.8894907908992415
3858,5,3628,186,3814,19.50537634408602
3858,6,3845,190,4035,20.236842105263158
3858,7,4070,231,4301,17.61904761904762
3858,8,4394,267,4661,16.45692883895131
3858,9,4715,37,4752,127.43243243243244
3858,10,4801,40,4841,120.025
3858,11,4866,183,5049,26.59016393442623
3858,12,5060,181,5241,27.955801104972377
3858,13,5259,238,5497,22.096638655462186
3858,14,5571,174,5745,32.01724137931034
3858,15,5840,290,6130,20.137931034482758
3858,16,6424,415,6839,15.479518072289157
3858,17,6855,73,6928,93.9041095890411
3858,18,6938,38,6976,182.57894736842104
3858,19,6991,66,7057,105.92424242424242
3858,20,7117,91,7208,78.20879120879121
3858,21,7265,62,7327,117.1774193548387
3859,1,105,736,841,0.14266304347826086
3860,1,684,644,1328,1.062111801242236
3860,2,1481,651,2132,2.2749615975422426
3860,3,2197,621,2818,3.5378421900161032
3861,1,2814,39,2853,72.15384615384616
3861,2,5098,86,5184,59.27906976744186
3862,1,99,265,364,0.37358490566037733
3862,2,450,506,956,0.8893280632411067
3862,3,1152,410,1562,2.8097560975609754
3862,4,1665,641,2306,2.5975039001560063
3862,5,2368,448,2816,5.285714285714286
3862,6,2980,727,3707,4.099037138927097
3862,7,4085,497,4582,8.219315895372233
3862,8,4775,686,5461,6.960641399416909
3862,9,5710,1013,6723,5.6367226061204345
3862,10,6773,1033,7806,6.556631171345595
3863,1,1193,529,1722,2.2551984877126654
3863,2,1823,1105,2928,1.6497737556561085
3863,3,2976,1031,4007,2.886517943743938
3863,4,4147,1060,5207,3.9122641509433964
3863,5,5251,263,5514,19.96577946768061
3863,6,5529,657,6186,8.415525114155251
3863,7,6194,801,6995,7.7328339575530585
3863,8,7003,503,7506,13.922465208747514
3863,9,7515,590,8105,12.73728813559322
3864,1,68,231,299,0.2943722943722944
3864,2,484,1171,1655,0.41332194705380015
3864,3,1682,625,2307,2.6912
3864,4,2371,677,3048,3.502215657311669
3864,5,3132,861,3993,3.637630662020906
3864,6,4039,382,4421,10.573298429319372
3864,7,4528,818,5346,5.5354523227383865
3864,8,5415,1167,6582,4.640102827763497
3864,9,6624,869,7493,7.622554660529344
3864,10,7516,419,7935,17.937947494033413
3864,11,7952,57,8009,139.50877192982455
3865,1,50,869,919,0.05753739930955121
3865,2,944,869,1813,1.0863060989643267
3866,1,48,204,252,0.23529411764705882
3867,1,19,305,324,0.06229508196721312
3868,1,90,586,676,0.15358361774744028
3868,2,748,821,1569,0.9110840438489647
3868,3,1580,302,1882,5.231788079470198
3868,4,1888,223,2111,8.466367713004484
3868,5,2165,942,3107,2.298301486199575
3868,6,3109,437,3546,7.11441647597254
3868,7,3568,224,3792,15.928571428571429
3868,8,3802,373,4175,10.193029490616622
3868,9,4241,990,5231,4.283838383838384
3868,10,5234,169,5403,30.97041420118343
3868,11,5410,36,5446,150.27777777777777
3868,12,5454,987,6441,5.525835866261398
3868,13,6449,639,7088,10.092331768388107
3869,1,960,21,981,45.714285714285715
3869,2,1045,20,1065,52.25
3869,3,1098,21,1119,52.285714285714285
3869,4,1341,27,1368,49.666666666666664
3869,5,1397,24,1421,58.208333333333336
3869,6,1500,47,1547,31.914893617021278
3869,7,1701,31,1732,54.87096774193548
3869,8,1756,43,1799,40.83720930232558
3869,9,2073,33,2106,62.81818181818182
3869,10,2171,40,2211,54.275
3869,11,2306,47,2353,49.06382978723404
3869,12,2380,54,2434,44.074074074074076
3869,13,2483,35,2518,70.94285714285714
3869,14,2557,51,2608,50.13725490196079
3869,15,2627,40,2667,65.675
3869,16,2715,57,2772,47.63157894736842
3869,17,2821,58,2879,48.63793103448276
3869,18,2935,50,2985,58.7
3869,19,3022,75,3097,40.29333333333334
3869,20,3141,59,3200,53.23728813559322
3869,21,3298,26,3324,126.84615384615384
3869,22,3375,64,3439,52.734375
3869,23,3464,37,3501,93.62162162162163
3869,24,3525,49,3574,71.93877551020408
3869,25,3614,49,3663,73.75510204081633
3869,26,3696,52,3748,71.07692307692308
3869,27,3814,60,3874,63.56666666666667
3869,28,3948,63,4011,62.666666666666664
3869,29,4040,63,4103,64.12698412698413
3869,30,4117,46,4163,89.5
3869,31,4194,55,4249,76.25454545454545
3869,32,4336,60,4396,72.26666666666667
3869,33,4452,58,4510,76.75862068965517
3869,34,4637,107,4744,43.33644859813084
3869,35,4864,146,5010,33.31506849315068
3869,36,5066,108,5174,46.907407407407405
3869,37,5218,74,5292,70.51351351351352
3869,38,5375,96,5471,55.989583333333336
3869,39,5566,68,5634,81.8529411764706
3869,40,5862,117,5979,50.1025641025641
3869,41,6052,115,6167,52.62608695652174
3869,42,6227,56,6283,111.19642857142857
3869,43,6352,75,6427,84.69333333333333
3869,44,6504,72,6576,90.33333333333333
3869,45,6633,61,6694,108.73770491803279
3869,46,6718,62,6780,108.35483870967742
3869,47,6835,59,6894,115.84745762711864
3869,48,6935,64,6999,108.359375
3869,49,7098,58,7156,122.37931034482759
3869,50,7197,71,7268,101.36619718309859
3869,51,7300,46,7346,158.69565217391303
3869,52,7383,32,7415,230.71875
3869,53,7667,77,7744,99.57142857142857
3870,1,65,972,1037,0.0668724279835391
3870,2,1048,1001,2049,1.046953046953047
3871,1,39,140,179,0.2785714285714286
3871,2,2158,393,2551,5.4910941475826975
3872,1,210,736,946,0.28532608695652173
3872,2,1050,925,1975,1.135135135135135
3872,3,2061,907,2968,2.2723263506063947
3872,4,3050,808,3858,3.7747524752475248
3872,5,3937,549,4486,7.171220400728598
3872,6,4520,644,5164,7.0186335403726705
3872,7,5224,796,6020,6.562814070351759
3872,8,6069,549,6618,11.05464480874317
3872,9,6646,236,6882,28.161016949152543
3872,10,6920,523,7443,13.231357552581262
3872,11,7509,305,7814,24.619672131147542
3873,1,453,250,703,1.812
3873,2,2809,472,3281,5.951271186440678
3873,3,3407,263,3670,12.954372623574145
3873,4,3680,3,3683,1226.6666666666667
3874,1,209,89,298,2.348314606741573
3874,2,329,132,461,2.492424242424242
3875,1,30,632,662,0.04746835443037975
3875,2,692,651,1343,1.0629800307219661
3875,3,1375,487,1862,2.8234086242299794
3875,4,1892,642,2534,2.9470404984423677
3876,1,33,390,423,0.08461538461538462
3876,2,431,402,833,1.072139303482587
3876,3,841,410,1251,2.051219512195122
3876,4,1309,448,1757,2.921875
3877,1,14,814,828,0.0171990171990172
3878,1,153,164,317,0.9329268292682927
3878,2,358,294,652,1.217687074829932
3878,3,666,279,945,2.3870967741935485
3878,4,973,370,1343,2.6297297297297297
3878,5,1375,330,1705,4.166666666666667
3878,6,1746,362,2108,4.823204419889502
3879,1,25,549,574,0.04553734061930783
3879,2,590,343,933,1.7201166180758019
3879,3,950,448,1398,2.1205357142857144
3879,4,1412,211,1623,6.691943127962086
3880,1,97,682,779,0.14222873900293256
3880,2,825,653,1478,1.2633996937212864
3881,1,1422,453,1875,3.1390728476821192
3881,2,1893,501,2394,3.7784431137724552
3881,3,2438,244,2682,9.991803278688524
3881,4,2689,120,2809,22.408333333333335
3881,5,2821,104,2925,27.125
3881,6,2991,214,3205,13.976635514018692
3881,7,3227,286,3513,11.283216783216783
3881,8,3586,350,3936,10.245714285714286
3881,9,4605,321,4926,14.345794392523365
3881,10,4946,301,5247,16.431893687707642
3881,11,5268,321,5589,16.411214953271028
3881,12,5748,115,5863,49.982608695652175
3881,13,6951,320,7271,21.721875
3881,14,7300,340,7640,21.470588235294116
3882,1,15,499,514,0.03006012024048096
3883,1,1007,2141,3148,0.4703409621672116
3883,2,4260,1744,6004,2.4426605504587156
3883,3,6718,1429,8147,4.701189643107067
3884,1,190,264,454,0.7196969696969697
3885,1,10,506,516,0.019762845849802372
3885,2,537,624,1161,0.8605769230769231
3885,3,1171,510,1681,2.296078431372549
3885,4,1699,1002,2701,1.6956087824351298
3885,5,2704,390,3094,6.933333333333334
3886,1,2873,34,2907,84.5
3886,2,5379,130,5509,41.37692307692308
3886,3,6524,52,6576,125.46153846153847
3886,4,6595,475,7070,13.884210526315789
3886,5,7105,480,7585,14.802083333333334
3886,6,7851,156,8007,50.32692307692308
3887,1,16,311,327,0.05144694533762058
3887,2,335,489,824,0.6850715746421268
3887,3,844,640,1484,1.31875
3888,1,75,1011,1086,0.07418397626112759
3888,2,1092,204,1296,5.352941176470588
3888,3,1510,976,2486,1.5471311475409837
3888,4,2493,609,3102,4.093596059113301
3889,1,318,305,623,1.042622950819672
3889,2,634,379,1013,1.6728232189973615
3889,3,1024,367,1391,2.790190735694823
3889,4,1402,345,1747,4.063768115942029
3889,5,1758,143,1901,12.293706293706293
3889,6,1915,96,2011,19.947916666666668
3889,7,2037,284,2321,7.172535211267606
3889,8,2352,267,2619,8.808988764044944
3889,9,2634,114,2748,23.105263157894736
3889,10,2875,338,3213,8.505917159763314
3889,11,3224,342,3566,9.426900584795321
3889,12,3577,274,3851,13.054744525547445
3889,13,3868,331,4199,11.685800604229607
3889,14,4210,345,4555,12.202898550724637
3889,15,4597,312,4909,14.73397435897436
3889,16,4920,278,5198,17.697841726618705
3889,17,5201,369,5570,14.094850948509485
3890,1,16,512,528,0.03125
3890,2,549,453,1002,1.2119205298013245
3891,1,23,595,618,0.03865546218487395
3892,1,104,563,667,0.1847246891651865
3893,1,10,49,59,0.20408163265306123
3893,2,102,61,163,1.6721311475409837
3893,3,179,354,533,0.5056497175141242
3893,4,595,475,1070,1.2526315789473683
3893,5,1083,141,1224,7.680851063829787
3893,6,1230,140,1370,8.785714285714286
3894,1,911,13,924,70.07692307692308
3894,2,945,711,1656,1.3291139240506329
3895,1,19,94,113,0.20212765957446807
3896,1,453,581,1034,0.7796901893287436
3896,2,1039,489,1528,2.1247443762781186
3896,3,1533,477,2010,3.2138364779874213
3896,4,2015,576,2591,3.498263888888889
3896,5,2733,598,3331,4.570234113712375
3896,6,3336,711,4047,4.69198312236287
3896,7,4190,373,4563,11.233243967828418
3896,8,4626,454,5080,10.189427312775331
3896,9,5232,647,5879,8.086553323029367
3897,1,118,427,545,0.27634660421545665
3897,2,632,567,1199,1.1146384479717812
3898,1,10,289,299,0.03460207612456748
3898,2,322,413,735,0.7796610169491526
3898,3,1655,368,2023,4.497282608695652
3898,4,2200,218,2418,10.091743119266056
3898,5,2636,427,3063,6.173302107728337
3898,6,3214,162,3376,19.839506172839506
3898,7,3513,152,3665,23.111842105263158
3898,8,4154,103,4257,40.33009708737864
3898,9,4356,834,5190,5.223021582733813
3898,10,5506,113,5619,48.72566371681416
3898,11,5726,818,6544,7.0
3898,12,6773,828,7601,8.179951690821255
3899,1,51,68,119,0.75
3899,2,132,78,210,1.6923076923076923
3899,3,269,583,852,0.4614065180102916
3899,4,901,277,1178,3.252707581227437
3900,1,3390,905,4295,3.74585635359116
3900,2,4321,321,4642,13.461059190031152
3900,3,4754,112,4866,42.44642857142857
3900,4,4888,39,4927,125.33333333333333
3900,5,5040,53,5093,95.09433962264151
3900,6,5123,76,5199,67.40789473684211
3900,7,5229,129,5358,40.53488372093023
3900,8,5385,235,5620,22.914893617021278
3901,1,15,170,185,0.08823529411764706
3901,2,193,203,396,0.9507389162561576
3901,3,406,631,1037,0.6434231378763867
3901,4,1045,238,1283,4.390756302521009
3901,5,1293,194,1487,6.664948453608248
3901,6,1494,119,1613,12.554621848739496
3901,7,1616,172,1788,9.395348837209303
3902,1,31,18,49,1.7222222222222223
3902,2,63,29,92,2.1724137931034484
3902,3,115,27,142,4.2592592592592595
3902,4,151,61,212,2.4754098360655736
3902,5,244,35,279,6.9714285714285715
3902,6,488,207,695,2.357487922705314
3902,7,1014,131,1145,7.740458015267175
3902,8,1206,70,1276,17.228571428571428
3902,9,1284,17,1301,75.52941176470588
3902,10,1307,33,1340,39.60606060606061
3902,11,1358,65,1423,20.892307692307693
3902,12,1505,132,1637,11.401515151515152
3902,13,1654,317,1971,5.217665615141956
3902,14,2041,422,2463,4.8364928909952605
3902,15,2471,232,2703,10.650862068965518
3902,16,2719,432,3151,6.293981481481482
3902,17,3158,191,3349,16.534031413612567
3902,18,3358,736,4094,4.5625
3902,19,4134,196,4330,21.091836734693878
3902,20,4334,58,4392,74.72413793103448
3902,21,4400,255,4655,17.254901960784313
3902,22,4754,288,5042,16.506944444444443
3902,23,5056,539,5595,9.380333951762523
3902,24,5612,210,5822,26.723809523809525
3902,25,5837,192,6029,30.401041666666668
3902,26,6043,252,6295,23.98015873015873
3902,27,6312,209,6521,30.20095693779904
3902,28,6532,248,6780,26.338709677419356
3902,29,6793,208,7001,32.65865384615385
3902,30,7017,50,7067,140.34
3902,31,7084,38,7122,186.42105263157896
3902,32,7125,23,7148,309.7826086956522
3902,33,7171,35,7206,204.88571428571427
3902,34,7212,28,7240,257.57142857142856
3902,35,7262,36,7298,201.72222222222223
3902,36,7312,23,7335,317.9130434782609
3902,37,7347,210,7557,34.98571428571429
3902,38,7565,41,7606,184.5121951219512
3902,39,7621,193,7814,39.487046632124354
3903,1,1043,890,1933,1.1719101123595506
3904,1,6,208,214,0.028846153846153848
3904,2,240,218,458,1.1009174311926606
3904,3,474,388,862,1.2216494845360826
3904,4,872,197,1069,4.426395939086294
3904,5,1079,367,1446,2.9400544959128063
3904,6,1481,428,1909,3.460280373831776
3905,1,186,137,323,1.3576642335766422
3906,1,39,388,427,0.10051546391752578
3907,1,74,1155,1229,0.06406926406926407
3907,2,1237,984,2221,1.2571138211382114
3908,1,470,344,814,1.3662790697674418
3908,2,830,347,1177,2.3919308357348705
3909,1,56,665,721,0.08421052631578947
3910,1,108,606,714,0.1782178217821782
3911,1,334,724,1058,0.4613259668508287
3911,2,1657,737,2394,2.248303934871099
3911,3,3052,715,3767,4.268531468531468
3911,4,4452,874,5326,5.093821510297483
3911,5,5777,932,6709,6.198497854077253
3911,6,7332,164,7496,44.707317073170735
3912,1,83,726,809,0.11432506887052342
3913,1,22,148,170,0.14864864864864866
3913,2,198,423,621,0.46808510638297873
3913,3,632,426,1058,1.483568075117371
3913,4,1123,409,1532,2.745721271393643
3913,5,1541,375,1916,4.109333333333334
3913,6,1931,243,2174,7.946502057613169
3913,7,2194,204,2398,10.754901960784315
3913,8,2473,93,2566,26.591397849462364
3913,9,2894,267,3161,10.838951310861423
3913,10,3179,369,3548,8.615176151761517
3913,11,3551,326,3877,10.892638036809815
3913,12,3903,251,4154,15.549800796812749
3913,13,4161,160,4321,26.00625
3913,14,4323,158,4481,27.360759493670887
3913,15,4484,137,4621,32.72992700729927
3913,16,4627,289,4916,16.01038062283737
3913,17,4920,423,5343,11.631205673758865
3913,18,5354,3,5357,1784.6666666666667
3914,1,87,92,179,0.9456521739130435
3914,2,344,265,609,1.2981132075471697
3914,3,789,112,901,7.044642857142857
3914,4,1093,116,1209,9.422413793103448
3914,5,1374,109,1483,12.605504587155963
3914,6,1504,91,1595,16.52747252747253
3914,7,1616,370,1986,4.367567567567567
3915,1,34,556,590,0.06115107913669065
3915,2,623,245,868,2.5428571428571427
3915,3,881,553,1434,1.593128390596745
3915,4,1458,361,1819,4.038781163434903
3915,5,1834,562,2396,3.263345195729537
3915,6,2417,433,2850,5.581986143187067
3915,7,2893,368,3261,7.861413043478261
3915,8,3273,336,3609,9.741071428571429
3915,9,3655,502,4157,7.280876494023905
3916,1,177,793,970,0.223203026481715
3917,1,24,121,145,0.19834710743801653
3917,2,163,528,691,0.3087121212121212
3917,3,734,870,1604,0.8436781609195402
3917,4,1640,132,1772,12.424242424242424
3918,1,30,408,438,0.07352941176470588
3918,2,462,159,621,2.9056603773584904
3918,3,676,233,909,2.9012875536480687
3918,4,932,323,1255,2.8854489164086687
3919,1,29,426,455,0.06807511737089202
3919,2,472,295,767,1.6
3919,3,802,454,1256,1.7665198237885462
3919,4,1272,631,1903,2.0158478605388273
3919,5,1921,398,2319,4.826633165829146
3920,1,495,4,499,123.75
3920,2,2940,4,2944,735.0
3920,3,5636,4,5640,1409.0
3920,4,5680,232,5912,24.482758620689655
3920,5,5953,256,6209,23.25390625
3920,6,6242,703,6945,8.879089615931722
3920,7,6986,749,7735,9.327102803738319
3921,1,67,888,955,0.07545045045045046
3922,1,14,921,935,0.01520086862106406
3923,1,98,406,504,0.2413793103448276
3924,1,144,377,521,0.3819628647214854
3924,2,524,421,945,1.2446555819477434
3924,3,948,217,1165,4.368663594470046
3925,1,113,987,1100,0.11448834853090173
3925,2,1102,255,1357,4.32156862745098
3925,3,1385,829,2214,1.6706875753920385
3925,4,2227,181,2408,12.303867403314918
3925,5,2440,966,3406,2.525879917184265
3925,6,3446,646,4092,5.3343653250774
3925,7,5593,727,6320,7.693259972489684
3926,1,104,317,421,0.3280757097791798
3926,2,424,131,555,3.236641221374046
3926,3,626,379,1005,1.6517150395778364
3926,4,1008,191,1199,5.277486910994765
3927,1,19,566,585,0.03356890459363958
3927,2,648,561,1209,1.1550802139037433
3928,1,91,243,334,0.37448559670781895
3928,2,412,491,903,0.8391038696537678
3929,1,30,655,685,0.04580152671755725
3929,2,706,814,1520,0.8673218673218673
3929,3,1559,635,2194,2.4551181102362203
3929,4,2248,1053,3301,2.134852801519468
3929,5,3309,336,3645,9.848214285714286
3929,6,3697,786,4483,4.703562340966921
3929,7,4505,968,5473,4.653925619834711
3929,8,5481,293,5774,18.706484641638227
3930,1,60,832,892,0.07211538461538461
3930,2,900,880,1780,1.0227272727272727
3931,1,47,863,910,0.054461181923522596
3932,1,62,846,908,0.07328605200945626
3933,1,58,328,386,0.17682926829268292
3933,2,1761,1180,2941,1.4923728813559323
3933,3,2981,602,3583,4.951827242524917
3933,4,3986,556,4542,7.169064748201439
3933,5,4554,343,4897,13.276967930029155
3933,6,4962,821,5783,6.043848964677223
3933,7,5857,1310,7167,4.470992366412213
3934,1,515,1298,1813,0.3967642526964561
3934,2,2015,1129,3144,1.7847652790079716
3934,3,3310,968,4278,3.419421487603306
3934,4,4513,1141,5654,3.955302366345311
3934,5,5821,836,6657,6.962918660287081
3934,6,6903,382,7285,18.07068062827225
3935,1,124,69,193,1.7971014492753623
3935,2,341,116,457,2.939655172413793
3935,3,507,73,580,6.945205479452055
3935,4,590,54,644,10.925925925925926
3935,5,728,209,937,3.4832535885167464
3936,1,13,617,630,0.02106969205834684
3937,1,1197,424,1621,2.82311320754717
3937,2,1926,314,2240,6.13375796178344
3938,1,106,595,701,0.1781512605042017
3939,1,400,192,592,2.0833333333333335
3939,2,1339,234,1573,5.722222222222222
3939,3,1949,287,2236,6.790940766550523
3939,4,2969,371,3340,8.002695417789758
3939,5,3726,365,4091,10.208219178082192
3939,6,4478,371,4849,12.070080862533693
3939,7,5051,414,5465,12.20048309178744
3939,8,5521,521,6042,10.596928982725528
3940,1,755,401,1156,1.8827930174563592
3940,2,1273,13,1286,97.92307692307692
3941,1,117,65,182,1.8
3941,2,279,118,397,2.364406779661017
3941,3,452,180,632,2.511111111111111
3941,4,656,200,856,3.28
3941,5,946,335,1281,2.8238805970149254
3942,1,45,897,942,0.05016722408026756
3942,2,965,951,1916,1.0147213459516298
3942,3,1935,401,2336,4.8254364089775565
3942,4,2368,778,3146,3.043701799485861
3942,5,3160,936,4096,3.376068376068376
3942,6,4125,1005,5130,4.104477611940299
3942,7,5165,885,6050,5.836158192090395
3942,8,6072,501,6573,12.119760479041917
3942,9,6602,478,7080,13.811715481171548
3942,10,7102,514,7616,13.817120622568094
3943,1,3973,9,3982,441.44444444444446
3943,2,4066,529,4595,7.686200378071834
3943,3,4665,608,5273,7.672697368421052
3944,1,33,97,130,0.3402061855670103
3944,2,152,168,320,0.9047619047619048
3945,1,1260,828,2088,1.5217391304347827
3945,2,2209,1051,3260,2.1018078020932447
3945,3,3338,1083,4421,3.0821791320406278
3945,4,5780,823,6603,7.023086269744836
3945,5,6739,962,7701,7.005197505197505
3946,1,20,396,416,0.050505050505050504
3946,2,498,682,1180,0.7302052785923754
3946,3,1200,59,1259,20.338983050847457
3947,1,1332,995,2327,1.3386934673366835
3947,2,5453,1147,6600,4.754141238012206
3947,3,6697,1069,7766,6.264733395696913
3948,1,51,546,597,0.09340659340659341
3948,2,622,522,1144,1.1915708812260537
3948,3,1158,487,1645,2.37782340862423
3949,1,1024,631,1655,1.6228209191759113
3950,1,160,672,832,0.23809523809523808
3950,2,4345,953,5298,4.559286463798531
3950,3,5384,513,5897,10.495126705653021
3951,1,16,598,614,0.026755852842809364
3951,2,630,379,1009,1.6622691292875988
3951,3,1026,478,1504,2.1464435146443517
3951,4,1537,244,1781,6.299180327868853
3951,5,1831,431,2262,4.248259860788863
3951,6,2349,392,2741,5.99234693877551
3951,7,2813,720,3533,3.9069444444444446
3951,8,3551,426,3977,8.335680751173708
3951,9,4009,235,4244,17.059574468085106
3951,10,4257,524,4781,8.124045801526718
3951,11,4842,513,5355,9.43859649122807
3951,12,5373,475,5848,11.311578947368421
3951,13,5863,373,6236,15.718498659517426
3952,1,111,1058,1169,0.10491493383742911
3952,2,1189,339,1528,3.5073746312684366
3952,3,1542,271,1813,5.6900369003690034
3952,4,1846,169,2015,10.923076923076923
3952,5,2024,393,2417,5.150127226463105
3952,6,2436,673,3109,3.6196136701337296
3952,7,3165,921,4086,3.436482084690554
3952,8,4088,284,4372,14.394366197183098
3952,9,4415,499,4914,8.847695390781563
3952,10,4963,267,5230,18.588014981273407
3952,11,5254,944,6198,5.565677966101695
3952,12,6200,230,6430,26.956521739130434
3952,13,6441,350,6791,18.402857142857144
3952,14,6832,896,7728,7.625
3953,1,53,417,470,0.12709832134292565
3953,2,511,194,705,2.634020618556701
3953,3,742,286,1028,2.5944055944055946
3953,4,1084,446,1530,2.430493273542601
3953,5,1570,186,1756,8.440860215053764
3953,6,1766,181,1947,9.756906077348066
3953,7,1958,225,2183,8.702222222222222
3953,8,2203,536,2739,4.110074626865671
3954,1,88,1058,1146,0.0831758034026465
3954,2,1154,562,1716,2.0533807829181496
3954,3,1747,1075,2822,1.6251162790697675
3954,4,2838,717,3555,3.9581589958158996
3955,1,38,250,288,0.152
3955,2,555,330,885,1.6818181818181819
3955,3,906,243,1149,3.728395061728395
3955,4,1165,371,1536,3.1401617250673852
3956,1,32,46,78,0.6956521739130435
3956,2,515,3,518,171.66666666666666
3956,3,1288,3,1291,429.3333333333333
3957,1,18,319,337,0.05642633228840126
3957,2,345,592,937,0.5827702702702703
3957,3,942,711,1653,1.3248945147679325
3958,1,27,580,607,0.04655172413793104
3959,1,62,3835,3897,0.01616688396349413
3960,1,100,870,970,0.11494252873563218
3960,2,1031,408,1439,2.5269607843137254
3960,3,1482,709,2191,2.090267983074753
3960,4,2217,584,2801,3.796232876712329
3961,1,51,384,435,0.1328125
3961,2,457,251,708,1.8207171314741035
3962,1,2373,1886,4259,1.2582184517497348
3963,1,24,628,652,0.03821656050955414
3964,1,23,38,61,0.6052631578947368
3964,2,67,296,363,0.22635135135135134
3964,3,373,159,532,2.3459119496855347
3964,4,553,296,849,1.8682432432432432
3964,5,874,512,1386,1.70703125
3964,6,1425,348,1773,4.094827586206897
3964,7,1790,436,2226,4.105504587155964
3965,1,21,527,548,0.03984819734345351
3965,2,571,568,1139,1.005281690140845
3965,3,1147,547,1694,2.096892138939671
3966,1,18,1019,1037,0.017664376840039256
3966,2,1043,632,1675,1.6503164556962024
3967,1,91,210,301,0.43333333333333335
3967,2,429,112,541,3.830357142857143
3967,3,569,443,1012,1.2844243792325056
3967,4,1023,17,1040,60.1764705882353
3967,5,1057,315,1372,3.3555555555555556
3967,6,1435,185,1620,7.756756756756757
3967,7,1792,445,2237,4.026966292134832
3967,8,2254,142,2396,15.873239436619718
3967,9,2495,260,2755,9.596153846153847
3967,10,2919,282,3201,10.351063829787234
3967,11,3301,397,3698,8.314861460957179
3967,12,3748,290,4038,12.924137931034483
3967,13,4159,306,4465,13.591503267973856
3968,1,1255,689,1944,1.8214804063860668
3969,1,242,896,1138,0.2700892857142857
3969,2,1141,147,1288,7.761904761904762
3969,3,1323,919,2242,1.439608269858542
3969,4,2245,253,2498,8.873517786561266
3969,5,2512,958,3470,2.6221294363256784
3970,1,470,664,1134,0.7078313253012049
3970,2,1143,512,1655,2.232421875
3971,1,3725,150,3875,24.833333333333332
3971,2,3930,894,4824,4.395973154362416
3971,3,4897,537,5434,9.119180633147113
3971,4,5461,293,5754,18.638225255972696
3971,5,5791,446,6237,12.984304932735427
3971,6,6267,597,6864,10.49748743718593
3971,7,6906,144,7050,47.958333333333336
3971,8,7195,96,7291,74.94791666666667
3972,1,41,860,901,0.047674418604651166
3972,2,936,994,1930,0.9416498993963782
3972,3,1951,1075,3026,1.8148837209302326
3972,4,3046,1076,4122,2.8308550185873607
3972,5,4166,1088,5254,3.829044117647059
3972,6,5278,1005,6283,5.251741293532338
3972,7,6296,972,7268,6.477366255144033
3973,1,32,814,846,0.03931203931203931
3973,2,889,829,1718,1.0723763570566949
3973,3,1733,757,2490,2.2892998678996035
3973,4,2567,781,3348,3.2868117797695264
3973,5,3363,471,3834,7.140127388535032
3973,6,3862,770,4632,5.015584415584415
3973,7,4639,728,5367,6.372252747252747
3973,8,5400,530,5930,10.18867924528302
3973,9,5980,701,6681,8.530670470756062
3973,10,6747,752,7499,8.972074468085106
3974,1,19,113,132,0.168141592920354
3974,2,170,160,330,1.0625
3974,3,335,41,376,8.170731707317072
3974,4,407,312,719,1.3044871794871795
3974,5,741,310,1051,2.390322580645161
3974,6,1096,263,1359,4.167300380228137
3974,7,1373,3,1376,457.6666666666667
3975,1,242,896,1138,0.2700892857142857
3975,2,1141,147,1288,7.761904761904762
3975,3,1323,919,2242,1.439608269858542
3976,1,1222,1005,2227,1.2159203980099502
3976,2,2243,207,2450,10.83574879227053
3976,3,2477,465,2942,5.326881720430108
3976,4,2965,526,3491,5.636882129277566
3976,5,3515,612,4127,5.743464052287582
3976,6,4151,547,4698,7.588665447897624
3976,7,4720,713,5433,6.6199158485273495
3976,8,5456,643,6099,8.485225505443236
3976,9,6114,635,6749,9.628346456692913
3976,10,6771,549,7320,12.333333333333334
3976,11,7337,575,7912,12.76
3977,1,92,527,619,0.174573055028463
3977,2,633,139,772,4.553956834532374
3977,3,801,438,1239,1.8287671232876712
3977,4,1285,280,1565,4.589285714285714
3977,5,1581,460,2041,3.4369565217391305
3977,6,2087,405,2492,5.153086419753087
3977,7,2503,107,2610,23.39252336448598
3977,8,2642,427,3069,6.187353629976581
3977,9,3071,277,3348,11.086642599277978
3977,10,3363,185,3548,18.17837837837838
3977,11,3571,205,3776,17.41951219512195
3977,12,3787,103,3890,36.76699029126213
3977,13,3912,307,4219,12.742671009771987
3977,14,4232,366,4598,11.562841530054644
3978,1,84,69,153,1.2173913043478262
3978,2,189,191,380,0.9895287958115183
3978,3,386,64,450,6.03125
3978,4,532,232,764,2.293103448275862
3979,1,12,721,733,0.016643550624133148
3979,2,751,920,1671,0.816304347826087
3979,3,1683,639,2322,2.6338028169014085
3979,4,2339,973,3312,2.403905447070915
3979,5,3341,692,4033,4.828034682080925
3979,6,4053,893,4946,4.538633818589026
3979,7,4976,647,5623,7.690880989180835
3979,8,5640,836,6476,6.746411483253588
3980,1,185,414,599,0.4468599033816425
3980,2,760,402,1162,1.890547263681592
3980,3,1164,451,1615,2.5809312638580932
3980,4,1617,355,1972,4.554929577464788
3980,5,1974,453,2427,4.357615894039735
3980,6,2429,195,2624,12.456410256410257
3980,7,2704,382,3086,7.0785340314136125
3980,8,3125,413,3538,7.566585956416465
3980,9,3540,386,3926,9.17098445595855
3980,10,3971,413,4384,9.615012106537531
3980,11,4386,413,4799,10.619854721549636
3980,12,4801,220,5021,21.822727272727274
3980,13,5070,441,5511,11.496598639455783
3980,14,5551,506,6057,10.970355731225297
3980,15,6065,352,6417,17.230113636363637
3980,16,6441,488,6929,13.198770491803279
3980,17,6931,363,7294,19.09366391184573
3981,1,62,820,882,0.07560975609756097
3981,2,906,607,1513,1.4925864909390445
3981,3,1592,653,2245,2.437978560490046
3981,4,2280,433,2713,5.265588914549654
3981,5,2808,416,3224,6.75
3981,6,3245,459,3704,7.069716775599129
3981,7,3746,772,4518,4.852331606217617
3981,8,4568,442,5010,10.334841628959277
3981,9,5051,656,5707,7.699695121951219
3982,1,15,573,588,0.02617801047120419
3982,2,600,648,1248,0.9259259259259259
3982,3,1316,703,2019,1.871977240398293
3982,4,2037,719,2756,2.8331015299026427
3982,5,2815,948,3763,2.969409282700422
3982,6,3780,994,4774,3.8028169014084505
3982,7,4781,158,4939,30.259493670886076
3982,8,4953,727,5680,6.81292984869326
3983,1,345,469,814,0.7356076759061834
3984,1,18,636,654,0.02830188679245283
3985,1,60,75,135,0.8
3985,2,392,583,975,0.6723842195540308
3986,1,3001,601,3602,4.993344425956739
3987,1,21,251,272,0.08366533864541832
3987,2,277,358,635,0.7737430167597765
3987,3,640,234,874,2.735042735042735
3987,4,879,256,1135,3.43359375
3987,5,1140,228,1368,5.0
3987,6,1403,133,1536,10.548872180451127
3987,7,1571,361,1932,4.351800554016621
3987,8,1937,348,2285,5.566091954022989
3987,9,2290,206,2496,11.116504854368932
3987,10,2558,368,2926,6.951086956521739
3987,11,2931,377,3308,7.774535809018568
3987,12,3313,287,3600,11.543554006968641
3987,13,3645,302,3947,12.06953642384106
3987,14,3952,245,4197,16.13061224489796
3987,15,4221,544,4765,7.759191176470588
3987,16,4770,482,5252,9.896265560165975
3987,17,5281,296,5577,17.841216216216218
3987,18,5582,84,5666,66.45238095238095
3988,1,794,480,1274,1.6541666666666666
3988,2,1324,605,1929,2.188429752066116
3988,3,2000,465,2465,4.301075268817204
3988,4,2851,526,3377,5.420152091254753
3988,5,6467,680,7147,9.510294117647058
3989,1,159,1063,1222,0.1495766698024459
3989,2,1238,955,2193,1.2963350785340315
3990,1,23,226,249,0.10176991150442478
3990,2,262,457,719,0.5733041575492341
3990,3,755,346,1101,2.1820809248554913
3990,4,1113,411,1524,2.708029197080292
3990,5,1530,196,1726,7.8061224489795915
3990,6,1740,382,2122,4.554973821989528
3990,7,2220,358,2578,6.201117318435754
3990,8,2585,289,2874,8.944636678200691
3990,9,2963,452,3415,6.5553097345132745
3991,1,94,109,203,0.8623853211009175
3991,2,257,58,315,4.431034482758621
3991,3,1101,347,1448,3.1729106628242074
3991,4,1991,403,2394,4.94044665012407
3991,5,3053,420,3473,7.269047619047619
3991,6,3513,61,3574,57.59016393442623
3991,7,3703,637,4340,5.813186813186813
3991,8,4383,424,4807,10.337264150943396
3991,9,4832,398,5230,12.140703517587939
3991,10,5262,167,5429,31.508982035928145
3991,11,5467,145,5612,37.703448275862065
3991,12,5647,405,6052,13.943209876543209
3991,13,6095,289,6384,21.089965397923876
3991,14,6407,457,6864,14.019693654266959
3992,1,474,423,897,1.1205673758865249
3992,2,903,271,1174,3.3321033210332103
3992,3,1208,475,1683,2.5431578947368423
3992,4,1725,466,2191,3.7017167381974247
3992,5,2214,805,3019,2.7503105590062114
3993,1,1608,375,1983,4.288
3993,2,1990,404,2394,4.925742574257426
3993,3,2401,414,2815,5.799516908212561
3993,4,2822,283,3105,9.97173144876325
3993,5,3112,37,3149,84.10810810810811
3994,1,212,38,250,5.578947368421052
3994,2,283,208,491,1.3605769230769231
3994,3,584,250,834,2.336
3994,4,872,254,1126,3.4330708661417324
3994,5,1179,259,1438,4.552123552123552
3994,6,1468,299,1767,4.909698996655519
3994,7,1978,38,2016,52.05263157894737
3994,8,2051,174,2225,11.78735632183908
3994,9,2254,224,2478,10.0625
3994,10,2486,259,2745,9.5984555984556
3994,11,2794,292,3086,9.568493150684931
3994,12,3141,354,3495,8.872881355932204
3994,13,3520,392,3912,8.979591836734693
3994,14,3938,713,4651,5.5231416549789625
3995,1,57,787,844,0.0724269377382465
3996,1,231,481,712,0.4802494802494803
3996,2,734,395,1129,1.8582278481012657
3996,3,1137,415,1552,2.7397590361445783
3996,4,1561,57,1618,27.385964912280702
3996,5,1625,24,1649,67.70833333333333
3996,6,1655,41,1696,40.36585365853659
3996,7,2211,513,2724,4.309941520467836
3997,1,19,361,380,0.05263157894736842
3997,2,402,508,910,0.7913385826771654
3998,1,128,469,597,0.27292110874200426
3998,2,712,415,1127,1.7156626506024097
3998,3,1171,373,1544,3.1394101876675604
3998,4,1603,552,2155,2.903985507246377
3998,5,2195,481,2676,4.5634095634095635
3998,6,2721,531,3252,5.124293785310734
3998,7,3264,437,3701,7.469107551487414
3998,8,3785,612,4397,6.184640522875817
3998,9,4424,496,4920,8.919354838709678
3998,10,4980,402,5382,12.388059701492537
3998,11,5421,477,5898,11.364779874213836
3998,12,5928,463,6391,12.803455723542116
3998,13,6626,496,7122,13.358870967741936
3998,14,7143,433,7576,16.496535796766743
3998,15,7599,470,8069,16.16808510638298
3999,1,77,571,648,0.13485113835376533
3999,2,667,104,771,6.413461538461538
4000,1,83,339,422,0.2448377581120944
4000,2,437,534,971,0.8183520599250936
4001,1,35,741,776,0.04723346828609987
4001,2,809,494,1303,1.6376518218623481
4002,1,130,446,576,0.2914798206278027
4002,2,584,413,997,1.414043583535109
4003,1,129,812,941,0.15886699507389163
4004,1,286,623,909,0.4590690208667737
4004,2,936,434,1370,2.1566820276497696
4004,3,1396,458,1854,3.0480349344978164
4005,1,33,964,997,0.03423236514522822
4005,2,1021,168,1189,6.0773809523809526
4005,3,1205,283,1488,4.257950530035336
4005,4,1496,175,1671,8.548571428571428
4005,5,1679,57,1736,29.45614035087719
4005,6,1762,79,1841,22.303797468354432
4005,7,1869,1144,3013,1.6337412587412588
4006,1,53,350,403,0.15142857142857144
4006,2,416,540,956,0.7703703703703704
4006,3,969,556,1525,1.7428057553956835
4006,4,1546,613,2159,2.5220228384991845
4006,5,2167,413,2580,5.246973365617434
4006,6,2595,461,3056,5.629067245119306
4006,7,3113,637,3750,4.8869701726844585
4006,8,3763,540,4303,6.968518518518518
4006,9,4319,529,4848,8.164461247637051
4006,10,4859,882,5741,5.50907029478458
4006,11,5762,342,6104,16.84795321637427
4006,12,6129,375,6504,16.344
4006,13,6533,88,6621,74.23863636363636
4006,14,6642,66,6708,100.63636363636364
4006,15,6718,75,6793,89.57333333333334
4007,1,155,789,944,0.1964512040557668
4007,2,981,884,1865,1.1097285067873304
4007,3,1887,985,2872,1.915736040609137
4007,4,2908,733,3641,3.9672578444747613
4007,5,3666,631,4297,5.809825673534073
4007,6,4321,760,5081,5.685526315789474
4007,7,5120,182,5302,28.13186813186813
4007,8,5347,708,6055,7.55225988700565
4007,9,6065,915,6980,6.628415300546448
4007,10,6988,891,7879,7.84287317620651
4008,1,171,225,396,0.76
4008,2,418,233,651,1.793991416309013
4008,3,826,157,983,5.261146496815287
4008,4,1188,107,1295,11.102803738317757
4008,5,5254,250,5504,21.016
4008,6,5521,52,5573,106.17307692307692
4008,7,5606,43,5649,130.37209302325581
4008,8,5670,3,5673,1890.0
4009,1,31,149,180,0.2080536912751678
4009,2,191,218,409,0.8761467889908257
4010,1,95,538,633,0.17657992565055763
4010,2,728,537,1265,1.355679702048417
4010,3,1362,590,1952,2.3084745762711862
4010,4,1989,919,2908,2.1643090315560394
4010,5,2947,810,3757,3.6382716049382715
4010,6,3811,824,4635,4.625
4010,7,4744,1011,5755,4.692383778437191
4011,1,121,753,874,0.16069057104913678
4012,1,11,151,162,0.0728476821192053
4012,2,183,202,385,0.905940594059406
4012,3,410,530,940,0.7735849056603774
4012,4,960,433,1393,2.2170900692840645
4012,5,1412,642,2054,2.1993769470404985
4012,6,2067,153,2220,13.509803921568627
4012,7,2240,339,2579,6.607669616519174
4012,8,2599,383,2982,6.785900783289817
4012,9,2998,319,3317,9.398119122257054
4013,1,27,643,670,0.041990668740279936
4013,2,687,427,1114,1.6088992974238876
4013,3,1137,281,1418,4.0462633451957295
4013,4,1451,513,1964,2.828460038986355
4013,5,1988,570,2558,3.487719298245614
4014,1,118,50,168,2.36
4014,2,254,33,287,7.696969696969697
4014,3,289,341,630,0.8475073313782991
4015,1,78,616,694,0.1266233766233766
4015,2,702,587,1289,1.1959114139693356
4016,1,102,1074,1176,0.09497206703910614
4017,1,675,29,704,23.275862068965516
4017,2,709,63,772,11.253968253968255
4017,3,780,86,866,9.069767441860465
4017,4,878,81,959,10.839506172839506
4017,5,967,16,983,60.4375
4017,6,998,69,1067,14.46376811594203
4018,1,129,78,207,1.6538461538461537
4018,2,224,61,285,3.6721311475409837
4018,3,315,120,435,2.625
4018,4,439,124,563,3.5403225806451615
4018,5,582,152,734,3.8289473684210527
4018,6,738,226,964,3.265486725663717
4018,7,1099,138,1237,7.963768115942029
4018,8,1382,127,1509,10.881889763779528
4018,9,1517,86,1603,17.63953488372093
4018,10,1612,245,1857,6.579591836734694
4018,11,1933,212,2145,9.117924528301886
4018,12,2162,186,2348,11.623655913978494
4018,13,2403,145,2548,16.572413793103447
4018,14,2552,702,3254,3.635327635327635
4018,15,3277,79,3356,41.48101265822785
4018,16,3362,73,3435,46.054794520547944
4018,17,4001,621,4622,6.442834138486313
4018,18,4641,457,5098,10.155361050328228
4018,19,5123,401,5524,12.775561097256858
4018,20,5533,861,6394,6.4262485481997675
4019,1,88,403,491,0.21836228287841192
4019,2,636,439,1075,1.44874715261959
4019,3,1287,495,1782,2.6
4019,4,1797,522,2319,3.442528735632184
4019,5,2333,608,2941,3.8371710526315788
4019,6,2975,696,3671,4.274425287356322
4019,7,3697,777,4474,4.758043758043758
4019,11,4828,1,4829,4828.0
4019,12,4877,673,5550,7.24665676077266
4019,13,5737,707,6444,8.114568599717115
4019,14,6507,766,7273,8.494778067885118
4020,1,30,679,709,0.044182621502209134
4020,2,722,548,1270,1.3175182481751824
4020,3,1286,610,1896,2.1081967213114754
4020,4,1907,405,2312,4.708641975308642
4020,5,2358,666,3024,3.5405405405405403
4020,6,3090,329,3419,9.39209726443769
4020,7,3589,587,4176,6.114139693356048
4020,8,4205,382,4587,11.007853403141361
4020,9,4628,460,5088,10.060869565217391
4020,10,5340,502,5842,10.637450199203187
4020,11,5866,273,6139,21.487179487179485
4020,12,6155,255,6410,24.137254901960784
4020,13,6451,349,6800,18.484240687679083
4020,14,6818,285,7103,23.92280701754386
4020,15,7304,481,7785,15.185031185031185
4021,1,85,881,966,0.09648127128263337
4021,2,979,552,1531,1.7735507246376812
4021,3,1552,535,2087,2.9009345794392525
4022,1,142,84,226,1.6904761904761905
4023,1,55,571,626,0.09632224168126094
4023,2,650,924,1574,0.7034632034632035
4023,3,1612,791,2403,2.0379266750948166
4023,4,2410,154,2564,15.64935064935065
4023,5,2573,160,2733,16.08125
4023,6,2745,256,3001,10.72265625
4023,7,3026,271,3297,11.166051660516604
4023,8,3313,402,3715,8.24129353233831
4023,9,3732,281,4013,13.281138790035588
4024,1,11,42,53,0.2619047619047619
4024,2,118,73,191,1.6164383561643836
4024,3,206,111,317,1.8558558558558558
4025,1,31,334,365,0.09281437125748503
4026,1,277,431,708,0.642691415313225
4026,2,715,479,1194,1.4926931106471817
4027,1,46,535,581,0.08598130841121496
4027,2,651,1028,1679,0.6332684824902723
4027,3,1730,1163,2893,1.4875322441960448
4027,4,2960,1087,4047,2.723091076356946
4027,5,4094,1223,5317,3.3475061324611612
4027,6,5389,1183,6572,4.555367709213863
4027,7,6592,766,7358,8.605744125326371
4028,1,14,529,543,0.026465028355387523
4029,1,64,389,453,0.16452442159383032
4029,2,487,390,877,1.2487179487179487
4029,3,919,377,1296,2.4376657824933687
4029,4,1316,403,1719,3.2655086848635237
4029,5,1740,362,2102,4.806629834254144
4029,6,2114,579,2693,3.6511226252158893
4029,7,2724,551,3275,4.943738656987295
4029,8,3286,161,3447,20.40993788819876
4029,9,3457,260,3717,13.296153846153846
4030,1,40,772,812,0.05181347150259067
4031,1,18,762,780,0.023622047244094488
4031,2,791,448,1239,1.765625
4032,1,19,332,351,0.0572289156626506
4032,2,409,1017,1426,0.40216322517207476
4032,3,1528,728,2256,2.098901098901099
4032,4,2389,624,3013,3.828525641025641
4032,5,3053,625,3678,4.8848
4032,6,3719,769,4488,4.836150845253576
4032,7,4564,710,5274,6.428169014084507
4033,1,38,182,220,0.2087912087912088
4034,1,320,964,1284,0.33195020746887965
4034,2,1291,983,2274,1.313326551373347
4034,3,2306,974,3280,2.3675564681724848
4034,4,3287,627,3914,5.242424242424242
4035,1,1049,198,1247,5.297979797979798
4035,2,1252,201,1453,6.2288557213930345
4035,3,1458,407,1865,3.5823095823095823
4035,4,1871,206,2077,9.08252427184466
4035,5,2082,209,2291,9.961722488038278
4035,6,2297,44,2341,52.20454545454545
4036,1,3590,81,3671,44.32098765432099
4036,2,3738,183,3921,20.42622950819672
4036,3,3946,328,4274,12.03048780487805
4036,4,4314,777,5091,5.552123552123552
4037,1,11,65,76,0.16923076923076924
4037,2,85,78,163,1.0897435897435896
4037,3,221,246,467,0.8983739837398373
4037,4,481,192,673,2.5052083333333335
4037,5,689,222,911,3.1036036036036037
4037,6,960,169,1129,5.680473372781065
4037,7,1143,310,1453,3.6870967741935483
4037,8,1519,31,1550,49.0
4037,9,1617,125,1742,12.936
4037,10,1821,221,2042,8.239819004524886
4037,11,2058,180,2238,11.433333333333334
4037,12,2298,168,2466,13.678571428571429
4038,1,31,80,111,0.3875
4038,2,557,231,788,2.411255411255411
4038,3,810,29,839,27.93103448275862
4038,4,1624,3,1627,541.3333333333334
4038,5,2184,3,2187,728.0
4038,6,2962,3,2965,987.3333333333334
4038,7,2989,33,3022,90.57575757575758
4038,8,3741,3,3744,1247.0
4038,9,3756,159,3915,23.62264150943396
4038,10,5818,3,5821,1939.3333333333333
4038,11,5876,402,6278,14.616915422885572
4038,12,6337,443,6780,14.304740406320542
4038,13,6816,424,7240,16.07547169811321
4039,1,25,732,757,0.03415300546448088
4039,2,768,464,1232,1.6551724137931034
4039,3,1262,402,1664,3.1393034825870645
4040,1,11,151,162,0.0728476821192053
4040,2,183,202,385,0.905940594059406
4040,3,410,530,940,0.7735849056603774
4040,4,960,433,1393,2.2170900692840645
4040,5,1412,642,2054,2.1993769470404985
4040,6,2069,226,2295,9.154867256637168
4040,7,2315,430,2745,5.383720930232558
4040,8,2761,388,3149,7.115979381443299
4040,9,3164,87,3251,36.367816091954026
4041,1,74,526,600,0.14068441064638784
4041,2,619,7,626,88.42857142857143
4041,3,637,96,733,6.635416666666667
4041,4,913,537,1450,1.7001862197392923
4041,5,1492,584,2076,2.5547945205479454
4041,6,2103,458,2561,4.591703056768559
4041,7,2567,34,2601,75.5
4041,8,2606,37,2643,70.43243243243244
4042,1,9,57,66,0.15789473684210525
4042,2,71,137,208,0.5182481751824818
4042,3,215,1030,1245,0.2087378640776699
4042,4,1248,1008,2256,1.2380952380952381
4042,5,2259,220,2479,10.268181818181818
4042,6,2483,131,2614,18.954198473282442
4042,7,2630,503,3133,5.2286282306163026
4042,8,3179,201,3380,15.81592039800995
4042,9,3399,57,3456,59.63157894736842
4042,10,3506,851,4357,4.119858989424207
4042,11,4410,249,4659,17.710843373493976
4042,12,4679,687,5366,6.810771470160116
4042,13,5385,223,5608,24.14798206278027
4042,14,5632,288,5920,19.555555555555557
4042,15,5949,853,6802,6.974208675263775
4042,16,6804,859,7663,7.920838183934808
4043,1,73,451,524,0.16186252771618626
4043,2,564,512,1076,1.1015625
4043,3,1098,244,1342,4.5
4044,1,95,937,1032,0.10138740661686232
4044,2,1034,41,1075,25.21951219512195
4044,3,1092,619,1711,1.764135702746365
4044,4,1728,634,2362,2.725552050473186
4045,1,57,419,476,0.1360381861575179
4045,2,489,262,751,1.866412213740458
4045,3,760,328,1088,2.317073170731707
4045,4,1096,573,1669,1.912739965095986
4045,5,1680,461,2141,3.644251626898048
4046,1,182,361,543,0.5041551246537396
4046,2,992,484,1476,2.049586776859504
4046,3,1899,329,2228,5.772036474164134
4046,4,2692,374,3066,7.197860962566845
4046,5,3774,234,4008,16.128205128205128
4046,6,4185,328,4513,12.759146341463415
4046,7,5508,544,6052,10.125
4046,8,6064,41,6105,147.90243902439025
4047,1,40,704,744,0.056818181818181816
4047,2,773,928,1701,0.8329741379310345
4048,1,236,630,866,0.3746031746031746
4048,2,939,664,1603,1.4141566265060241
4048,3,1706,868,2574,1.9654377880184333
4048,4,2581,435,3016,5.933333333333334
4048,5,3065,669,3734,4.581464872944694
4049,1,321,311,632,1.0321543408360128
4049,2,652,237,889,2.7510548523206753
4050,1,757,600,1357,1.2616666666666667
4050,2,1498,544,2042,2.7536764705882355
4050,3,2127,902,3029,2.358093126385809
4050,4,3034,496,3530,6.116935483870968
4050,5,3586,729,4315,4.919067215363512
4050,6,4344,397,4741,10.942065491183879
4050,7,4758,497,5255,9.57344064386318
4051,1,69,24,93,2.875
4051,2,728,628,1356,1.1592356687898089
4051,3,1363,480,1843,2.839583333333333
4051,4,1883,865,2748,2.176878612716763
4052,1,2899,387,3286,7.4909560723514215
4052,2,3288,404,3692,8.138613861386139
4052,3,3767,301,4068,12.514950166112957
4052,4,4070,360,4430,11.305555555555555
4052,5,4595,319,4914,14.404388714733543
4052,6,4958,359,5317,13.81058495821727
4052,7,5563,378,5941,14.716931216931217
4053,1,209,89,298,2.348314606741573
4053,2,329,132,461,2.492424242424242
4053,3,491,192,683,2.5572916666666665
4054,1,46,979,1025,0.04698672114402452
4054,2,1036,416,1452,2.4903846153846154
4055,1,237,74,311,3.2027027027027026
4055,2,331,110,441,3.0090909090909093
4055,3,562,231,793,2.432900432900433
4055,4,840,122,962,6.885245901639344
4055,5,976,93,1069,10.494623655913978
4055,6,1165,123,1288,9.471544715447154
4055,7,1359,229,1588,5.934497816593886
4055,8,1615,136,1751,11.875
4055,9,1816,136,1952,13.352941176470589
4055,10,1962,115,2077,17.06086956521739
4055,11,2092,245,2337,8.538775510204081
4055,12,2349,140,2489,16.77857142857143
4056,1,12,579,591,0.02072538860103627
4056,2,607,553,1160,1.0976491862567812
4056,3,1220,868,2088,1.4055299539170507
4056,4,2172,644,2816,3.372670807453416
4057,1,20,717,737,0.02789400278940028
4058,1,54,240,294,0.225
4058,2,313,257,570,1.2178988326848248
4058,3,578,44,622,13.136363636363637
4059,1,41,148,189,0.27702702702702703
4059,2,217,1176,1393,0.18452380952380953
4059,3,1423,1120,2543,1.2705357142857143
4059,4,2598,1233,3831,2.1070559610705595
4059,5,3890,1177,5067,3.3050127442650807
4059,6,5106,1172,6278,4.356655290102389
4060,1,117,342,459,0.34210526315789475
4060,2,477,717,1194,0.6652719665271967
4061,1,43,185,228,0.23243243243243245
4061,2,247,151,398,1.6357615894039734
4061,3,416,103,519,4.038834951456311
4062,1,74,66,140,1.121212121212121
4062,2,174,43,217,4.046511627906977
4062,3,256,35,291,7.314285714285714
4062,4,339,41,380,8.268292682926829
4062,5,430,43,473,10.0
4062,6,527,48,575,10.979166666666666
4062,7,619,43,662,14.395348837209303
4062,8,692,726,1418,0.953168044077135
4062,9,1499,1177,2676,1.2735768903993203
4062,10,2684,1196,3880,2.2441471571906355
4062,11,3888,906,4794,4.291390728476821
4062,12,4802,548,5350,8.762773722627736
4063,1,172,752,924,0.22872340425531915
4064,1,12,322,334,0.037267080745341616
4064,2,343,446,789,0.7690582959641256
4064,3,812,520,1332,1.5615384615384615
4065,1,1797,597,2394,3.0100502512562812
4065,2,2441,813,3254,3.002460024600246
4065,3,3452,610,4062,5.659016393442623
4065,4,4095,525,4620,7.8
4065,5,4699,815,5514,5.765644171779141
4065,6,5584,749,6333,7.455273698264352
4065,7,6391,914,7305,6.99234135667396
4066,1,162,692,854,0.23410404624277456
4067,1,31,811,842,0.03822441430332922
4068,1,85,354,439,0.2401129943502825
4068,2,477,332,809,1.4367469879518073
4068,3,836,366,1202,2.2841530054644807
4069,1,796,289,1085,2.754325259515571
4070,1,1362,958,2320,1.4217118997912317
4070,2,2334,472,2806,4.944915254237288
4070,3,2827,691,3518,4.091172214182344
4070,4,3604,761,4365,4.735873850197109
4070,5,4377,756,5133,5.7896825396825395
4070,6,5144,46,5190,111.82608695652173
4070,7,5209,406,5615,12.830049261083744
4071,1,16,634,650,0.025236593059936908
4071,2,667,674,1341,0.9896142433234422
4072,1,20,423,443,0.04728132387706856
4072,2,471,816,1287,0.5772058823529411
4072,3,1292,171,1463,7.555555555555555
4072,4,1487,834,2321,1.7829736211031175
4072,5,2326,576,2902,4.038194444444445
4072,6,2933,804,3737,3.648009950248756
4072,7,3751,816,4567,4.596813725490196
4072,8,4572,152,4724,30.07894736842105
4072,9,4775,702,5477,6.801994301994302
4072,10,5501,748,6249,7.35427807486631
4072,11,6301,818,7119,7.702933985330073
4072,12,7142,853,7995,8.372801875732709
4073,1,169,20,189,8.45
4073,2,203,218,421,0.9311926605504587
4074,1,74,244,318,0.30327868852459017
4074,2,363,71,434,5.112676056338028
4074,3,496,1157,1653,0.428694900605013
4074,4,1680,778,2458,2.159383033419023
4074,5,2510,102,2612,24.607843137254903
4074,6,2689,175,2864,15.365714285714287
4074,7,2941,1158,4099,2.5397236614853194
4074,8,4109,134,4243,30.66417910447761
4074,9,4298,80,4378,53.725
4074,10,4866,399,5265,12.19548872180451
4074,11,5336,155,5491,34.42580645161291
4074,12,5518,288,5806,19.15972222222222
4074,13,5861,847,6708,6.919716646989374
4074,14,6770,313,7083,21.629392971246006
4074,15,7208,238,7446,30.285714285714285
4074,16,7458,302,7760,24.695364238410598
4075,1,33,511,544,0.06457925636007827
4075,2,2621,328,2949,7.990853658536586
4076,1,16,20,36,0.8
4076,2,40,22,62,1.8181818181818181
4076,3,67,38,105,1.763157894736842
4076,4,109,37,146,2.945945945945946
4076,5,152,40,192,3.8
4077,1,82,516,598,0.15891472868217055
4078,1,15,65,80,0.23076923076923078
4078,2,133,87,220,1.528735632183908
4079,1,17,89,106,0.19101123595505617
4079,2,133,284,417,0.46830985915492956
4079,3,440,57,497,7.719298245614035
4079,4,508,386,894,1.3160621761658031
4079,5,921,409,1330,2.251833740831296
4079,6,1343,412,1755,3.2597087378640777
4079,7,1761,446,2207,3.9484304932735426
4079,8,2214,81,2295,27.333333333333332
4079,9,2312,207,2519,11.169082125603865
4079,10,2553,411,2964,6.211678832116788
4080,1,160,918,1078,0.17429193899782136
4080,2,1096,583,1679,1.8799313893653515
4080,3,1738,935,2673,1.8588235294117648
4080,4,2690,415,3105,6.481927710843373
4080,5,3168,591,3759,5.3604060913705585
4080,6,3846,297,4143,12.94949494949495
4080,7,4252,942,5194,4.51380042462845
4080,8,5202,947,6149,5.493136219640972
4080,9,6157,645,6802,9.545736434108527
4080,10,6857,942,7799,7.279193205944798
4081,1,37,650,687,0.05692307692307692
4081,2,726,612,1338,1.1862745098039216
4082,1,30,632,662,0.04746835443037975
4082,2,692,651,1343,1.0629800307219661
4082,3,1375,487,1862,2.8234086242299794
4082,4,1892,642,2534,2.9470404984423677
4082,5,2686,811,3497,3.3119605425400738
4082,6,3542,330,3872,10.733333333333333
4083,1,12,576,588,0.020833333333333332
4084,1,816,795,1611,1.0264150943396226
4085,1,41,144,185,0.2847222222222222
4085,2,201,533,734,0.3771106941838649
4085,3,755,73,828,10.342465753424657
4086,1,685,471,1156,1.454352441613588
4086,2,1198,241,1439,4.970954356846473
4086,3,2202,665,2867,3.311278195488722
4087,1,21,251,272,0.08366533864541832
4087,2,277,358,635,0.7737430167597765
4087,3,640,234,874,2.735042735042735
4087,4,879,256,1135,3.43359375
4087,5,1140,228,1368,5.0
4087,6,1403,133,1536,10.548872180451127
4087,7,1571,361,1932,4.351800554016621
4087,8,1937,348,2285,5.566091954022989
4087,9,2290,206,2496,11.116504854368932
4087,10,2558,368,2926,6.951086956521739
4087,11,2931,377,3308,7.774535809018568
4087,12,3313,287,3600,11.543554006968641
4087,13,3645,302,3947,12.06953642384106
4087,14,3952,245,4197,16.13061224489796
4087,15,4221,544,4765,7.759191176470588
4087,16,4770,482,5252,9.896265560165975
4087,17,5281,296,5577,17.841216216216218
4087,18,5582,84,5666,66.45238095238095
4087,19,5695,346,6041,16.459537572254334
4087,20,6046,184,6230,32.858695652173914
4087,21,6322,319,6641,19.818181818181817
4087,22,6646,6,6652,1107.6666666666667
4087,23,6696,416,7112,16.096153846153847
4087,24,7142,141,7283,50.652482269503544
4087,25,7289,89,7378,81.89887640449439
4088,1,119,653,772,0.18223583460949463
4088,2,820,168,988,4.880952380952381
4088,3,1001,212,1213,4.721698113207547
4088,4,1287,81,1368,15.88888888888889
4088,5,1442,323,1765,4.464396284829721
4088,6,1772,26,1798,68.15384615384616
4088,7,1882,221,2103,8.515837104072398
4088,8,2156,62,2218,34.774193548387096
4088,9,2331,129,2460,18.069767441860463
4088,10,2496,80,2576,31.2
4088,11,2602,51,2653,51.01960784313726
4088,12,2678,78,2756,34.333333333333336
4088,13,2765,73,2838,37.87671232876713
4088,14,2921,110,3031,26.554545454545455
4088,15,3051,76,3127,40.14473684210526
4088,16,3133,14,3147,223.78571428571428
4088,17,3174,40,3214,79.35
4088,18,3238,103,3341,31.436893203883496
4088,19,3367,54,3421,62.351851851851855
4088,20,3432,19,3451,180.6315789473684
4088,21,3693,551,4244,6.702359346642468
4088,22,4272,57,4329,74.94736842105263
4088,23,4359,64,4423,68.109375
4088,24,4440,103,4543,43.10679611650485
4088,25,4564,243,4807,18.781893004115226
4088,26,4821,90,4911,53.56666666666667
4088,27,5051,179,5230,28.217877094972067
4088,28,5257,148,5405,35.520270270270274
4088,29,5430,261,5691,20.804597701149426
4088,30,5700,102,5802,55.88235294117647
4088,31,5830,93,5923,62.68817204301075
4088,32,5930,60,5990,98.83333333333333
4088,33,6007,90,6097,66.74444444444444
4088,34,6118,113,6231,54.14159292035398
4088,35,6300,98,6398,64.28571428571429
4088,36,6416,77,6493,83.32467532467533
4088,37,6516,162,6678,40.22222222222222
4088,38,6704,243,6947,27.588477366255145
4088,39,6960,640,7600,10.875
4089,1,802,748,1550,1.072192513368984
4089,2,1562,919,2481,1.6996735582154516
4089,3,2483,181,2664,13.718232044198896
4090,1,56,547,603,0.10237659963436929
4090,2,676,62,738,10.903225806451612
4090,3,772,101,873,7.643564356435643
4090,4,904,84,988,10.761904761904763
4090,5,1018,86,1104,11.837209302325581
4090,6,1128,82,1210,13.75609756097561
4090,7,1239,67,1306,18.492537313432837
4090,8,1320,65,1385,20.307692307692307
4090,9,1402,225,1627,6.231111111111111
4090,10,1662,107,1769,15.532710280373832
4090,11,1793,108,1901,16.60185185185185
4090,12,1965,144,2109,13.645833333333334
4090,13,2133,109,2242,19.568807339449542
4090,14,2279,122,2401,18.68032786885246
4090,15,2419,152,2571,15.914473684210526
4090,16,2587,134,2721,19.30597014925373
4090,17,2741,70,2811,39.15714285714286
4090,18,2856,106,2962,26.943396226415093
4090,19,3008,113,3121,26.61946902654867
4090,20,3128,43,3171,72.74418604651163
4090,21,3193,91,3284,35.08791208791209
4091,1,85,66,151,1.2878787878787878
4091,2,176,627,803,0.2807017543859649
4091,3,881,409,1290,2.154034229828851
4092,1,25,817,842,0.030599755201958383
4093,1,12,361,373,0.0332409972299169
4094,1,3052,683,3735,4.468521229868228
4094,2,3790,1037,4827,3.6547733847637414
4094,3,4932,978,5910,5.042944785276074
4094,4,5934,225,6159,26.373333333333335
4094,5,6184,566,6750,10.925795053003533
4094,6,6828,528,7356,12.931818181818182
4094,7,7395,294,7689,25.153061224489797
4094,8,7717,366,8083,21.084699453551913
4095,1,51,26,77,1.9615384615384615
4095,2,99,167,266,0.592814371257485
4095,3,346,603,949,0.5737976782752903
4095,4,1080,191,1271,5.654450261780105
4095,5,1458,618,2076,2.3592233009708736
4095,6,2263,542,2805,4.175276752767528
4095,7,3035,775,3810,3.9161290322580644
4095,8,4005,634,4639,6.317034700315458
4095,9,4841,555,5396,8.722522522522523
4095,10,5489,404,5893,13.586633663366337
4095,11,5933,63,5996,94.17460317460318
4095,12,6034,60,6094,100.56666666666666
4095,13,6141,66,6207,93.04545454545455
4095,14,6254,53,6307,118.0
4095,15,6346,64,6410,99.15625
4095,16,6454,319,6773,20.231974921630094
4096,1,19,578,597,0.0328719723183391
4096,2,617,973,1590,0.6341212744090442
4096,3,1605,977,2582,1.6427840327533265
4096,4,2590,840,3430,3.0833333333333335
4096,5,3445,919,4364,3.748639825897715
4096,6,4389,989,5378,4.437815975733064
4096,7,5393,969,6362,5.565531475748194
4096,8,6373,580,6953,10.98793103448276
4096,9,6976,884,7860,7.891402714932127
4097,1,1260,828,2088,1.5217391304347827
4097,2,2209,1051,3260,2.1018078020932447
4097,3,3338,1083,4421,3.0821791320406278
4097,4,5780,823,6603,7.023086269744836
4097,5,6739,962,7701,7.005197505197505
4098,1,1731,349,2080,4.959885386819484
4098,2,2083,421,2504,4.947743467933492
4098,3,2507,390,2897,6.4282051282051285
4098,4,2900,477,3377,6.079664570230608
4098,5,3380,385,3765,8.779220779220779
4098,6,3768,449,4217,8.391982182628063
4098,7,4220,168,4388,25.11904761904762
4098,8,4413,394,4807,11.200507614213198
4098,9,4824,255,5079,18.91764705882353
4098,10,5086,401,5487,12.683291770573566
4098,11,5490,174,5664,31.551724137931036
4099,1,144,1116,1260,0.12903225806451613
4099,2,1351,881,2232,1.5334846765039727
4100,1,122,800,922,0.1525
4100,2,929,95,1024,9.778947368421052
4100,3,1047,372,1419,2.814516129032258
4100,4,1482,533,2015,2.7804878048780486
4100,5,2097,855,2952,2.4526315789473685
4100,6,2959,381,3340,7.766404199475065
4100,7,3413,841,4254,4.058263971462544
4100,8,4261,293,4554,14.542662116040956
4100,9,4639,864,5503,5.369212962962963
4100,10,5510,258,5768,21.356589147286822
4101,1,62,707,769,0.0876944837340877
4101,2,782,640,1422,1.221875
4102,1,20,346,366,0.057803468208092484
4103,1,11,250,261,0.044
4103,2,269,360,629,0.7472222222222222
4103,3,661,313,974,2.1118210862619806
4103,4,1005,431,1436,2.331786542923434
4103,5,1478,157,1635,9.414012738853502
4103,6,1656,242,1898,6.8429752066115705
4103,7,1989,284,2273,7.003521126760563
4103,8,2280,402,2682,5.6716417910447765
4103,9,2782,473,3255,5.881606765327696
4103,10,3290,509,3799,6.4636542239685655
4103,11,3813,222,4035,17.175675675675677
4104,1,98,665,763,0.14736842105263157
4104,2,921,678,1599,1.3584070796460177
4104,3,1669,948,2617,1.760548523206751
4104,4,2620,572,3192,4.580419580419581
4104,5,3394,663,4057,5.119155354449472
4104,6,4087,276,4363,14.807971014492754
4104,7,4442,37,4479,120.05405405405405
4104,8,4500,162,4662,27.77777777777778
4104,9,4683,462,5145,10.136363636363637
4104,10,5206,64,5270,81.34375
4104,11,5279,460,5739,11.476086956521739
4104,12,5742,463,6205,12.40172786177106
4104,13,6208,156,6364,39.794871794871796
4104,14,6404,961,7365,6.663891779396462
4104,15,7398,454,7852,16.295154185022028
4105,1,42,300,342,0.14
4105,2,361,256,617,1.41015625
4105,3,675,289,964,2.3356401384083045
4105,4,1012,292,1304,3.4657534246575343
4105,5,1314,262,1576,5.015267175572519
4105,6,1605,271,1876,5.922509225092251
4105,7,1899,168,2067,11.303571428571429
4105,8,2082,221,2303,9.42081447963801
4106,1,15,208,223,0.07211538461538461
4106,2,237,320,557,0.740625
4106,3,605,400,1005,1.5125
4106,4,1223,502,1725,2.4362549800796813
4106,5,1838,521,2359,3.5278310940499042
4106,6,2413,470,2883,5.134042553191489
4106,7,2897,200,3097,14.485
4106,8,3160,257,3417,12.295719844357977
4106,9,3468,540,4008,6.4222222222222225
4106,10,4144,967,5111,4.285418821096174
4106,11,6094,537,6631,11.348230912476723
4107,1,274,542,816,0.5055350553505535
4107,2,831,502,1333,1.655378486055777
4107,3,1390,459,1849,3.028322440087146
4107,4,1867,382,2249,4.887434554973822
4107,5,2271,431,2702,5.269141531322505
4107,6,2715,418,3133,6.4952153110047846
4107,7,3144,544,3688,5.779411764705882
4107,8,3698,434,4132,8.52073732718894
4108,1,762,276,1038,2.760869565217391
4108,2,1051,216,1267,4.8657407407407405
4109,1,19,572,591,0.033216783216783216
4109,2,602,742,1344,0.8113207547169812
4110,1,2262,394,2656,5.741116751269035
4110,2,2664,428,3092,6.224299065420561
4110,3,3100,446,3546,6.95067264573991
4110,4,3554,475,4029,7.482105263157894
4110,5,4102,498,4600,8.236947791164658
4110,6,4608,475,5083,9.701052631578948
4110,7,5091,424,5515,12.007075471698114
4110,8,5661,1253,6914,4.517956903431764
4110,9,6922,926,7848,7.475161987041036
4111,1,509,437,946,1.1647597254004576
4111,2,957,446,1403,2.1457399103139014
4111,3,1426,206,1632,6.922330097087379
4111,4,1644,169,1813,9.727810650887575
4112,1,2328,788,3116,2.954314720812183
4113,1,832,834,1666,0.9976019184652278
4114,1,34,517,551,0.06576402321083172
4114,2,594,749,1343,0.7930574098798397
4114,3,1361,615,1976,2.2130081300813007
4115,1,47,811,858,0.05795314426633785
4115,2,869,699,1568,1.2432045779685266
4115,3,1605,802,2407,2.0012468827930174
4116,1,9,51,60,0.17647058823529413
4116,2,74,657,731,0.1126331811263318
4116,3,742,873,1615,0.849942726231386
4117,1,292,89,381,3.2808988764044944
4117,2,393,239,632,1.6443514644351465
4117,3,664,227,891,2.9251101321585904
4117,4,908,167,1075,5.437125748502994
4118,1,20,536,556,0.03731343283582089
4118,2,561,842,1403,0.666270783847981
4118,3,1462,651,2113,2.2457757296466974
4119,1,12,87,99,0.13793103448275862
4119,2,124,392,516,0.3163265306122449
4119,3,518,342,860,1.5146198830409356
4119,4,862,373,1235,2.310991957104558
4119,5,1237,209,1446,5.91866028708134
4119,6,1513,361,1874,4.191135734072022
4119,7,1876,383,2259,4.898172323759791
4119,8,2261,337,2598,6.70919881305638
4119,9,2624,366,2990,7.169398907103825
4119,10,2992,397,3389,7.5365239294710324
4119,11,3391,319,3710,10.630094043887148
4119,12,3712,188,3900,19.74468085106383
4119,13,4856,420,5276,11.561904761904762
4119,14,5278,408,5686,12.936274509803921
4119,15,5688,250,5938,22.752
4120,1,86,79,165,1.0886075949367089
4120,2,189,478,667,0.39539748953974896
4120,3,799,122,921,6.549180327868853
4120,4,995,107,1102,9.299065420560748
4120,5,1130,438,1568,2.5799086757990866
4120,6,1589,714,2303,2.2254901960784315
4120,7,2336,503,2839,4.644135188866799
4120,8,2876,60,2936,47.93333333333333
4120,9,2968,74,3042,40.108108108108105
4120,10,3075,55,3130,55.90909090909091
4120,11,3232,782,4014,4.132992327365729
4120,12,4058,905,4963,4.483977900552486
4120,13,4977,70,5047,71.1
4120,14,5085,968,6053,5.253099173553719
4120,15,6076,196,6272,31.0
4120,16,6325,231,6556,27.38095238095238
4120,17,6582,68,6650,96.79411764705883
4120,18,6667,248,6915,26.883064516129032
4120,19,6981,570,7551,12.24736842105263
4121,1,46,823,869,0.05589307411907655
4121,2,886,896,1782,0.9888392857142857
4121,3,1796,666,2462,2.6966966966966965
4122,1,69,451,520,0.15299334811529933
4123,1,29,618,647,0.04692556634304207
4124,1,13,576,589,0.022569444444444444
4124,2,614,713,1327,0.8611500701262272
4125,1,197,44,241,4.4772727272727275
4125,2,499,195,694,2.5589743589743588
4126,1,13,411,424,0.031630170316301706
4127,1,18,876,894,0.02054794520547945
4128,1,27,879,906,0.030716723549488054
4128,2,926,591,1517,1.5668358714043993
4128,3,1526,649,2175,2.3513097072419105
4128,4,2194,744,2938,2.9489247311827955
4128,5,2952,672,3624,4.392857142857143
4128,6,3646,308,3954,11.837662337662337
4128,7,3963,245,4208,16.175510204081633
4128,8,4226,650,4876,6.501538461538462
4128,9,4895,608,5503,8.050986842105264
4128,10,5522,662,6184,8.341389728096678
4129,1,221,425,646,0.52
4129,2,667,3,670,222.33333333333334
4130,1,152,15,167,10.133333333333333
4130,2,192,983,1175,0.1953204476093591
4130,3,1278,982,2260,1.3014256619144602
4130,4,2298,974,3272,2.359342915811088
4131,1,13,322,335,0.040372670807453416
4131,2,341,340,681,1.0029411764705882
4131,3,702,207,909,3.391304347826087
4131,4,929,332,1261,2.7981927710843375
4131,5,1280,287,1567,4.45993031358885
4131,6,1593,273,1866,5.835164835164835
4132,1,169,20,189,8.45
4132,2,203,212,415,0.9575471698113207
4132,3,555,653,1208,0.8499234303215927
4132,4,1261,580,1841,2.174137931034483
4133,1,21,835,856,0.025149700598802394
4134,1,2728,958,3686,2.847599164926931
4135,1,21,370,391,0.05675675675675676
4136,1,22,55,77,0.4
4136,2,100,626,726,0.1597444089456869
4136,3,731,726,1457,1.0068870523415978
4136,4,1472,562,2034,2.619217081850534
4137,1,53,96,149,0.5520833333333334
4137,2,193,130,323,1.4846153846153847
4137,3,361,305,666,1.1836065573770491
4137,4,724,314,1038,2.305732484076433
4137,5,1098,260,1358,4.223076923076923
4137,6,1423,586,2009,2.4283276450511946
4137,7,2060,718,2778,2.86908077994429
4137,8,2796,847,3643,3.3010625737898467
4137,9,3699,869,4568,4.2566168009205985
4137,10,4575,421,4996,10.866983372921615
4137,11,5058,650,5708,7.781538461538462
4138,1,22,458,480,0.048034934497816595
4138,2,492,514,1006,0.9571984435797666
4139,1,48,315,363,0.1523809523809524
4139,2,372,112,484,3.3214285714285716
4140,1,241,694,935,0.3472622478386167
4140,2,954,685,1639,1.3927007299270073
4140,3,1719,638,2357,2.69435736677116
4140,4,2373,340,2713,6.979411764705882
4140,5,2782,557,3339,4.994614003590664
4140,6,3435,520,3955,6.605769230769231
4141,1,20,810,830,0.024691358024691357
4141,2,865,820,1685,1.0548780487804879
4142,1,176,745,921,0.23624161073825503
4142,2,951,578,1529,1.6453287197231834
4142,3,1611,637,2248,2.5290423861852434
4142,4,2354,785,3139,2.9987261146496813
4142,5,3202,492,3694,6.508130081300813
4142,6,3718,381,4099,9.758530183727034
4142,7,4124,955,5079,4.318324607329843
4142,8,5095,237,5332,21.49789029535865
4142,9,5412,812,6224,6.665024630541872
4143,1,75,1095,1170,0.0684931506849315
4143,2,1192,418,1610,2.851674641148325
4143,3,1652,485,2137,3.406185567010309
4143,4,2230,703,2933,3.1721194879089616
4143,5,2953,1046,3999,2.823135755258126
4143,6,4046,1021,5067,3.962781586679726
4143,7,5088,1000,6088,5.088
4143,8,6118,1019,7137,6.003925417075564
4144,1,24,98,122,0.24489795918367346
4144,2,132,68,200,1.9411764705882353
4144,3,230,118,348,1.9491525423728813
4144,4,405,111,516,3.6486486486486487
4144,5,545,294,839,1.8537414965986394
4145,1,10,83,93,0.12048192771084337
4146,1,105,95,200,1.105263157894737
4146,2,736,610,1346,1.2065573770491804
4146,3,1766,330,2096,5.351515151515152
4146,4,2448,416,2864,5.884615384615385
4146,5,3240,247,3487,13.117408906882591
4146,6,3864,207,4071,18.666666666666668
4146,7,4144,468,4612,8.854700854700855
4146,8,4720,670,5390,7.044776119402985
4146,9,5501,107,5608,51.41121495327103
4146,10,6520,181,6701,36.02209944751381
4146,11,6741,93,6834,72.48387096774194
4146,12,7709,185,7894,41.67027027027027
4147,1,19,899,918,0.021134593993325918
4148,1,82,809,891,0.10135970333745364
4148,2,896,706,1602,1.2691218130311614
4148,3,1618,594,2212,2.723905723905724
4148,4,2672,801,3473,3.3358302122347068
4148,5,3478,796,4274,4.369346733668341
4148,6,4279,690,4969,6.201449275362319
4148,7,5005,816,5821,6.133578431372549
4148,8,6054,804,6858,7.529850746268656
4148,9,6906,819,7725,8.432234432234432
4149,1,85,190,275,0.4473684210526316
4149,2,296,352,648,0.8409090909090909
4149,3,678,169,847,4.011834319526627
4149,4,872,14,886,62.285714285714285
4149,5,934,89,1023,10.49438202247191
4149,6,1041,165,1206,6.3090909090909095
4149,7,1289,213,1502,6.051643192488263
4149,8,1527,250,1777,6.108
4149,9,1836,180,2016,10.2
4150,1,89,793,882,0.11223203026481715
4151,1,167,618,785,0.2702265372168285
4152,1,47,50,97,0.94
4152,2,144,67,211,2.1492537313432836
4153,1,21,496,517,0.04233870967741935
4154,1,208,613,821,0.33931484502446985
4154,2,833,432,1265,1.9282407407407407
4154,3,1494,502,1996,2.9760956175298805
4154,4,2158,419,2577,5.15035799522673
4154,5,2719,468,3187,5.80982905982906
4154,6,3402,344,3746,9.88953488372093
4154,7,3972,396,4368,10.030303030303031
4155,1,29,892,921,0.032511210762331835
4155,2,965,914,1879,1.0557986870897156
4155,3,1920,896,2816,2.142857142857143
4155,4,2965,903,3868,3.283499446290144
4155,5,4038,898,4936,4.496659242761693
4155,6,5018,874,5892,5.741418764302059
4156,1,578,883,1461,0.6545866364665912
4156,2,1490,895,2385,1.664804469273743
4156,3,2882,1003,3885,2.8733798604187437
4156,4,3976,42,4018,94.66666666666667
4156,5,5867,40,5907,146.675
4157,1,78,858,936,0.09090909090909091
4157,2,981,574,1555,1.7090592334494774
4157,3,1564,1003,2567,1.5593220338983051
4157,4,3018,1008,4026,2.994047619047619
4157,5,4048,412,4460,9.825242718446601
4157,6,4483,642,5125,6.982866043613707
4157,7,5140,352,5492,14.602272727272727
4157,8,5501,414,5915,13.28743961352657
4157,9,5923,649,6572,9.126348228043144
4157,10,6575,533,7108,12.335834896810507
4158,1,18,856,874,0.02102803738317757
4158,2,879,411,1290,2.1386861313868613
4159,1,46,928,974,0.04956896551724138
4160,1,20,585,605,0.03418803418803419
4160,2,619,381,1000,1.6246719160104988
4160,3,1013,310,1323,3.267741935483871
4160,4,1330,337,1667,3.9465875370919883
4160,5,1724,464,2188,3.7155172413793105
4160,6,2237,499,2736,4.482965931863728
4160,7,2750,93,2843,29.56989247311828
4160,8,2866,525,3391,5.459047619047619
4160,9,3416,435,3851,7.852873563218391
4160,10,3863,290,4153,13.320689655172414
4160,11,4166,507,4673,8.216962524654832
4161,1,174,904,1078,0.19247787610619468
4162,1,15,200,215,0.075
4162,2,247,174,421,1.4195402298850575
4162,3,438,187,625,2.342245989304813
4162,4,644,188,832,3.425531914893617
4162,5,836,150,986,5.573333333333333
4163,1,31,231,262,0.1341991341991342
4164,1,16,380,396,0.042105263157894736
4164,2,410,374,784,1.0962566844919786
4165,1,11,878,889,0.012528473804100227
4165,2,904,849,1753,1.0647820965842167
4165,3,1776,661,2437,2.686838124054463
4165,4,2453,1027,3480,2.388510223953262
4165,5,3488,794,4282,4.392947103274559
4165,6,4294,413,4707,10.397094430992736
4165,7,4714,724,5438,6.511049723756906
4165,8,5454,1040,6494,5.244230769230769
4165,9,6503,845,7348,7.69585798816568
4166,1,1063,145,1208,7.3310344827586205
4167,1,300,479,779,0.6263048016701461
4167,2,781,486,1267,1.6069958847736625
4167,3,1269,478,1747,2.6548117154811717
4167,4,2014,397,2411,5.073047858942066
4167,5,2413,469,2882,5.144989339019189
4167,6,2884,217,3101,13.290322580645162
4168,1,72,56,128,1.2857142857142858
4168,2,131,54,185,2.425925925925926
4168,3,192,68,260,2.823529411764706
4168,4,262,65,327,4.030769230769231
4168,5,329,65,394,5.061538461538461
4169,1,34,515,549,0.06601941747572816
4169,2,833,1568,2401,0.53125
4170,1,19,578,597,0.0328719723183391
4170,2,617,973,1590,0.6341212744090442
4170,3,1605,977,2582,1.6427840327533265
4170,4,2590,840,3430,3.0833333333333335
4170,5,3445,919,4364,3.748639825897715
4170,6,4389,989,5378,4.437815975733064
4170,7,5393,969,6362,5.565531475748194
4170,8,6373,580,6953,10.98793103448276
4170,9,6976,884,7860,7.891402714932127
4171,1,44,625,669,0.0704
4171,2,694,194,888,3.577319587628866
4171,3,896,369,1265,2.4281842818428183
4171,4,1308,154,1462,8.493506493506494
4171,5,1508,161,1669,9.366459627329192
4171,6,1712,183,1895,9.3551912568306
4171,7,1970,478,2448,4.121338912133891
4171,8,2572,277,2849,9.28519855595668
4171,9,2934,286,3220,10.258741258741258
4171,10,3339,261,3600,12.793103448275861
4171,11,3629,606,4235,5.988448844884489
4171,12,4273,648,4921,6.594135802469136
4171,13,4972,214,5186,23.233644859813083
4171,14,5214,635,5849,8.211023622047245
4171,15,5867,432,6299,13.581018518518519
4171,16,6366,644,7010,9.885093167701863
4171,17,7021,568,7589,12.360915492957746
4172,1,384,5,389,76.8
4172,2,1152,992,2144,1.1612903225806452
4172,3,2146,826,2972,2.598062953995157
4172,4,2979,484,3463,6.154958677685951
4172,5,3470,562,4032,6.174377224199288
4172,6,4038,610,4648,6.619672131147541
4172,7,4655,736,5391,6.324728260869565
4173,1,33,537,570,0.061452513966480445
4174,1,13,41,54,0.3170731707317073
4174,2,246,508,754,0.484251968503937
4174,3,764,58,822,13.172413793103448
4174,4,842,498,1340,1.6907630522088353
4174,5,1354,458,1812,2.9563318777292578
4174,6,1837,631,2468,2.911251980982567
4174,7,2527,523,3050,4.831739961759082
4174,8,3063,374,3437,8.189839572192513
4175,1,114,1083,1197,0.10526315789473684
4176,1,17,875,892,0.019428571428571427
4176,2,959,896,1855,1.0703125
4176,3,1888,892,2780,2.116591928251121
4176,4,2791,86,2877,32.45348837209303
4176,5,2909,260,3169,11.188461538461539
4176,6,3177,375,3552,8.472
4176,7,3568,433,4001,8.240184757505773
4177,1,264,652,916,0.4049079754601227
4177,2,962,150,1112,6.413333333333333
4177,3,1155,141,1296,8.191489361702128
4178,1,46,979,1025,0.04698672114402452
4178,2,1036,416,1452,2.4903846153846154
4178,3,1478,603,2081,2.451077943615257
4178,4,2108,624,2732,3.378205128205128
4178,5,2756,585,3341,4.711111111111111
4178,6,3367,590,3957,5.706779661016949
4178,7,3973,467,4440,8.507494646680943
4178,8,4462,537,4999,8.309124767225326
4178,9,5014,300,5314,16.713333333333335
4178,10,5368,717,6085,7.486750348675035
4178,11,6126,922,7048,6.644251626898048
4179,1,195,728,923,0.26785714285714285
4179,2,992,218,1210,4.5504587155963305
4179,3,1313,612,1925,2.145424836601307
4179,4,1981,656,2637,3.019817073170732
4180,1,67,687,754,0.0975254730713246
4180,2,782,956,1738,0.8179916317991632
4180,3,1742,526,2268,3.311787072243346
4180,4,2288,929,3217,2.46286329386437
4180,5,3221,505,3726,6.3782178217821786
4180,6,3742,947,4689,3.9514255543822596
4181,1,759,99,858,7.666666666666667
4181,2,871,165,1036,5.278787878787878
4181,3,1136,310,1446,3.664516129032258
4181,4,1894,287,2181,6.599303135888502
4181,5,2229,832,3061,2.6790865384615383
4181,6,3072,993,4065,3.093655589123867
4181,7,4078,959,5037,4.252346193952033
4181,8,5044,363,5407,13.895316804407713
4181,9,5443,1059,6502,5.13975448536355
4181,10,6604,1060,7664,6.230188679245283
4182,1,111,680,791,0.16323529411764706
4182,2,811,289,1100,2.8062283737024223
4183,1,146,513,659,0.28460038986354774
4183,2,706,611,1317,1.1554828150572831
4183,3,1340,587,1927,2.282793867120954
4183,4,1967,573,2540,3.432809773123909
4183,5,2557,538,3095,4.75278810408922
4184,1,27,672,699,0.04017857142857143
4184,2,775,786,1561,0.9860050890585241
4185,1,401,244,645,1.6434426229508197
4185,2,658,277,935,2.375451263537906
4185,3,944,662,1606,1.4259818731117824
4186,1,1146,501,1647,2.287425149700599
4186,2,1664,773,2437,2.152652005174644
4187,1,79,42,121,1.880952380952381
4187,2,240,256,496,0.9375
4188,1,2051,490,2541,4.185714285714286
4188,2,5174,26,5200,199.0
4189,1,19,332,351,0.0572289156626506
4189,2,409,1017,1426,0.40216322517207476
4189,3,1528,728,2256,2.098901098901099
4190,1,473,433,906,1.092378752886836
4191,1,111,70,181,1.5857142857142856
4191,2,189,84,273,2.25
4192,1,163,954,1117,0.1708595387840671
4192,2,1153,1007,2160,1.1449851042701091
4192,3,2202,997,3199,2.208625877632899
4192,4,3236,1042,4278,3.105566218809981
4192,5,4312,892,5204,4.834080717488789
4192,6,5239,939,6178,5.579339723109691
4192,7,6215,836,7051,7.434210526315789
4192,8,7083,792,7875,8.943181818181818
4193,1,48,384,432,0.125
4193,2,445,594,1039,0.7491582491582491
4193,3,1080,412,1492,2.621359223300971
4193,4,1504,526,2030,2.859315589353612
4193,5,2046,546,2592,3.7472527472527473
4193,6,2598,394,2992,6.593908629441624
4194,1,19,484,503,0.03925619834710744
4194,2,520,453,973,1.1479028697571745
4195,1,44,37,81,1.1891891891891893
4195,2,3084,45,3129,68.53333333333333
4195,3,5649,34,5683,166.14705882352942
4196,1,35,162,197,0.21604938271604937
4197,1,82,106,188,0.7735849056603774
4197,2,387,448,835,0.8638392857142857
4197,3,1073,489,1562,2.1942740286298568
4197,4,1624,267,1891,6.082397003745318
4198,1,791,867,1658,0.9123414071510957
4198,2,1660,532,2192,3.1203007518796992
4199,1,20,984,1004,0.02032520325203252
4199,2,1013,562,1575,1.802491103202847
4200,1,2389,22,2411,108.5909090909091
4200,2,5544,724,6268,7.657458563535911
4200,3,6410,934,7344,6.862955032119914
4200,4,7392,714,8106,10.352941176470589
4201,1,27,764,791,0.03534031413612566
4201,2,881,772,1653,1.1411917098445596
4202,1,42,845,887,0.04970414201183432
4202,2,889,61,950,14.573770491803279
4202,3,1001,793,1794,1.2622950819672132
4203,1,364,1262,1626,0.2884310618066561
4204,1,1156,571,1727,2.0245183887915936
4204,2,1781,799,2580,2.2290362953692116
4204,3,2665,738,3403,3.611111111111111
4204,4,3444,568,4012,6.063380281690141
4205,1,10,785,795,0.012738853503184714
4205,2,812,820,1632,0.9902439024390244
4205,3,1636,496,2132,3.2983870967741935
4205,4,2159,876,3035,2.4646118721461185
4205,5,3039,857,3896,3.546091015169195
4205,6,3900,864,4764,4.513888888888889
4205,7,4768,872,5640,5.467889908256881
4206,1,170,1025,1195,0.16585365853658537
4206,2,1213,490,1703,2.475510204081633
4206,3,1712,610,2322,2.8065573770491805
4206,4,2332,280,2612,8.32857142857143
4206,5,2625,452,3077,5.807522123893805
4206,6,3087,419,3506,7.3675417661097855
4206,7,3564,408,3972,8.735294117647058
4206,8,4001,257,4258,15.568093385214008
4206,9,4310,632,4942,6.819620253164557
4206,10,4967,961,5928,5.168574401664932
4206,11,6009,524,6533,11.467557251908397
4206,12,6688,946,7634,7.069767441860465
4207,1,3084,357,3441,8.638655462184873
4207,2,3444,467,3911,7.374732334047109
4207,3,3914,363,4277,10.782369146005509
4207,4,4280,184,4464,23.26086956521739
4208,1,96,647,743,0.14837712519319937
4208,2,764,866,1630,0.8822170900692841
4208,3,1903,561,2464,3.392156862745098
4208,4,2676,923,3599,2.8992416034669555
4208,5,3667,878,4545,4.176537585421412
4208,6,5155,379,5534,13.601583113456464
4208,7,5541,228,5769,24.30263157894737
4208,8,5789,416,6205,13.915865384615385
4208,9,6219,959,7178,6.484880083420229
4209,1,30,995,1025,0.03015075376884422
4209,2,1027,14,1041,73.35714285714286
4210,1,12,579,591,0.02072538860103627
4210,2,604,420,1024,1.438095238095238
4211,1,44,647,691,0.06800618238021638
4212,1,1857,786,2643,2.3625954198473282
4212,2,2652,444,3096,5.972972972972973
4212,3,3105,153,3258,20.294117647058822
4213,1,33,863,896,0.038238702201622246
4213,2,976,762,1738,1.2808398950131235
4214,1,105,629,734,0.1669316375198728
4214,2,762,458,1220,1.6637554585152838
4214,3,1234,197,1431,6.2639593908629445
4214,4,1564,795,2359,1.9672955974842767
4214,5,2442,947,3389,2.5786694825765575
4214,6,3410,585,3995,5.829059829059829
4214,7,4018,479,4497,8.388308977035491
4214,8,4510,330,4840,13.666666666666666
4215,1,883,287,1170,3.076655052264808
4215,2,1273,515,1788,2.471844660194175
4215,3,1945,434,2379,4.481566820276497
4215,4,2382,363,2745,6.56198347107438
4215,5,2818,316,3134,8.917721518987342
4215,6,3195,345,3540,9.26086956521739
4215,7,3589,410,3999,8.753658536585366
4215,8,4002,341,4343,11.736070381231672
4215,9,4484,431,4915,10.403712296983759
4215,10,4918,161,5079,30.546583850931675
4215,11,5257,386,5643,13.619170984455959
4215,12,5646,287,5933,19.67247386759582
4215,13,6344,419,6763,15.140811455847256
4215,14,6766,355,7121,19.059154929577463
4215,15,7124,349,7473,20.412607449856733
4215,16,7678,386,8064,19.89119170984456
4216,1,70,78,148,0.8974358974358975
4216,2,894,916,1810,0.9759825327510917
4217,1,18,1152,1170,0.015625
4218,1,1979,881,2860,2.246311010215664
4219,1,225,273,498,0.8241758241758241
4219,2,863,355,1218,2.4309859154929576
4219,3,1281,367,1648,3.4904632152588557
4219,4,1687,562,2249,3.001779359430605
4219,5,2278,104,2382,21.903846153846153
4219,6,2712,335,3047,8.0955223880597
4219,7,3509,411,3920,8.53771289537713
4219,8,4116,167,4283,24.646706586826348
4219,9,4815,457,5272,10.536105032822757
4219,10,5356,961,6317,5.573361082206035
4220,1,95,442,537,0.2149321266968326
4220,2,561,159,720,3.5283018867924527
4221,1,62,820,882,0.07560975609756097
4222,1,17,145,162,0.11724137931034483
4222,2,174,429,603,0.40559440559440557
4222,3,623,383,1006,1.6266318537859008
4222,4,1016,83,1099,12.240963855421686
4222,5,1125,447,1572,2.5167785234899327
4222,6,1586,756,2342,2.0978835978835977
4222,7,2383,311,2694,7.662379421221865
4222,8,2792,86,2878,32.46511627906977
4222,9,2978,137,3115,21.73722627737226
4222,10,3132,584,3716,5.363013698630137
4222,11,3826,532,4358,7.19172932330827
4222,12,4369,125,4494,34.952
4222,13,4513,782,5295,5.771099744245524
4222,14,5314,307,5621,17.309446254071663
4222,15,5636,395,6031,14.268354430379746
4222,16,6042,458,6500,13.192139737991265
4222,17,6518,378,6896,17.243386243386244
4222,18,6909,108,7017,63.97222222222222
4222,19,7033,488,7521,14.41188524590164
4223,1,24,636,660,0.03773584905660377
4223,2,691,687,1378,1.0058224163027656
4223,3,1408,582,1990,2.4192439862542954
4223,4,2006,240,2246,8.358333333333333
4223,5,2272,532,2804,4.2706766917293235
4223,6,2826,740,3566,3.8189189189189188
4223,7,3574,390,3964,9.164102564102564
4223,8,3987,274,4261,14.55109489051095
4223,9,5059,305,5364,16.58688524590164
4223,10,5383,137,5520,39.29197080291971
4223,11,6170,85,6255,72.58823529411765
4223,12,6272,130,6402,48.246153846153845
4223,13,6453,225,6678,28.68
4223,14,6698,229,6927,29.24890829694323
4223,15,6963,183,7146,38.049180327868854
4223,16,7174,170,7344,42.2
4223,17,7360,179,7539,41.11731843575419
4223,18,7557,467,8024,16.182012847965737
4224,1,1571,648,2219,2.424382716049383
4224,2,4264,686,4950,6.215743440233236
4224,3,6325,505,6830,12.524752475247524
4225,1,28,566,594,0.04946996466431095
4225,2,607,1019,1626,0.5956820412168793
4226,1,11,163,174,0.06748466257668712
4226,2,185,128,313,1.4453125
4226,3,341,994,1335,0.34305835010060365
4226,4,1356,224,1580,6.053571428571429
4226,5,1586,156,1742,10.166666666666666
4226,6,1752,724,2476,2.4198895027624308
4226,7,2478,858,3336,2.888111888111888
4226,8,3366,3,3369,1122.0
4227,1,215,82,297,2.6219512195121952
4227,2,305,358,663,0.8519553072625698
4227,3,700,190,890,3.6842105263157894
4228,1,1827,268,2095,6.817164179104478
4228,2,3816,236,4052,16.16949152542373
4228,3,5841,288,6129,20.28125
4229,1,30,759,789,0.039525691699604744
4229,2,798,788,1586,1.0126903553299493
4229,3,1599,682,2281,2.344574780058651
4230,1,43,4,47,10.75
4230,2,64,412,476,0.1553398058252427
4230,3,508,358,866,1.4189944134078212
4231,1,721,447,1168,1.6129753914988814
4231,2,1519,523,2042,2.904397705544933
4231,3,2111,7,2118,301.57142857142856
4231,4,2841,464,3305,6.122844827586207
4231,5,3656,542,4198,6.745387453874539
4231,6,4267,7,4274,609.5714285714286
4231,7,4896,449,5345,10.90423162583519
4231,8,5647,488,6135,11.57172131147541
4231,9,6204,7,6211,886.2857142857143
4231,10,6834,393,7227,17.389312977099237
4231,11,7529,434,7963,17.347926267281107
4231,12,8032,7,8039,1147.4285714285713
4232,1,77,963,1040,0.07995846313603323
4233,1,12,333,345,0.036036036036036036
4233,2,354,341,695,1.0381231671554252
4233,3,742,360,1102,2.061111111111111
4233,4,1105,364,1469,3.0357142857142856
4233,5,1472,278,1750,5.294964028776978
4233,6,1767,345,2112,5.121739130434783
4233,7,2115,325,2440,6.507692307692308
4233,8,2443,231,2674,10.575757575757576
4233,9,2710,325,3035,8.338461538461539
4233,10,3041,359,3400,8.470752089136491
4233,11,3403,355,3758,9.585915492957746
4233,12,3761,52,3813,72.32692307692308
4233,13,3832,190,4022,20.16842105263158
4233,14,4025,424,4449,9.492924528301886
4233,15,4452,735,5187,6.057142857142857
4233,16,5225,170,5395,30.735294117647058
4233,17,5398,361,5759,14.952908587257618
4233,18,5762,608,6370,9.476973684210526
4233,19,6373,119,6492,53.554621848739494
4233,20,6495,346,6841,18.771676300578033
4233,21,6843,369,7212,18.54471544715447
4233,22,7214,350,7564,20.611428571428572
4233,23,7566,120,7686,63.05
4234,1,186,186,372,1.0
4234,2,394,72,466,5.472222222222222
4234,3,480,48,528,10.0
4234,4,551,386,937,1.427461139896373
4234,5,992,354,1346,2.8022598870056497
4234,6,1398,385,1783,3.6311688311688313
4234,7,1817,425,2242,4.275294117647059
4235,1,15,575,590,0.02608695652173913
4235,2,615,503,1118,1.2226640159045725
4236,1,32,636,668,0.050314465408805034
4236,2,683,509,1192,1.3418467583497053
4236,3,1280,379,1659,3.3773087071240107
4236,4,1707,369,2076,4.626016260162602
4236,5,2121,532,2653,3.986842105263158
4236,6,2674,747,3421,3.5796519410977243
4237,1,2305,268,2573,8.600746268656716
4237,2,2585,243,2828,10.637860082304528
4237,3,2837,861,3698,3.295005807200929
4237,4,3809,346,4155,11.008670520231213
4237,5,4170,386,4556,10.803108808290155
4237,6,4574,372,4946,12.295698924731182
4237,7,4961,780,5741,6.36025641025641
4238,1,13,622,635,0.02090032154340836
4239,1,25,683,708,0.036603221083455345
4239,2,782,842,1624,0.9287410926365796
4239,3,1633,302,1935,5.4072847682119205
4239,4,2021,844,2865,2.3945497630331753
4239,5,2872,338,3210,8.497041420118343
4239,6,3247,845,4092,3.842603550295858
4239,7,4123,616,4739,6.693181818181818
4239,8,4780,882,5662,5.419501133786848
4239,9,5669,598,6267,9.479933110367893
4239,10,6392,867,7259,7.372549019607843
4239,11,7285,650,7935,11.207692307692307
4240,1,40,749,789,0.0534045393858478
4240,2,821,686,1507,1.1967930029154519
4240,3,1532,832,2364,1.8413461538461537
4240,4,2381,973,3354,2.447070914696814
4240,5,3458,953,4411,3.628541448058762
4240,6,4422,72,4494,61.416666666666664
4241,1,7,133,140,0.05263157894736842
4241,2,148,178,326,0.8314606741573034
4241,3,337,373,710,0.903485254691689
4241,4,726,393,1119,1.8473282442748091
4242,1,545,866,1411,0.6293302540415704
4242,2,1421,444,1865,3.2004504504504503
4242,3,1888,918,2806,2.056644880174292
4242,4,2816,296,3112,9.513513513513514
4243,1,11,37,48,0.2972972972972973
4243,2,1852,46,1898,40.26086956521739
4243,3,1918,88,2006,21.795454545454547
4243,4,2021,512,2533,3.947265625
4243,5,2549,536,3085,4.755597014925373
4243,6,3108,551,3659,5.64065335753176
4244,1,81,173,254,0.4682080924855491
4244,2,275,178,453,1.5449438202247192
4244,3,500,46,546,10.869565217391305
4244,4,599,188,787,3.1861702127659575
4245,1,509,600,1109,0.8483333333333334
4246,1,2539,351,2890,7.233618233618234
4246,2,2918,478,3396,6.104602510460251
4246,3,3491,808,4299,4.320544554455446
4246,4,4441,543,4984,8.178637200736649
4246,5,5015,564,5579,8.891843971631205
4246,6,5613,564,6177,9.952127659574469
4247,1,1009,340,1349,2.9676470588235295
4248,1,101,909,1010,0.1111111111111111
4248,2,1015,914,1929,1.1105032822757113
4248,3,1934,938,2872,2.0618336886993602
4248,4,2879,396,3275,7.27020202020202
4248,5,3285,428,3713,7.675233644859813
4248,6,3743,441,4184,8.487528344671201
4248,7,4194,723,4917,5.800829875518672
4248,8,4936,659,5595,7.490136570561456
4248,9,5606,605,6211,9.26611570247934
4248,10,6226,616,6842,10.107142857142858
4248,11,6847,648,7495,10.566358024691358
4249,1,140,906,1046,0.1545253863134658
4249,2,1057,711,1768,1.4866385372714486
4249,3,1921,941,2862,2.0414452709883104
4249,4,2873,560,3433,5.130357142857143
4249,5,3573,949,4522,3.7650158061116965
4249,6,4668,900,5568,5.1866666666666665
4250,1,17,757,774,0.022457067371202115
4251,1,231,98,329,2.357142857142857
4251,2,496,903,1399,0.5492801771871539
4251,3,1618,940,2558,1.721276595744681
4252,1,25,460,485,0.05434782608695652
4252,2,514,125,639,4.112
4253,1,168,278,446,0.60431654676259
4253,2,853,323,1176,2.6408668730650153
4254,1,16,673,689,0.0237741456166419
4254,2,916,635,1551,1.44251968503937
4254,3,1598,560,2158,2.8535714285714286
4254,4,2194,546,2740,4.018315018315018
4254,5,2861,1277,4138,2.240407204385278
4255,1,225,1030,1255,0.21844660194174756
4256,1,9,255,264,0.03529411764705882
4256,2,281,764,1045,0.36780104712041883
4256,3,1053,527,1580,1.9981024667931688
4256,4,1639,959,2598,1.7090719499478624
4256,5,2612,607,3219,4.303130148270181
4256,6,3235,732,3967,4.419398907103825
4256,7,4008,623,4631,6.43338683788122
4257,1,162,290,452,0.5586206896551724
4257,2,459,387,846,1.186046511627907
4257,3,957,876,1833,1.0924657534246576
4257,4,1854,875,2729,2.1188571428571428
4257,5,2749,874,3623,3.145308924485126
4258,1,1072,885,1957,1.2112994350282487
4258,2,1965,860,2825,2.2848837209302326
4259,1,44,21,65,2.0952380952380953
4260,1,202,804,1006,0.2512437810945274
4260,2,1063,628,1691,1.6926751592356688
4261,1,50,632,682,0.07911392405063292
4261,2,702,232,934,3.0258620689655173
4261,3,949,341,1290,2.7829912023460412
4262,1,37,684,721,0.054093567251461985
4263,1,36,667,703,0.053973013493253376
4263,2,729,411,1140,1.7737226277372262
4263,3,1168,382,1550,3.0575916230366493
4264,1,271,754,1025,0.3594164456233422
4264,2,1094,30,1124,36.46666666666667
4264,3,1203,605,1808,1.9884297520661156
4264,4,1811,658,2469,2.7522796352583585
4264,5,2501,765,3266,3.269281045751634
4264,6,3269,771,4040,4.239948119325551
4264,7,4145,667,4812,6.214392803598201
4264,8,4927,603,5530,8.170812603648425
4264,9,5572,721,6293,7.728155339805825
4264,10,6310,209,6519,30.19138755980861
4264,11,6529,197,6726,33.142131979695435
4264,12,6787,607,7394,11.181219110378912
4264,13,7398,59,7457,125.38983050847457
4265,1,262,112,374,2.3392857142857144
4265,2,941,130,1071,7.2384615384615385
4265,3,1077,295,1372,3.6508474576271186
4265,4,1378,739,2117,1.86468200270636
4265,5,2123,860,2983,2.468604651162791
4265,6,2989,648,3637,4.612654320987654
4265,7,3643,927,4570,3.929881337648328
4265,8,4576,706,5282,6.481586402266289
4265,9,5288,992,6280,5.330645161290323
4265,10,6286,787,7073,7.9872935196950445
4265,11,7079,1004,8083,7.050796812749004
4266,1,13,654,667,0.019877675840978593
4266,2,2602,653,3255,3.98468606431853
4266,3,3265,485,3750,6.731958762886598
4266,4,3766,671,4437,5.612518628912071
4267,1,86,81,167,1.0617283950617284
4267,2,194,756,950,0.2566137566137566
4267,3,972,758,1730,1.2823218997361479
4268,1,4,767,771,0.005215123859191656
4269,1,108,705,813,0.15319148936170213
4270,1,41,1533,1574,0.02674494455316373
4271,1,38,263,301,0.1444866920152091
4271,2,356,184,540,1.934782608695652
4271,3,557,75,632,7.426666666666667
4271,4,3970,207,4177,19.17874396135266
4271,5,4385,871,5256,5.034443168771527
4271,6,5298,875,6173,6.054857142857143
4271,7,6175,656,6831,9.413109756097562
4271,8,6838,758,7596,9.021108179419524
4272,1,349,693,1042,0.5036075036075036
4273,1,19,667,686,0.02848575712143928
4273,2,870,568,1438,1.5316901408450705
4273,3,1465,431,1896,3.3990719257540603
4273,4,1915,903,2818,2.1207087486157254
4273,5,2852,774,3626,3.6847545219638245
4273,6,3639,645,4284,5.641860465116279
4273,7,4297,414,4711,10.379227053140097
4273,8,4728,474,5202,9.974683544303797
4273,9,5237,1024,6261,5.1142578125
4274,1,61,38,99,1.605263157894737
4274,2,433,93,526,4.655913978494624
4274,3,570,206,776,2.766990291262136
4274,4,1111,357,1468,3.112044817927171
4275,1,135,612,747,0.22058823529411764
4275,2,780,481,1261,1.6216216216216217
4275,3,1288,438,1726,2.9406392694063928
4275,4,1750,571,2321,3.0647985989492117
4275,5,2339,609,2948,3.8407224958949095
4276,1,319,58,377,5.5
4276,2,382,54,436,7.074074074074074
4276,3,442,68,510,6.5
4276,4,528,94,622,5.617021276595745
4276,5,637,72,709,8.847222222222221
4276,6,713,73,786,9.767123287671232
4276,7,791,71,862,11.140845070422536
4276,8,876,82,958,10.682926829268293
4276,9,973,104,1077,9.35576923076923
4276,10,1087,97,1184,11.206185567010309
4276,11,1199,117,1316,10.247863247863247
4276,12,1340,110,1450,12.181818181818182
4276,13,1457,95,1552,15.336842105263157
4277,1,941,524,1465,1.7958015267175573
4277,2,2363,324,2687,7.29320987654321
4277,3,3648,340,3988,10.729411764705882
4277,4,4001,791,4792,5.058154235145386
4278,1,26,461,487,0.05639913232104121
4278,2,505,386,891,1.3082901554404145
4279,1,116,371,487,0.31266846361185985
4279,2,517,545,1062,0.9486238532110092
4279,3,1108,419,1527,2.6443914081145583
4279,4,1610,915,2525,1.7595628415300546
4279,5,2601,947,3548,2.746568109820486
4280,1,174,348,522,0.5
4280,2,546,53,599,10.30188679245283
4280,3,640,422,1062,1.5165876777251184
4280,4,1141,486,1627,2.347736625514403
4281,1,8,541,549,0.014787430683918669
4281,2,559,248,807,2.254032258064516
4281,3,874,553,1427,1.5804701627486437
4282,1,24,636,660,0.03773584905660377
4282,2,691,687,1378,1.0058224163027656
4282,3,1408,582,1990,2.4192439862542954
4282,4,2006,240,2246,8.358333333333333
4282,5,2272,532,2804,4.2706766917293235
4282,6,2826,740,3566,3.8189189189189188
4282,7,3574,390,3964,9.164102564102564
4282,8,3987,274,4261,14.55109489051095
4282,9,5059,305,5364,16.58688524590164
4283,1,17,140,157,0.12142857142857143
4283,2,172,367,539,0.46866485013623976
4283,3,543,143,686,3.797202797202797
4283,4,702,294,996,2.3877551020408165
4283,5,1001,370,1371,2.7054054054054055
4283,6,1384,277,1661,4.996389891696751
4283,7,1665,338,2003,4.92603550295858
4284,1,33,352,385,0.09375
4284,2,397,393,790,1.0101781170483461
4284,3,820,424,1244,1.9339622641509433
4284,4,1267,713,1980,1.7769985974754559
4284,5,1990,477,2467,4.171907756813417
4284,6,2483,349,2832,7.114613180515759
4284,7,2850,266,3116,10.714285714285714
4284,8,3131,954,4085,3.2819706498951784
4284,9,4105,503,4608,8.1610337972167
4284,10,4625,701,5326,6.59771754636234
4284,11,5344,663,6007,8.060331825037707
4284,12,6028,596,6624,10.114093959731544
4284,13,6633,394,7027,16.83502538071066
4284,14,7053,661,7714,10.670196671709531
4285,1,30,745,775,0.040268456375838924
4285,2,847,24,871,35.291666666666664
4285,3,943,4,947,235.75
4285,4,1019,467,1486,2.182012847965739
4285,5,1488,432,1920,3.4444444444444446
4285,6,1923,284,2207,6.77112676056338
4286,1,39,502,541,0.07768924302788845
4287,1,2531,550,3081,4.601818181818182
4287,2,3145,491,3636,6.405295315682281
4287,3,3658,216,3874,16.935185185185187
4287,4,3967,706,4673,5.618980169971671
4288,1,178,135,313,1.3185185185185184
4288,2,333,52,385,6.403846153846154
4288,3,406,33,439,12.303030303030303
4288,4,454,36,490,12.61111111111111
4288,5,526,72,598,7.305555555555555
4288,6,618,48,666,12.875
4288,7,685,55,740,12.454545454545455
4288,8,749,65,814,11.523076923076923
4288,9,833,88,921,9.465909090909092
4288,10,1174,139,1313,8.446043165467627
4288,11,1330,40,1370,33.25
4288,12,1387,52,1439,26.673076923076923
4288,13,1454,62,1516,23.451612903225808
4288,14,1528,53,1581,28.830188679245282
4288,15,1593,53,1646,30.056603773584907
4288,16,1664,83,1747,20.048192771084338
4288,17,1792,58,1850,30.896551724137932
4288,18,1895,89,1984,21.292134831460675
4289,1,16,172,188,0.09302325581395349
4289,2,195,250,445,0.78
4289,3,463,267,730,1.7340823970037453
4289,4,734,277,1011,2.6498194945848375
4289,5,1015,197,1212,5.152284263959391
4289,6,1216,197,1413,6.1725888324873095
4289,7,1417,186,1603,7.618279569892473
4289,8,1607,203,1810,7.916256157635468
4290,1,103,440,543,0.2340909090909091
4290,2,551,433,984,1.2725173210161662
4290,3,992,393,1385,2.524173027989822
4291,1,451,83,534,5.433734939759036
4291,2,550,276,826,1.9927536231884058
4291,3,844,278,1122,3.035971223021583
4292,1,60,367,427,0.16348773841961853
4293,1,73,198,271,0.3686868686868687
4293,2,643,787,1430,0.8170266836086404
4293,3,1467,89,1556,16.48314606741573
4294,1,15,544,559,0.027573529411764705
4294,2,568,398,966,1.4271356783919598
4295,1,18,758,776,0.023746701846965697
4296,1,135,573,708,0.2356020942408377
4297,1,76,4,80,19.0
4298,1,111,680,791,0.16323529411764706
4299,1,84,332,416,0.25301204819277107
4299,2,420,378,798,1.1111111111111112
4299,3,814,329,1143,2.474164133738602
4299,4,1164,296,1460,3.9324324324324325
4299,5,1464,334,1798,4.383233532934132
4299,6,1819,297,2116,6.124579124579125
4299,7,2183,310,2493,7.041935483870968
4299,8,2526,174,2700,14.517241379310345
4300,1,190,8,198,23.75
4300,2,219,122,341,1.7950819672131149
4300,3,362,134,496,2.701492537313433
4300,4,612,198,810,3.090909090909091
4300,5,924,245,1169,3.7714285714285714
4300,6,1250,293,1543,4.266211604095563
4300,7,1563,748,2311,2.089572192513369
4301,1,209,294,503,0.7108843537414966
4302,1,3,24,27,0.125
4302,2,41,231,272,0.1774891774891775
4302,3,284,301,585,0.9435215946843853
4302,4,604,365,969,1.6547945205479453
4302,5,982,411,1393,2.389294403892944
4302,6,1416,472,1888,3.0
4302,7,1927,415,2342,4.643373493975903
4302,8,2355,290,2645,8.120689655172415
4302,9,2659,457,3116,5.818380743982495
4302,10,3135,291,3426,10.77319587628866
4302,11,3449,420,3869,8.211904761904762
4302,12,3891,538,4429,7.232342007434944
4302,13,4447,439,4886,10.12984054669704
4302,14,4898,296,5194,16.5472972972973
4302,15,5209,471,5680,11.059447983014863
4302,16,5694,347,6041,16.40922190201729
4303,1,48,141,189,0.3404255319148936
4304,1,35,682,717,0.051319648093841645
4305,1,65,554,619,0.11732851985559567
4305,2,634,401,1035,1.5810473815461346
4305,3,1051,371,1422,2.8328840970350404
4305,4,1438,257,1695,5.595330739299611
4306,1,33,535,568,0.0616822429906542
4306,2,848,367,1215,2.310626702997275
4306,3,1237,224,1461,5.522321428571429
4306,4,1480,29,1509,51.03448275862069
4306,5,1534,6,1540,255.66666666666666
4306,6,1807,6,1813,301.1666666666667
4306,7,2254,75,2329,30.053333333333335
4306,8,2353,702,3055,3.3518518518518516
4306,9,3068,995,4063,3.083417085427136
4306,10,4077,896,4973,4.550223214285714
4306,11,4982,1018,6000,4.893909626719057
4306,12,6008,729,6737,8.241426611796982
4306,13,6745,782,7527,8.62531969309463
4307,1,23,390,413,0.05897435897435897
4308,1,153,948,1101,0.16139240506329114
4308,2,1110,188,1298,5.904255319148936
4308,3,1314,486,1800,2.7037037037037037
4308,4,1826,395,2221,4.622784810126582
4309,1,55,744,799,0.0739247311827957
4309,2,812,574,1386,1.4146341463414633
4310,1,14,1036,1050,0.013513513513513514
4310,2,1072,1048,2120,1.0229007633587786
4310,3,2141,706,2847,3.0325779036827196
4310,4,2870,860,3730,3.3372093023255816
4310,5,3744,855,4599,4.378947368421053
4310,6,4611,880,5491,5.239772727272728
4310,7,5503,957,6460,5.750261233019854
4310,8,6486,983,7469,6.598168870803662
4311,1,188,290,478,0.6482758620689655
4311,2,508,200,708,2.54
4311,3,732,331,1063,2.211480362537764
4311,4,1084,317,1401,3.419558359621451
4311,5,1422,316,1738,4.5
4312,1,175,6,181,29.166666666666668
4312,2,695,943,1638,0.7370095440084835
4312,3,1674,1136,2810,1.4735915492957747
4312,4,2822,883,3705,3.1959229898074746
4312,5,3754,1153,4907,3.2558542931483085
4312,6,4919,525,5444,9.369523809523809
4313,1,431,270,701,1.5962962962962963
4313,2,753,412,1165,1.8276699029126213
4313,3,1219,391,1610,3.1176470588235294
4313,4,1617,430,2047,3.76046511627907
4313,5,2054,382,2436,5.37696335078534
4313,6,2443,231,2674,10.575757575757576
4314,1,24,881,905,0.02724177071509648
4315,1,1145,188,1333,6.090425531914893
4316,1,186,713,899,0.2608695652173913
4316,2,1092,3,1095,364.0
4317,1,1145,1084,2229,1.0562730627306274
4318,1,33,898,931,0.036748329621380846
4319,1,268,857,1125,0.31271878646441076
4320,1,23,512,535,0.044921875
4321,1,48,126,174,0.38095238095238093
4321,2,224,737,961,0.3039348710990502
4322,1,14,905,919,0.015469613259668509
4322,2,928,912,1840,1.0175438596491229
4322,3,1914,1077,2991,1.777158774373259
4322,4,3000,748,3748,4.010695187165775
4322,5,3837,17,3854,225.7058823529412
4322,6,3884,974,4858,3.9876796714579057
4322,7,4910,1139,6049,4.310798946444249
4322,8,6058,506,6564,11.972332015810277
4322,9,6572,824,7396,7.975728155339806
4323,1,471,489,960,0.9631901840490797
4324,1,23,1008,1031,0.022817460317460316
4324,2,1033,521,1554,1.982725527831094
4324,3,1703,699,2402,2.436337625178827
4324,4,2422,638,3060,3.7962382445141065
4325,1,804,65,869,12.36923076923077
4325,2,912,133,1045,6.857142857142857
4325,3,1087,81,1168,13.419753086419753
4326,1,7,18,25,0.3888888888888889
4326,2,165,331,496,0.4984894259818731
4326,3,689,350,1039,1.9685714285714286
4326,4,1305,407,1712,3.2063882063882065
4326,5,1755,445,2200,3.943820224719101
4326,6,2248,322,2570,6.9813664596273295
4326,7,2615,178,2793,14.691011235955056
4326,8,3224,77,3301,41.87012987012987
4327,1,80,607,687,0.13179571663920922
4328,1,303,336,639,0.9017857142857143
4328,2,921,303,1224,3.0396039603960396
4328,3,1990,308,2298,6.461038961038961
4328,4,3232,434,3666,7.447004608294931
4328,5,3770,369,4139,10.21680216802168
4329,1,363,153,516,2.372549019607843
4329,2,645,413,1058,1.5617433414043584
4330,1,52,185,237,0.2810810810810811
4330,2,343,542,885,0.6328413284132841
4330,3,1003,555,1558,1.8072072072072072
4330,4,1706,659,2365,2.588770864946889
4330,5,2483,708,3191,3.5070621468926553
4330,6,3450,827,4277,4.171704957678355
4330,7,4387,676,5063,6.489644970414201
4330,8,5128,613,5741,8.36541598694943
4330,9,5811,725,6536,8.015172413793103
4330,10,6617,592,7209,11.177364864864865
4330,11,7289,668,7957,10.911676646706587
4331,1,26,117,143,0.2222222222222222
4332,1,77,24,101,3.2083333333333335
4332,2,744,628,1372,1.1847133757961783
4332,3,1387,480,1867,2.8895833333333334
4332,4,1915,865,2780,2.213872832369942
4333,1,2056,292,2348,7.041095890410959
4333,2,2356,361,2717,6.526315789473684
4333,3,2720,171,2891,15.90643274853801
4333,4,3034,368,3402,8.244565217391305
4333,5,3405,373,3778,9.128686327077748
4333,6,3781,358,4139,10.561452513966481
4333,7,4142,360,4502,11.505555555555556
4333,8,4505,297,4802,15.168350168350168
4334,1,400,657,1057,0.60882800608828
4334,2,1131,1007,2138,1.1231380337636545
4334,3,2150,762,2912,2.8215223097112863
4335,1,19,20,39,0.95
4335,2,63,676,739,0.09319526627218935
4335,3,758,751,1509,1.0093209054593875
4335,4,1517,857,2374,1.7701283547257876
4335,5,2420,1019,3439,2.3748773307163886
4335,6,3461,14,3475,247.21428571428572
4336,1,433,269,702,1.6096654275092936
4336,2,705,493,1198,1.4300202839756593
4337,1,10,829,839,0.012062726176115802
4337,2,876,676,1552,1.2958579881656804
4337,3,1560,980,2540,1.5918367346938775
4337,4,2632,343,2975,7.673469387755102
4337,5,3011,541,3552,5.565619223659889
4337,6,3569,982,4551,3.634419551934827
4337,7,4560,614,5174,7.4267100977198695
4337,8,5205,959,6164,5.427528675703858
4337,9,6189,831,7020,7.447653429602888
4337,10,7040,809,7849,8.702101359703338
4338,1,177,47,224,3.765957446808511
4338,2,240,123,363,1.951219512195122
4338,3,367,91,458,4.032967032967033
4338,4,489,157,646,3.1146496815286624
4338,5,669,122,791,5.483606557377049
4338,6,802,160,962,5.0125
4338,7,994,151,1145,6.582781456953643
4338,8,1182,306,1488,3.8627450980392157
4338,9,1673,202,1875,8.282178217821782
4338,10,1879,212,2091,8.86320754716981
4338,11,2105,121,2226,17.39669421487603
4338,12,2231,223,2454,10.004484304932735
4338,13,2469,112,2581,22.044642857142858
4339,1,707,46,753,15.369565217391305
4339,2,1195,493,1688,2.4239350912778903
4339,3,2168,538,2706,4.029739776951673
4339,4,3148,511,3659,6.160469667318982
4340,1,79,627,706,0.12599681020733652
4340,2,806,790,1596,1.0202531645569621
4340,3,1655,791,2446,2.092288242730721
4340,4,2603,825,3428,3.1551515151515153
4340,5,3430,825,4255,4.157575757575757
4340,6,4299,833,5132,5.160864345738295
4340,7,5142,234,5376,21.974358974358974
4340,8,5540,398,5938,13.919597989949748
4340,9,5952,612,6564,9.72549019607843
4340,10,6625,410,7035,16.158536585365855
4340,11,7042,856,7898,8.226635514018692
4340,12,7903,22,7925,359.22727272727275
4341,1,38,758,796,0.05013192612137203
4342,1,111,680,791,0.16323529411764706
4342,2,811,289,1100,2.8062283737024223
4343,1,141,535,676,0.2635514018691589
4343,2,746,1028,1774,0.72568093385214
4343,3,1825,1163,2988,1.5692175408426483
4343,4,3055,1087,4142,2.81048758049678
4343,5,4189,1223,5412,3.4251839738348324
4343,6,5484,1183,6667,4.635672020287405
4343,7,6687,766,7453,8.72976501305483
4344,1,79,951,1030,0.08307045215562565
4345,1,8029,120,8149,66.90833333333333
4346,1,18,41,59,0.43902439024390244
4346,2,62,46,108,1.3478260869565217
4346,3,111,50,161,2.22
4346,4,165,54,219,3.0555555555555554
4346,5,223,64,287,3.484375
4346,6,296,119,415,2.4873949579831933
4346,7,419,72,491,5.819444444444445
4346,8,494,79,573,6.253164556962025
4346,9,577,87,664,6.632183908045977
4346,10,668,96,764,6.958333333333333
4346,11,768,106,874,7.245283018867925
4346,12,877,114,991,7.692982456140351
4346,13,994,122,1116,8.147540983606557
4346,14,1157,48,1205,24.104166666666668
4346,15,1208,22,1230,54.90909090909091
4346,16,1234,24,1258,51.416666666666664
4346,17,1275,96,1371,13.28125
4346,18,1374,23,1397,59.73913043478261
4346,19,1400,25,1425,56.0
4346,20,1432,29,1461,49.37931034482759
4346,21,1465,24,1489,61.041666666666664
4346,22,1493,28,1521,53.32142857142857
4346,23,1525,24,1549,63.541666666666664
4346,24,1553,22,1575,70.5909090909091
4347,1,57,315,372,0.18095238095238095
4347,2,378,797,1175,0.4742785445420326
4347,3,1196,797,1993,1.5006273525721456
4348,1,86,493,579,0.1744421906693712
4348,2,619,481,1100,1.2869022869022868
4349,1,852,522,1374,1.632183908045977
4350,1,55,744,799,0.0739247311827957
4350,2,812,574,1386,1.4146341463414633
4351,1,34,570,604,0.05964912280701754
4351,2,631,521,1152,1.2111324376199617
4351,3,1263,584,1847,2.162671232876712
4351,4,1859,599,2458,3.1035058430717863
4351,5,2526,687,3213,3.6768558951965065
4351,6,3246,340,3586,9.547058823529412
4351,7,3629,130,3759,27.915384615384614
4351,8,3794,584,4378,6.4965753424657535
4351,9,4388,542,4930,8.095940959409594
4352,1,13,547,560,0.02376599634369287
4352,2,571,374,945,1.5267379679144386
4352,3,956,328,1284,2.9146341463414633
4352,4,1314,703,2017,1.8691322901849217
4353,1,25,97,122,0.25773195876288657
4353,2,152,87,239,1.7471264367816093
4353,3,285,313,598,0.9105431309904153
4353,4,601,375,976,1.6026666666666667
4353,5,980,363,1343,2.6997245179063363
4353,6,1440,260,1700,5.538461538461538
4353,7,1716,421,2137,4.076009501187649
4353,8,2139,463,2602,4.619870410367171
4353,9,2604,254,2858,10.251968503937007
4353,10,2873,367,3240,7.8283378746594
4353,11,3242,360,3602,9.005555555555556
4353,12,3605,357,3962,10.098039215686274
4353,13,3966,120,4086,33.05
4353,14,4094,402,4496,10.18407960199005
4353,15,4511,352,4863,12.815340909090908
4353,16,4867,303,5170,16.062706270627064
4354,1,24,636,660,0.03773584905660377
4354,2,691,687,1378,1.0058224163027656
4354,3,1408,582,1990,2.4192439862542954
4354,4,2006,240,2246,8.358333333333333
4354,5,2272,532,2804,4.2706766917293235
4354,6,2826,740,3566,3.8189189189189188
4354,7,3574,390,3964,9.164102564102564
4354,8,3987,274,4261,14.55109489051095
4354,9,5059,305,5364,16.58688524590164
4354,10,5383,137,5520,39.29197080291971
4354,11,6170,85,6255,72.58823529411765
4354,12,6272,130,6402,48.246153846153845
4354,13,6453,225,6678,28.68
4354,14,6698,229,6927,29.24890829694323
4354,15,6963,183,7146,38.049180327868854
4354,16,7174,170,7344,42.2
4354,17,7360,179,7539,41.11731843575419
4354,18,7557,467,8024,16.182012847965737
4355,1,623,972,1595,0.6409465020576132
4355,2,1600,499,2099,3.2064128256513027
4355,3,2265,890,3155,2.544943820224719
4355,4,3212,917,4129,3.5027262813522357
4355,5,4152,407,4559,10.201474201474202
4355,6,4584,731,5315,6.270861833105335
4355,7,5351,989,6340,5.41051567239636
4355,8,6347,454,6801,13.980176211453745
4355,9,6858,806,7664,8.508684863523573
4355,10,7696,84,7780,91.61904761904762
4356,1,972,313,1285,3.1054313099041533
4356,2,1500,268,1768,5.597014925373134
4356,3,1962,268,2230,7.32089552238806
4356,4,2414,268,2682,9.007462686567164
4356,5,2801,268,3069,10.451492537313433
4356,6,4052,268,4320,15.119402985074627
4356,7,4536,414,4950,10.956521739130435
4356,8,5916,268,6184,22.074626865671643
4356,9,7098,371,7469,19.132075471698112
4357,1,35,755,790,0.046357615894039736
4358,1,4282,9,4291,475.77777777777777
4358,2,7691,9,7700,854.5555555555555
4359,1,96,173,269,0.5549132947976878
4359,2,480,321,801,1.4953271028037383
4359,3,806,314,1120,2.56687898089172
4359,4,1125,313,1438,3.594249201277955
4359,5,1443,259,1702,5.571428571428571
4359,6,1707,267,1974,6.393258426966292
4359,7,2048,338,2386,6.059171597633136
4359,8,2485,261,2746,9.521072796934867
4359,9,2751,28,2779,98.25
4360,1,31,489,520,0.06339468302658487
4360,2,565,447,1012,1.2639821029082774
4360,3,1056,500,1556,2.112
4360,4,1582,460,2042,3.4391304347826086
4360,5,2085,188,2273,11.090425531914894
4360,6,2303,185,2488,12.448648648648648
4360,7,2502,539,3041,4.641929499072356
4360,8,3055,400,3455,7.6375
4360,9,3495,394,3889,8.870558375634518
4361,1,262,863,1125,0.30359212050984935
4361,2,1189,1029,2218,1.1554907677356656
4361,3,2224,371,2595,5.994609164420485
4361,4,2604,793,3397,3.283732660781841
4361,5,3435,942,4377,3.6464968152866244
4361,6,4384,116,4500,37.793103448275865
4361,7,4519,324,4843,13.947530864197532
4361,8,4854,75,4929,64.72
4361,9,4980,925,5905,5.383783783783784
4361,10,5916,372,6288,15.903225806451612
4361,11,6341,966,7307,6.564182194616977
4361,12,7316,336,7652,21.773809523809526
4362,1,25,365,390,0.0684931506849315
4362,2,423,434,857,0.9746543778801844
4362,3,865,403,1268,2.1464019851116625
4363,1,153,1031,1184,0.1483996120271581
4363,2,1194,805,1999,1.4832298136645963
4363,3,2006,811,2817,2.4734895191122073
4363,4,2937,820,3757,3.5817073170731706
4363,5,3779,498,4277,7.588353413654619
4363,6,4296,267,4563,16.089887640449437
4364,1,340,22,362,15.454545454545455
4364,2,374,40,414,9.35
4364,3,457,145,602,3.1517241379310343
4364,4,673,513,1186,1.3118908382066277
4364,5,1213,559,1772,2.1699463327370303
4364,6,1781,473,2254,3.7653276955602535
4364,7,2288,434,2722,5.271889400921659
4364,8,3140,552,3692,5.688405797101449
4364,9,3754,428,4182,8.771028037383177
4364,10,4278,224,4502,19.098214285714285
4364,11,4510,394,4904,11.446700507614214
4364,12,4944,378,5322,13.079365079365079
4364,13,5376,372,5748,14.451612903225806
4364,14,5757,370,6127,15.55945945945946
4364,15,6148,366,6514,16.797814207650273
4364,16,6555,245,6800,26.755102040816325
4364,17,6878,69,6947,99.68115942028986
4364,18,7097,38,7135,186.76315789473685
4364,19,7363,72,7435,102.26388888888889
4364,20,7642,46,7688,166.1304347826087
4364,21,7893,137,8030,57.613138686131386
4365,1,1655,427,2082,3.8758782201405153
4366,1,87,563,650,0.15452930728241562
4367,1,37,485,522,0.07628865979381444
4368,1,184,183,367,1.005464480874317
4368,2,379,264,643,1.4356060606060606
4368,3,646,272,918,2.375
4369,1,9,26,35,0.34615384615384615
4369,2,55,421,476,0.13064133016627077
4369,3,492,112,604,4.392857142857143
4369,4,618,169,787,3.6568047337278107
4369,5,800,112,912,7.142857142857143
4369,6,931,120,1051,7.758333333333334
4369,7,1066,124,1190,8.596774193548388
4369,8,1207,88,1295,13.715909090909092
4369,9,1303,107,1410,12.177570093457945
4369,10,1418,115,1533,12.330434782608696
4369,11,1544,325,1869,4.75076923076923
4369,12,1882,430,2312,4.376744186046512
4369,13,2324,363,2687,6.402203856749312
4369,14,2707,174,2881,15.557471264367816
4369,15,2889,326,3215,8.86196319018405
4370,1,348,2079,2427,0.1673881673881674
4371,1,863,621,1484,1.3896940418679549
4371,2,1736,273,2009,6.358974358974359
4371,3,2094,227,2321,9.224669603524228
4371,4,2634,470,3104,5.604255319148936
4371,5,3111,47,3158,66.19148936170212
4371,6,3381,524,3905,6.452290076335878
4371,7,3947,322,4269,12.25776397515528
4371,8,4334,163,4497,26.588957055214724
4371,9,4579,367,4946,12.47683923705722
4371,10,5018,299,5317,16.782608695652176
4371,11,5441,297,5738,18.31986531986532
4371,12,5745,57,5802,100.78947368421052
4371,13,5902,225,6127,26.23111111111111
4371,14,6176,239,6415,25.84100418410042
4371,15,6455,168,6623,38.42261904761905
4371,16,6693,264,6957,25.352272727272727
4372,1,95,801,896,0.11860174781523096
4372,2,953,803,1756,1.186799501867995
4372,3,1837,902,2739,2.0365853658536586
4372,4,2801,1044,3845,2.6829501915708813
4372,5,3910,852,4762,4.589201877934272
4373,1,167,579,746,0.28842832469775476
4374,1,1822,33,1855,55.21212121212121
4374,2,2964,33,2997,89.81818181818181
4374,3,4049,35,4084,115.68571428571428
4374,4,4904,35,4939,140.11428571428573
4374,5,5776,35,5811,165.02857142857144
4374,6,7067,31,7098,227.96774193548387
4374,7,7125,396,7521,17.992424242424242
4375,1,100,56,156,1.7857142857142858
4375,2,276,31,307,8.903225806451612
4375,3,964,491,1455,1.9633401221995928
4376,1,247,760,1007,0.325
4376,2,1047,936,1983,1.1185897435897436
4376,3,2100,879,2979,2.3890784982935154
4376,4,3137,188,3325,16.68617021276596
4376,5,3353,936,4289,3.5822649572649574
4377,1,156,826,982,0.18886198547215496
4378,1,28,418,446,0.06698564593301436
4378,2,471,806,1277,0.5843672456575683
4378,3,1296,754,2050,1.7188328912466844
4379,1,23,960,983,0.023958333333333335
4379,2,1014,468,1482,2.1666666666666665
4379,3,1554,121,1675,12.84297520661157
4379,4,1976,460,2436,4.2956521739130435
4379,5,2464,1015,3479,2.4275862068965517
4379,6,3496,1028,4524,3.4007782101167314
4379,7,4720,496,5216,9.516129032258064
4379,8,5257,244,5501,21.545081967213115
4379,9,5574,167,5741,33.377245508982035
4379,10,5766,152,5918,37.93421052631579
4379,11,6409,615,7024,10.421138211382114
4380,1,927,90,1017,10.3
4381,1,57,939,996,0.06070287539936102
4382,1,44,442,486,0.09954751131221719
4383,1,108,251,359,0.4302788844621514
4383,2,364,40,404,9.1
4383,3,435,603,1038,0.7213930348258707
4383,4,1063,865,1928,1.2289017341040462
4383,5,1967,632,2599,3.1123417721518987
4383,6,2630,660,3290,3.984848484848485
4383,7,3314,647,3961,5.12210200927357
4383,8,4010,599,4609,6.69449081803005
4383,9,4622,582,5204,7.941580756013746
4383,10,5221,649,5870,8.044684129429893
4383,11,5893,661,6554,8.915279878971255
4383,12,6572,560,7132,11.735714285714286
4383,13,7156,581,7737,12.31669535283993
4384,1,50,55,105,0.9090909090909091
4384,2,125,111,236,1.1261261261261262
4384,3,259,108,367,2.3981481481481484
4385,1,701,352,1053,1.9914772727272727
4385,2,1069,345,1414,3.0985507246376813
4385,3,1416,90,1506,15.733333333333333
4385,4,2412,371,2783,6.501347708894879
4386,1,228,298,526,0.7651006711409396
4387,1,29,100,129,0.29
4388,1,71,1066,1137,0.06660412757973734
4388,2,1266,362,1628,3.4972375690607733
4389,1,219,963,1182,0.22741433021806853
4389,2,1222,627,1849,1.9489633173843701
4389,3,1862,1020,2882,1.8254901960784313
4389,4,2898,858,3756,3.3776223776223775
4390,1,523,21,544,24.904761904761905
4390,2,568,56,624,10.142857142857142
4390,3,626,14,640,44.714285714285715
4390,4,668,85,753,7.858823529411764
4390,5,755,12,767,62.916666666666664
4390,6,781,16,797,48.8125
4390,7,799,14,813,57.07142857142857
4390,8,842,102,944,8.254901960784315
4390,9,959,114,1073,8.412280701754385
4390,10,1075,26,1101,41.34615384615385
4390,11,1129,164,1293,6.884146341463414
4390,12,1295,17,1312,76.17647058823529
4390,13,1340,142,1482,9.43661971830986
4390,14,1507,104,1611,14.490384615384615
4390,15,1630,137,1767,11.897810218978103
4390,16,1779,102,1881,17.441176470588236
4390,17,1898,30,1928,63.266666666666666
4390,18,1934,25,1959,77.36
4390,19,2007,124,2131,16.18548387096774
4390,20,2133,25,2158,85.32
4390,21,2165,62,2227,34.91935483870968
4390,22,2265,116,2381,19.525862068965516
4390,23,2383,37,2420,64.4054054054054
4390,24,2439,65,2504,37.52307692307692
4390,25,2506,21,2527,119.33333333333333
4390,26,2542,77,2619,33.01298701298701
4390,27,2632,75,2707,35.093333333333334
4390,28,2719,75,2794,36.25333333333333
4390,29,2799,22,2821,127.22727272727273
4390,30,2862,73,2935,39.205479452054796
4390,31,2937,31,2968,94.74193548387096
4390,32,3012,104,3116,28.96153846153846
4390,33,3118,34,3152,91.70588235294117
4390,34,3174,53,3227,59.886792452830186
4390,35,3255,231,3486,14.090909090909092
4390,36,3515,131,3646,26.83206106870229
4390,37,3653,49,3702,74.55102040816327
4390,38,3704,29,3733,127.72413793103448
4390,39,3780,176,3956,21.477272727272727
4390,40,3958,28,3986,141.35714285714286
4390,41,4014,98,4112,40.95918367346939
4390,42,4141,116,4257,35.69827586206897
4390,43,4259,35,4294,121.68571428571428
4390,44,4338,95,4433,45.66315789473684
4390,45,4450,129,4579,34.49612403100775
4390,46,4605,245,4850,18.79591836734694
4390,47,4860,309,5169,15.728155339805825
4391,1,35,369,404,0.0948509485094851
4392,1,115,314,429,0.3662420382165605
4392,2,465,906,1371,0.5132450331125827
4392,3,1418,718,2136,1.9749303621169916
4392,4,2188,652,2840,3.355828220858896
4392,5,2968,663,3631,4.4766214177978885
4392,6,3661,695,4356,5.267625899280575
4393,1,2676,1128,3804,2.372340425531915
4393,2,3837,623,4460,6.158908507223114
4393,3,4488,84,4572,53.42857142857143
4393,4,4706,378,5084,12.44973544973545
4393,5,5166,421,5587,12.270783847980997
4393,6,5805,592,6397,9.805743243243244
4394,1,11,614,625,0.017915309446254073
4395,1,32,976,1008,0.03278688524590164
4396,1,2539,351,2890,7.233618233618234
4396,2,2918,478,3396,6.104602510460251
4396,3,3491,808,4299,4.320544554455446
4396,4,4441,543,4984,8.178637200736649
4396,5,5015,564,5579,8.891843971631205
4396,6,5613,564,6177,9.952127659574469
4396,7,6207,454,6661,13.67180616740088
4396,8,6679,427,7106,15.641686182669789
4396,9,7143,623,7766,11.465489566613162
4397,1,30,51,81,0.5882352941176471
4397,2,523,53,576,9.867924528301886
4397,3,1345,44,1389,30.568181818181817
4397,4,1950,47,1997,41.48936170212766
4397,5,2315,44,2359,52.61363636363637
4397,6,2386,39,2425,61.17948717948718
4397,7,3209,122,3331,26.30327868852459
4397,8,3348,55,3403,60.872727272727275
4397,9,3889,132,4021,29.46212121212121
4397,10,5993,180,6173,33.294444444444444
4397,11,6272,469,6741,13.373134328358208
4397,12,6811,448,7259,15.203125
4397,13,7328,437,7765,16.76887871853547
4398,1,859,589,1448,1.4584040747028864
4399,1,23,899,922,0.025583982202447165
4399,2,933,344,1277,2.7122093023255816
4399,3,1287,906,2193,1.4205298013245033
4399,4,2199,888,3087,2.4763513513513513
4399,5,3099,379,3478,8.176781002638522
4399,6,3493,782,4275,4.466751918158568
4399,7,4288,973,5261,4.406988694758479
4399,8,5279,1136,6415,4.647007042253521
4399,9,6424,200,6624,32.12
4399,10,6634,622,7256,10.665594855305466
4400,1,222,590,812,0.376271186440678
4400,2,1241,354,1595,3.505649717514124
4401,1,17,872,889,0.0194954128440367
4402,1,34,36,70,0.9444444444444444
4402,2,1300,290,1590,4.482758620689655
4402,3,1606,404,2010,3.9752475247524752
4403,1,111,70,181,1.5857142857142856
4403,2,276,596,872,0.46308724832214765
4403,3,892,698,1590,1.2779369627507164
4403,4,1660,560,2220,2.9642857142857144
4403,5,2280,383,2663,5.953002610966058
4403,6,2700,450,3150,6.0
4403,7,3214,545,3759,5.897247706422019
4403,8,3819,252,4071,15.154761904761905
4403,9,4145,321,4466,12.912772585669781
4403,10,4482,139,4621,32.24460431654676
4403,11,4631,214,4845,21.64018691588785
4403,12,4917,322,5239,15.270186335403727
4403,13,5303,196,5499,27.056122448979593
4403,14,5548,122,5670,45.47540983606557
4404,1,12,186,198,0.06451612903225806
4405,1,110,548,658,0.20072992700729927
4405,2,678,569,1247,1.1915641476274166
4406,1,35,152,187,0.23026315789473684
4407,1,259,872,1131,0.29701834862385323
4408,1,32,984,1016,0.032520325203252036
4408,2,1078,698,1776,1.5444126074498568
4408,3,1818,965,2783,1.8839378238341968
4408,4,2829,904,3733,3.129424778761062
4408,5,3766,942,4708,3.997876857749469
4408,6,4753,928,5681,5.1217672413793105
4408,7,5703,773,6476,7.377749029754204
4408,8,6491,520,7011,12.482692307692307
4408,9,7030,685,7715,10.262773722627736
4409,1,46,69,115,0.6666666666666666
4409,2,138,475,613,0.2905263157894737
4409,3,689,173,862,3.9826589595375723
4409,4,911,558,1469,1.6326164874551972
4409,5,1536,548,2084,2.802919708029197
4409,6,2129,153,2282,13.915032679738562
4409,7,2329,155,2484,15.025806451612903
4409,8,2528,248,2776,10.193548387096774
4409,9,2778,110,2888,25.254545454545454
4409,10,2898,253,3151,11.454545454545455
4409,11,3153,97,3250,32.50515463917526
4409,12,3252,116,3368,28.03448275862069
4409,13,3370,95,3465,35.473684210526315
4409,14,3467,124,3591,27.95967741935484
4409,15,3593,181,3774,19.85082872928177
4409,16,3802,524,4326,7.255725190839694
4409,17,4369,281,4650,15.548042704626335
4409,18,4679,223,4902,20.982062780269057
4410,1,36,658,694,0.0547112462006079
4410,2,711,579,1290,1.2279792746113989
4411,1,320,391,711,0.8184143222506394
4411,2,746,436,1182,1.7110091743119267
4411,3,1196,458,1654,2.611353711790393
4412,1,11,503,514,0.02186878727634195
4412,2,527,420,947,1.2547619047619047
4412,3,962,291,1253,3.3058419243986252
4413,1,36,491,527,0.07331975560081466
4414,1,41,89,130,0.4606741573033708
4414,2,183,230,413,0.7956521739130434
4414,3,462,389,851,1.1876606683804627
4414,4,917,232,1149,3.9525862068965516
4414,5,1190,181,1371,6.574585635359116
4414,6,1437,198,1635,7.257575757575758
4414,7,1665,172,1837,9.680232558139535
4414,8,1875,153,2028,12.254901960784315
4414,9,2077,373,2450,5.568364611260054
4414,10,2470,368,2838,6.711956521739131
4414,11,2840,168,3008,16.904761904761905
4414,12,3047,174,3221,17.511494252873565
4415,1,21,683,704,0.03074670571010249
4416,1,220,231,451,0.9523809523809523
4417,1,39,76,115,0.5131578947368421
4418,1,18,378,396,0.047619047619047616
4418,2,407,210,617,1.938095238095238
4418,3,629,232,861,2.711206896551724
4418,4,880,293,1173,3.0034129692832763
4419,1,106,275,381,0.38545454545454544
4419,2,535,512,1047,1.044921875
4419,3,1061,421,1482,2.5201900237529693
4419,4,1558,629,2187,2.4769475357710653
4419,5,2225,730,2955,3.047945205479452
4420,1,182,672,854,0.2708333333333333
4420,2,888,732,1620,1.2131147540983607
4420,3,1655,731,2386,2.264021887824897
4420,4,2423,765,3188,3.1673202614379083
4420,5,3256,770,4026,4.228571428571429
4420,6,4079,317,4396,12.867507886435332
4420,7,4412,365,4777,12.087671232876712
4421,1,41,784,825,0.05229591836734694
4421,2,844,962,1806,0.8773388773388774
4421,3,1823,840,2663,2.170238095238095
4421,4,2683,729,3412,3.680384087791495
4421,5,3439,511,3950,6.729941291585127
4421,6,3977,159,4136,25.0125786163522
4421,7,4150,345,4495,12.028985507246377
4421,8,4517,614,5131,7.356677524429967
4421,9,5157,696,5853,7.4094827586206895
4422,1,30,963,993,0.03115264797507788
4423,1,109,310,419,0.35161290322580646
4423,2,427,340,767,1.2558823529411764
4424,1,34,286,320,0.11888111888111888
4424,2,352,154,506,2.2857142857142856
4425,1,17,186,203,0.0913978494623656
4425,2,430,714,1144,0.6022408963585434
4425,3,1215,843,2058,1.4412811387900355
4425,4,2129,973,3102,2.188078108941418
4425,5,3106,357,3463,8.700280112044817
4425,6,3490,229,3719,15.240174672489083
4425,7,3838,664,4502,5.780120481927711
4425,8,4516,631,5147,7.15689381933439
4425,9,5481,464,5945,11.8125
4425,10,6439,745,7184,8.642953020134229
4425,11,7253,206,7459,35.20873786407767
4425,12,7639,371,8010,20.590296495956874
4426,1,4075,25,4100,163.0
4426,2,7701,22,7723,350.04545454545456
4427,1,50,632,682,0.07911392405063292
4427,2,702,232,934,3.0258620689655173
4428,1,34,70,104,0.4857142857142857
4428,2,965,3,968,321.6666666666667
4428,3,2581,3,2584,860.3333333333334
4428,4,4506,3,4509,1502.0
4428,5,6214,3,6217,2071.3333333333335
4428,6,7977,3,7980,2659.0
4429,1,93,181,274,0.5138121546961326
4430,1,1535,1001,2536,1.5334665334665334
4430,2,2561,596,3157,4.296979865771812
4430,3,3235,789,4024,4.100126742712294
4430,4,4104,746,4850,5.501340482573727
4430,5,4874,889,5763,5.4825646794150735
4430,6,5784,927,6711,6.239482200647249
4431,1,1018,508,1526,2.0039370078740157
4431,2,1812,1028,2840,1.7626459143968871
4431,3,2843,118,2961,24.093220338983052
4432,1,11,57,68,0.19298245614035087
4432,2,87,121,208,0.71900826446281
4432,3,223,273,496,0.8168498168498168
4432,4,508,369,877,1.3766937669376693
4432,5,888,416,1304,2.1346153846153846
4432,6,1336,305,1641,4.380327868852459
4432,7,1652,199,1851,8.301507537688442
4432,8,1871,80,1951,23.3875
4432,9,1973,374,2347,5.275401069518717
4432,10,2361,181,2542,13.044198895027625
4432,11,2558,208,2766,12.298076923076923
4432,12,2772,365,3137,7.594520547945206
4432,13,3266,209,3475,15.626794258373206
4432,14,3625,268,3893,13.526119402985074
4432,15,3937,437,4374,9.009153318077804
4432,16,4494,170,4664,26.435294117647057
4432,17,4683,479,5162,9.77661795407098
4432,18,5180,517,5697,10.019342359767892
4432,19,5732,51,5783,112.3921568627451
4432,20,6145,617,6762,9.959481361426256
4432,21,6770,577,7347,11.733102253032929
4432,22,7414,14,7428,529.5714285714286
4432,23,7489,125,7614,59.912
4433,1,103,422,525,0.24407582938388625
4433,2,584,138,722,4.231884057971015
4433,3,818,399,1217,2.0501253132832082
4433,4,1295,299,1594,4.331103678929765
4433,5,1648,421,2069,3.9144893111638956
4433,6,2086,447,2533,4.666666666666667
4433,7,2555,314,2869,8.136942675159236
4433,8,2880,508,3388,5.669291338582677
4433,9,3414,455,3869,7.503296703296703
4433,10,4004,874,4878,4.581235697940503
4433,11,4960,3,4963,1653.3333333333333
4434,1,19,609,628,0.031198686371100164
4434,2,714,710,1424,1.0056338028169014
4434,3,1438,960,2398,1.4979166666666666
4434,4,2474,358,2832,6.910614525139665
4434,5,2857,696,3553,4.1048850574712645
4435,1,77,26,103,2.9615384615384617
4435,2,115,108,223,1.0648148148148149
4436,1,1148,430,1578,2.6697674418604653
4436,2,1587,1027,2614,1.5452775073028238
4436,3,2617,262,2879,9.988549618320612
4436,4,2914,147,3061,19.82312925170068
4436,5,3079,361,3440,8.529085872576177
4436,6,3449,466,3915,7.401287553648069
4436,7,3941,474,4415,8.314345991561181
4436,8,4436,486,4922,9.127572016460906
4436,9,5059,184,5243,27.494565217391305
4436,10,5252,38,5290,138.21052631578948
4437,1,1258,836,2094,1.5047846889952152
4437,2,2096,790,2886,2.6531645569620252
4437,3,2888,570,3458,5.066666666666666
4438,1,35,799,834,0.04380475594493116
4438,2,841,475,1316,1.7705263157894737
4438,3,1328,451,1779,2.9445676274944566
4438,4,1788,451,2239,3.964523281596452
4438,5,2245,290,2535,7.741379310344827
4438,6,2543,429,2972,5.927738927738928
4438,7,3000,295,3295,10.169491525423728
4438,8,3304,466,3770,7.090128755364807
4438,9,3782,602,4384,6.282392026578073
4438,10,4409,515,4924,8.561165048543689
4438,11,4937,500,5437,9.874
4438,12,5458,870,6328,6.273563218390804
4438,13,6338,925,7263,6.851891891891892
4439,1,31,662,693,0.04682779456193353
4439,2,710,529,1239,1.3421550094517958
4440,1,687,452,1139,1.5199115044247788
4440,2,1158,874,2032,1.3249427917620138
4441,1,22,385,407,0.05714285714285714
4441,2,424,358,782,1.1843575418994414
4442,1,103,333,436,0.30930930930930933
4442,2,474,557,1031,0.8509874326750448
4443,1,16,600,616,0.02666666666666667
4443,2,633,702,1335,0.9017094017094017
4443,3,1355,534,1889,2.5374531835205993
4444,1,129,10,139,12.9
4444,2,203,7,210,29.0
4444,3,354,8,362,44.25
4444,4,383,19,402,20.157894736842106
4444,5,413,10,423,41.3
4444,6,434,9,443,48.22222222222222
4444,7,522,14,536,37.285714285714285
4444,8,541,29,570,18.655172413793103
4444,9,575,13,588,44.23076923076923
4444,10,593,25,618,23.72
4444,11,622,19,641,32.73684210526316
4444,12,711,14,725,50.785714285714285
4444,13,745,31,776,24.032258064516128
4444,14,788,14,802,56.285714285714285
4444,15,816,18,834,45.333333333333336
4444,16,905,18,923,50.27777777777778
4444,17,959,15,974,63.93333333333333
4444,18,1136,29,1165,39.172413793103445
4444,19,1219,16,1235,76.1875
4444,20,1239,45,1284,27.533333333333335
4444,21,1305,20,1325,65.25
4444,22,1333,48,1381,27.770833333333332
4444,23,1391,43,1434,32.348837209302324
4444,24,2035,55,2090,37.0
4444,25,2106,7,2113,300.85714285714283
4444,26,2175,11,2186,197.72727272727272
4444,27,2275,37,2312,61.486486486486484
4444,28,2324,64,2388,36.3125
4444,29,2399,36,2435,66.63888888888889
4445,1,24,714,738,0.03361344537815126
4446,1,9,616,625,0.01461038961038961
4446,2,656,669,1325,0.9805680119581465
4446,3,1337,883,2220,1.5141562853907136
4446,4,2222,445,2667,4.9932584269662925
4446,5,2679,391,3070,6.851662404092072
4446,6,3080,309,3389,9.967637540453074
4447,1,504,655,1159,0.7694656488549618
4447,2,1291,673,1964,1.9182763744427935
4448,1,33,393,426,0.08396946564885496
4448,2,453,450,903,1.0066666666666666
4448,3,952,502,1454,1.8964143426294822
4448,4,1612,491,2103,3.283095723014257
4449,1,96,595,691,0.16134453781512606
4449,2,700,383,1083,1.8276762402088773
4449,3,1108,131,1239,8.458015267175572
4449,4,1248,67,1315,18.62686567164179
4449,5,1331,72,1403,18.48611111111111
4450,1,119,783,902,0.15197956577266922
4450,2,910,526,1436,1.7300380228136882
4450,3,1560,775,2335,2.0129032258064514
4450,4,2343,727,3070,3.22283356258597
4450,5,3200,839,4039,3.8140643623361146
4450,6,4047,799,4846,5.065081351689612
4450,7,4854,256,5110,18.9609375
4450,8,5239,756,5995,6.9298941798941796
4450,9,6003,808,6811,7.429455445544554
4450,10,6944,790,7734,8.78987341772152
4451,1,338,170,508,1.988235294117647
4451,2,515,260,775,1.9807692307692308
4451,3,791,493,1284,1.6044624746450304
4451,4,1295,950,2245,1.3631578947368421
4451,5,2248,151,2399,14.887417218543046
4452,1,2193,469,2662,4.67590618336887
4453,1,118,427,545,0.27634660421545665
4454,1,172,1717,1889,0.10017472335468841
4455,1,38,730,768,0.052054794520547946
4455,2,847,851,1698,0.9952996474735605
4455,3,1712,459,2171,3.729847494553377
4455,4,2188,384,2572,5.697916666666667
4455,5,2598,457,3055,5.6849015317286655
4455,6,3072,494,3566,6.218623481781377
4455,7,3591,926,4517,3.8779697624190064
4455,8,4542,224,4766,20.276785714285715
4455,9,4948,350,5298,14.137142857142857
4455,10,5320,465,5785,11.440860215053764
4455,11,5867,256,6123,22.91796875
4455,12,6152,963,7115,6.388369678089305
4455,13,7146,643,7789,11.11353032659409
4456,1,1504,491,1995,3.0631364562118124
4457,1,1039,715,1754,1.4531468531468532
4457,2,2682,1012,3694,2.650197628458498
4457,3,3784,1084,4868,3.4907749077490773
4458,1,140,724,864,0.19337016574585636
4458,2,873,265,1138,3.2943396226415094
4458,3,1259,848,2107,1.4846698113207548
4458,4,2154,636,2790,3.3867924528301887
4458,5,2801,291,3092,9.625429553264604
4458,6,3699,646,4345,5.726006191950464
4458,7,4355,428,4783,10.175233644859814
4459,1,194,345,539,0.5623188405797102
4459,2,542,295,837,1.8372881355932202
4459,3,841,93,934,9.043010752688172
4459,4,1074,278,1352,3.8633093525179856
4459,5,1395,313,1708,4.456869009584665
4459,6,1741,358,2099,4.863128491620111
4459,7,2102,295,2397,7.125423728813559
4459,8,2517,390,2907,6.453846153846154
4459,9,2910,363,3273,8.016528925619834
4459,10,3276,368,3644,8.902173913043478
4459,11,3720,341,4061,10.909090909090908
4459,12,4064,322,4386,12.621118012422361
4459,13,4417,328,4745,13.466463414634147
4459,14,4748,136,4884,34.911764705882355
4459,15,5010,353,5363,14.192634560906516
4459,16,5366,211,5577,25.43127962085308
4459,17,5644,313,5957,18.031948881789138
4459,18,5976,344,6320,17.372093023255815
4459,19,6369,334,6703,19.068862275449103
4459,20,6770,332,7102,20.39156626506024
4459,21,7105,289,7394,24.58477508650519
4459,22,7397,136,7533,54.38970588235294
4460,1,2608,786,3394,3.318066157760814
4460,2,3400,24,3424,141.66666666666666
4460,3,3436,210,3646,16.36190476190476
4460,4,3656,58,3714,63.03448275862069
4460,5,3726,239,3965,15.589958158995817
4460,6,3991,240,4231,16.629166666666666
4460,7,4248,344,4592,12.348837209302326
4460,8,4610,554,5164,8.321299638989169
4460,9,5193,711,5904,7.30379746835443
4460,10,5921,164,6085,36.103658536585364
4460,11,6093,168,6261,36.267857142857146
4461,1,26,33,59,0.7878787878787878
4461,2,102,518,620,0.1969111969111969
4462,1,8,73,81,0.1095890410958904
4462,2,89,248,337,0.3588709677419355
4463,1,353,529,882,0.667296786389414
4463,2,920,394,1314,2.33502538071066
4463,3,1330,647,1977,2.05564142194745
4463,4,1987,135,2122,14.718518518518518
4463,5,2137,578,2715,3.6972318339100347
4463,6,2840,252,3092,11.26984126984127
4464,1,33,424,457,0.07783018867924528
4464,2,473,428,901,1.105140186915888
4464,3,916,568,1484,1.6126760563380282
4465,1,48,271,319,0.17712177121771217
4466,1,308,386,694,0.7979274611398963
4466,2,697,430,1127,1.6209302325581396
4466,3,1130,427,1557,2.6463700234192036
4466,4,1560,273,1833,5.714285714285714
4467,1,325,387,712,0.8397932816537468
4467,2,720,642,1362,1.1214953271028036
4467,3,1372,622,1994,2.2057877813504825
4467,4,2007,641,2648,3.1310452418096726
4468,1,18,158,176,0.11392405063291139
4468,2,190,66,256,2.878787878787879
4468,3,270,276,546,0.9782608695652174
4468,4,584,55,639,10.618181818181819
4468,5,741,153,894,4.8431372549019605
4468,6,975,178,1153,5.477528089887641
4469,1,17,684,701,0.024853801169590642
4469,2,729,674,1403,1.0816023738872405
4469,3,1457,747,2204,1.9504685408299867
4470,1,44,2044,2088,0.021526418786692758
4471,1,58,268,326,0.21641791044776118
4472,1,206,12,218,17.166666666666668
4472,2,1392,20,1412,69.6
4472,3,2113,938,3051,2.2526652452025586
4472,4,3059,713,3772,4.290322580645161
4473,1,44,533,577,0.0825515947467167
4473,2,599,339,938,1.766961651917404
4473,3,1373,678,2051,2.0250737463126844
4473,4,2251,1007,3258,2.2353525322740815
4473,5,3343,74,3417,45.17567567567568
4473,6,3529,1027,4556,3.436222005842259
4473,7,4575,137,4712,33.394160583941606
4473,8,4725,1048,5773,4.508587786259542
4473,9,5789,671,6460,8.6274217585693
4473,10,6479,127,6606,51.01574803149607
4473,11,6637,998,7635,6.650300601202405
4474,1,224,1014,1238,0.22090729783037474
4474,2,1246,913,2159,1.3647316538882803
4475,1,17,207,224,0.0821256038647343
4475,2,262,393,655,0.6666666666666666
4475,3,687,652,1339,1.053680981595092
4475,4,1365,747,2112,1.8273092369477912
4475,5,2132,771,2903,2.7652399481193255
4475,6,2935,493,3428,5.953346855983773
4475,7,3444,449,3893,7.6703786191536745
4475,8,3932,441,4373,8.91609977324263
4475,9,4536,175,4711,25.92
4475,10,4812,172,4984,27.976744186046513
4475,11,5125,248,5373,20.66532258064516
4475,12,5384,243,5627,22.156378600823047
4475,13,5708,247,5955,23.10931174089069
4475,14,6001,86,6087,69.77906976744185
4475,15,6095,88,6183,69.26136363636364
4475,16,6218,215,6433,28.92093023255814
4475,17,6462,289,6751,22.359861591695502
4475,18,6780,350,7130,19.37142857142857
4475,19,7154,325,7479,22.012307692307694
4475,20,7517,162,7679,46.401234567901234
4476,1,93,518,611,0.17953667953667954
4476,2,744,497,1241,1.4969818913480886
4476,3,1293,544,1837,2.3768382352941178
4476,4,1937,505,2442,3.8356435643564355
4476,5,2517,756,3273,3.3293650793650795
4476,6,3289,626,3915,5.253993610223642
4476,7,3968,737,4705,5.383989145183175
4476,8,4712,591,5303,7.972927241962775
4476,9,5424,944,6368,5.745762711864407
4476,10,6392,86,6478,74.32558139534883
4476,11,6486,138,6624,47.0
4476,12,6634,959,7593,6.917622523461939
4477,1,14,704,718,0.019886363636363636
4477,2,745,601,1346,1.2396006655574043
4477,3,1356,342,1698,3.9649122807017543
4478,1,956,298,1254,3.208053691275168
4479,1,152,503,655,0.30218687872763417
4480,1,482,146,628,3.3013698630136985
4480,2,642,517,1159,1.241779497098646
4480,3,1174,132,1306,8.893939393939394
4480,4,1320,133,1453,9.924812030075188
4480,5,1470,177,1647,8.305084745762711
4480,6,1674,191,1865,8.764397905759163
4480,7,1877,153,2030,12.267973856209151
4480,8,2047,671,2718,3.0506706408345754
4480,9,2728,364,3092,7.4945054945054945
4480,10,3101,665,3766,4.663157894736842
4480,11,3774,623,4397,6.057784911717496
4480,12,4408,297,4705,14.841750841750843
4480,13,4723,141,4864,33.49645390070922
4480,14,4879,424,5303,11.507075471698114
4480,15,5310,201,5511,26.417910447761194
4480,16,5521,467,5988,11.822269807280515
4480,17,5998,507,6505,11.830374753451677
4480,18,6511,1027,7538,6.339824732229795
4481,1,18,546,564,0.03296703296703297
4481,2,591,656,1247,0.9009146341463414
4481,3,1262,447,1709,2.8232662192393736
4481,4,1738,698,2436,2.489971346704871
4481,5,2448,612,3060,4.0
4482,1,500,929,1429,0.5382131324004306
4482,2,1437,527,1964,2.7267552182163186
4483,1,631,428,1059,1.4742990654205608
4483,2,1080,391,1471,2.762148337595908
4483,3,1506,31,1537,48.58064516129032
4483,4,1559,27,1586,57.74074074074074
4484,1,1624,182,1806,8.923076923076923
4485,1,16,521,537,0.030710172744721688
4485,2,545,679,1224,0.8026509572901326
4486,1,36,349,385,0.10315186246418338
4486,2,421,346,767,1.216763005780347
4486,3,803,332,1135,2.4186746987951806
4486,4,1171,792,1963,1.4785353535353536
4486,5,2008,907,2915,2.2138919514884234
4486,6,2978,897,3875,3.319955406911929
4486,7,3886,376,4262,10.335106382978724
4486,8,4306,309,4615,13.935275080906148
4487,1,632,5,637,126.4
4487,2,1109,17,1126,65.23529411764706
4487,3,1254,322,1576,3.8944099378881987
4487,4,1680,472,2152,3.559322033898305
4487,5,2190,472,2662,4.639830508474576
4487,6,2697,122,2819,22.10655737704918
4487,7,2860,272,3132,10.514705882352942
4487,8,3356,538,3894,6.237918215613383
4487,9,3955,585,4540,6.760683760683761
4487,10,4686,907,5593,5.166482910694597
4487,11,5763,874,6637,6.593821510297483
4487,12,6682,472,7154,14.15677966101695
4487,13,7277,296,7573,24.58445945945946
4488,1,41,790,831,0.05189873417721519
4488,2,858,443,1301,1.9367945823927766
4488,3,1326,414,1740,3.2028985507246377
4488,4,1763,412,2175,4.279126213592233
4488,5,2196,449,2645,4.89086859688196
4488,6,2711,390,3101,6.9512820512820515
4488,7,3118,576,3694,5.413194444444445
4488,8,3801,547,4348,6.948811700182816
4488,9,4384,461,4845,9.509761388286334
4488,10,4913,958,5871,5.12839248434238
4488,11,5886,493,6379,11.939148073022313
4488,12,6395,343,6738,18.644314868804663
4488,13,6752,678,7430,9.958702064896755
4489,1,89,1229,1318,0.07241659886086249
4489,2,1328,550,1878,2.4145454545454546
4489,3,1909,876,2785,2.1792237442922375
4489,4,2798,430,3228,6.506976744186047
4489,5,3237,642,3879,5.042056074766355
4489,6,3903,1008,4911,3.8720238095238093
4489,7,4921,522,5443,9.4272030651341
4489,8,5466,1015,6481,5.385221674876847
4489,9,6500,382,6882,17.015706806282722
4489,10,6903,521,7424,13.249520153550863
4489,11,7446,539,7985,13.814471243042671
4490,1,53,396,449,0.13383838383838384
4490,2,617,629,1246,0.9809220985691574
4490,3,1340,808,2148,1.6584158415841583
4490,4,2194,590,2784,3.7186440677966104
4490,5,2849,607,3456,4.693574958813839
4490,6,3474,572,4046,6.073426573426573
4490,7,4066,535,4601,7.6
4490,8,4621,865,5486,5.342196531791908
4490,9,5594,929,6523,6.021528525296017
4490,10,6563,453,7016,14.487858719646798
4490,11,7027,548,7575,12.822992700729927
4491,1,1125,395,1520,2.848101265822785
4491,2,1548,379,1927,4.084432717678101
4491,3,1967,383,2350,5.135770234986945
4491,4,2575,315,2890,8.174603174603174
4491,5,2921,441,3362,6.62358276643991
4491,6,3405,416,3821,8.185096153846153
4492,1,51,69,120,0.7391304347826086
4492,2,847,811,1658,1.0443896424167693
4492,3,1662,18,1680,92.33333333333333
4492,4,2673,504,3177,5.303571428571429
4492,5,4796,607,5403,7.901153212520593
4492,6,6887,317,7204,21.725552050473187
4493,1,61,1053,1114,0.057929724596391265
4493,2,1146,973,2119,1.1778006166495376
4493,3,2147,1288,3435,1.6669254658385093
4493,4,3457,829,4286,4.170084439083233
4493,5,4335,1013,5348,4.279368213228036
4493,6,5436,554,5990,9.812274368231048
4493,7,6049,1086,7135,5.569981583793738
4494,1,12,152,164,0.07894736842105263
4495,1,190,699,889,0.2718168812589413
4495,2,913,125,1038,7.304
4495,3,1186,441,1627,2.689342403628118
4495,4,1752,503,2255,3.4831013916500995
4495,5,2301,249,2550,9.240963855421686
4495,6,2637,470,3107,5.610638297872341
4495,7,3364,362,3726,9.292817679558011
4496,1,23,791,814,0.029077117572692796
4496,2,865,326,1191,2.6533742331288344
4496,3,1217,384,1601,3.1692708333333335
4496,4,1956,417,2373,4.690647482014389
4496,5,2469,126,2595,19.595238095238095
4496,6,2828,969,3797,2.918472652218782
4497,1,592,626,1218,0.9456869009584664
4497,2,2087,80,2167,26.0875
4498,1,37,824,861,0.044902912621359224
4499,1,3246,583,3829,5.567753001715266
4499,2,3860,703,4563,5.490753911806544
4499,3,4593,626,5219,7.3370607028754
4499,4,5281,742,6023,7.117250673854447
4500,1,1160,960,2120,1.2083333333333333
4500,2,2141,956,3097,2.239539748953975
4500,3,3105,845,3950,3.6745562130177514
4501,1,105,882,987,0.11904761904761904
4502,1,1956,207,2163,9.44927536231884
4502,2,2979,644,3623,4.625776397515528
4502,3,5623,216,5839,26.03240740740741
4502,4,5870,198,6068,29.646464646464647
4502,5,6115,407,6522,15.024570024570025
4502,6,6534,387,6921,16.88372093023256
4502,7,6931,382,7313,18.143979057591622
4502,8,7325,366,7691,20.01366120218579
4503,1,14,288,302,0.04861111111111111
4503,2,320,76,396,4.2105263157894735
4503,3,429,313,742,1.3706070287539935
4503,4,778,383,1161,2.031331592689295
4503,5,1189,81,1270,14.679012345679013
4503,6,1306,168,1474,7.773809523809524
4503,7,1507,387,1894,3.8940568475452197
4503,8,1932,164,2096,11.78048780487805
4503,9,2132,453,2585,4.706401766004415
4503,10,2611,116,2727,22.50862068965517
4503,11,2758,386,3144,7.1450777202072535
4503,12,3186,363,3549,8.776859504132231
4503,13,3610,300,3910,12.033333333333333
4503,14,3927,162,4089,24.24074074074074
4504,1,652,598,1250,1.0903010033444815
4505,1,249,545,794,0.45688073394495415
4505,2,808,530,1338,1.5245283018867926
4505,3,1822,63,1885,28.92063492063492
4505,4,1895,33,1928,57.42424242424242
4505,5,2192,24,2216,91.33333333333333
4505,6,2226,43,2269,51.76744186046512
4505,7,2881,445,3326,6.474157303370786
4505,8,3406,864,4270,3.9421296296296298
4505,9,4293,338,4631,12.701183431952662
4505,10,4677,371,5048,12.606469002695418
4505,11,5090,948,6038,5.3691983122362865
4505,12,6049,564,6613,10.72517730496454
4506,1,998,640,1638,1.559375
4507,1,98,598,696,0.16387959866220736
4507,2,735,615,1350,1.1951219512195121
4508,1,676,466,1142,1.4506437768240343
4508,2,1216,524,1740,2.3206106870229006
4508,3,1782,504,2286,3.5357142857142856
4508,4,2314,621,2935,3.7262479871175525
4508,5,2955,681,3636,4.3392070484581495
4509,1,49,522,571,0.09386973180076628
4510,1,18,887,905,0.020293122886133032
4510,2,1390,439,1829,3.1662870159453305
4510,3,1847,868,2715,2.127880184331797
4510,4,2796,257,3053,10.879377431906615
4510,5,3075,237,3312,12.974683544303797
4511,1,6,122,128,0.04918032786885246
4511,2,142,511,653,0.27788649706457924
4511,3,694,670,1364,1.035820895522388
4511,4,1461,562,2023,2.599644128113879
4511,5,2058,729,2787,2.8230452674897117
4511,6,2809,769,3578,3.6527958387516253
4511,7,3646,563,4209,6.476021314387212
4511,8,4261,965,5226,4.415544041450778
4511,9,5230,247,5477,21.17408906882591
4511,10,5534,569,6103,9.725834797891038
4511,11,6176,544,6720,11.352941176470589
4511,12,6801,558,7359,12.188172043010752
4512,1,91,907,998,0.10033076074972437
4512,2,1109,929,2038,1.193756727664155
4513,1,45,731,776,0.06155950752393981
4513,2,796,535,1331,1.4878504672897197
4513,3,1350,437,1787,3.0892448512585813
4514,1,15,208,223,0.07211538461538461
4514,2,237,320,557,0.740625
4514,3,605,400,1005,1.5125
4514,4,1223,502,1725,2.4362549800796813
4514,5,1838,521,2359,3.5278310940499042
4514,6,2413,470,2883,5.134042553191489
4514,7,2897,200,3097,14.485
4514,8,3160,257,3417,12.295719844357977
4514,9,3468,540,4008,6.4222222222222225
4514,10,4144,967,5111,4.285418821096174
4514,11,6094,537,6631,11.348230912476723
4515,1,344,1008,1352,0.3412698412698413
4515,2,1365,988,2353,1.381578947368421
4515,3,2366,811,3177,2.917385943279901
4515,4,3181,413,3594,7.702179176755448
4515,5,3611,871,4482,4.145809414466131
4515,6,4498,755,5253,5.957615894039735
4516,1,28,469,497,0.05970149253731343
4516,2,511,616,1127,0.8295454545454546
4516,3,1149,1013,2162,1.134254689042448
4516,4,2178,905,3083,2.4066298342541437
4516,5,3105,967,4072,3.2109617373319543
4516,6,4074,163,4237,24.993865030674847
4516,7,4282,812,5094,5.273399014778325
4516,8,5152,842,5994,6.118764845605701
4516,9,6006,592,6598,10.14527027027027
4516,10,6623,750,7373,8.830666666666668
4517,1,213,474,687,0.44936708860759494
4517,2,697,530,1227,1.3150943396226416
4517,3,1277,464,1741,2.752155172413793
4517,4,1774,546,2320,3.249084249084249
4517,5,2338,560,2898,4.175
4517,6,2912,531,3443,5.483992467043315
4517,7,3450,466,3916,7.4034334763948495
4517,8,3940,523,4463,7.533460803059273
4517,9,4475,478,4953,9.361924686192468
4517,10,4973,551,5524,9.02540834845735
4517,11,5535,509,6044,10.87426326129666
4517,12,6053,555,6608,10.906306306306305
4517,13,6645,372,7017,17.862903225806452
4517,14,7043,421,7464,16.729216152019003
4518,1,54,134,188,0.40298507462686567
4519,1,102,763,865,0.13368283093053734
4520,1,20,441,461,0.045351473922902494
4520,2,477,226,703,2.1106194690265485
4520,3,801,612,1413,1.3088235294117647
4520,4,1445,721,2166,2.0041608876560333
4520,5,2183,909,3092,2.4015401540154016
4521,1,1233,3,1236,411.0
4521,2,1796,3,1799,598.6666666666666
4521,3,2120,3,2123,706.6666666666666
4521,4,2957,51,3008,57.98039215686274
4521,5,3507,67,3574,52.343283582089555
4521,6,5602,136,5738,41.19117647058823
4521,7,5825,3,5828,1941.6666666666667
4521,8,5846,130,5976,44.96923076923077
4521,9,6050,324,6374,18.67283950617284
4521,10,6977,360,7337,19.380555555555556
4521,11,7409,174,7583,42.58045977011494
4521,12,7632,173,7805,44.115606936416185
4522,1,182,402,584,0.4527363184079602
4522,2,587,339,926,1.7315634218289087
4523,1,89,822,911,0.10827250608272507
4523,2,3884,917,4801,4.235550708833151
4523,3,4845,737,5582,6.573948439620081
4524,1,397,835,1232,0.4754491017964072
4524,2,1249,544,1793,2.295955882352941
4524,3,1816,510,2326,3.56078431372549
4525,1,31,646,677,0.047987616099071206
4525,2,689,455,1144,1.5142857142857142
4525,3,1291,424,1715,3.044811320754717
4526,1,13,508,521,0.025590551181102362
4526,2,533,455,988,1.1714285714285715
4527,1,45,945,990,0.047619047619047616
4527,2,1054,315,1369,3.346031746031746
4527,3,2110,42,2152,50.23809523809524
4527,4,2901,179,3080,16.206703910614525
4528,1,911,492,1403,1.8516260162601625
4528,2,1425,389,1814,3.6632390745501286
4528,3,1836,363,2199,5.0578512396694215
4528,4,2223,639,2862,3.4788732394366195
4529,1,131,198,329,0.6616161616161617
4529,2,430,355,785,1.2112676056338028
4529,3,799,175,974,4.565714285714286
4529,4,990,413,1403,2.3970944309927362
4529,5,1437,864,2301,1.6631944444444444
4529,6,2341,779,3120,3.005134788189987
4529,7,3127,213,3340,14.68075117370892
4529,8,3424,232,3656,14.758620689655173
4529,9,3674,322,3996,11.409937888198758
4529,10,4010,169,4179,23.727810650887573
4529,11,4213,127,4340,33.173228346456696
4529,12,4363,460,4823,9.484782608695653
4530,1,224,880,1104,0.2545454545454545
4531,1,101,282,383,0.35815602836879434
4531,2,417,393,810,1.0610687022900764
4531,3,1014,412,1426,2.4611650485436893
4532,1,88,652,740,0.13496932515337423
4532,2,831,778,1609,1.0681233933161953
4532,3,1624,246,1870,6.6016260162601625
4532,4,1887,469,2356,4.023454157782516
4532,5,2372,396,2768,5.98989898989899
4532,6,2808,813,3621,3.4538745387453873
4532,7,3631,874,4505,4.154462242562929
4532,8,4514,516,5030,8.748062015503876
4532,9,5127,814,5941,6.298525798525799
4533,1,17,863,880,0.019698725376593278
4534,1,15,584,599,0.025684931506849314
4534,2,613,619,1232,0.9903069466882067
4535,1,576,457,1033,1.2603938730853392
4535,2,1094,429,1523,2.55011655011655
4535,3,1553,396,1949,3.9217171717171717
4535,4,1978,742,2720,2.665768194070081
4536,1,21,374,395,0.05614973262032086
4536,2,411,309,720,1.3300970873786409
4536,3,760,146,906,5.205479452054795
4536,4,947,619,1566,1.5298869143780292
4536,5,1595,468,2063,3.408119658119658
4536,6,2073,502,2575,4.129482071713148
4536,7,2582,498,3080,5.184738955823293
4536,8,3112,212,3324,14.679245283018869
4537,1,1898,640,2538,2.965625
4537,2,2554,214,2768,11.934579439252337
4537,3,2780,186,2966,14.946236559139784
4537,4,2973,202,3175,14.717821782178218
4537,5,3188,368,3556,8.66304347826087
4538,1,35,116,151,0.3017241379310345
4538,2,193,113,306,1.7079646017699115
4538,3,326,104,430,3.1346153846153846
4538,4,462,109,571,4.238532110091743
4539,1,40,617,657,0.06482982171799027
4539,2,661,295,956,2.240677966101695
4540,1,22,391,413,0.056265984654731455
4540,2,424,540,964,0.7851851851851852
4540,3,970,802,1772,1.2094763092269327
4540,4,1775,711,2486,2.4964838255977497
4541,1,34,409,443,0.08312958435207823
4541,2,453,450,903,1.0066666666666666
4541,3,918,204,1122,4.5
4541,4,1141,268,1409,4.257462686567164
4541,5,1433,412,1845,3.4781553398058254
4541,6,1864,363,2227,5.134986225895317
4541,7,2250,350,2600,6.428571428571429
4541,8,2630,119,2749,22.100840336134453
4541,9,2764,184,2948,15.021739130434783
4542,1,2220,631,2851,3.5182250396196513
4543,1,24,1040,1064,0.023076923076923078
4543,2,1123,1232,2355,0.911525974025974
4544,1,164,904,1068,0.18141592920353983
4544,2,1256,909,2165,1.3817381738173817
4544,3,2353,916,3269,2.5687772925764194
4544,4,3291,926,4217,3.5539956803455723
4544,5,4362,906,5268,4.814569536423841
4544,6,5378,509,5887,10.56581532416503
4544,7,5948,473,6421,12.575052854122621
4544,8,6561,539,7100,12.172541743970315
4544,9,7365,508,7873,14.498031496062993
4544,10,7923,86,8009,92.12790697674419
4544,11,8018,87,8105,92.16091954022988
4545,1,262,105,367,2.4952380952380953
4545,2,1197,231,1428,5.181818181818182
4545,3,1434,148,1582,9.68918918918919
4545,4,1588,302,1890,5.258278145695364
4545,5,1896,415,2311,4.5686746987951805
4545,6,2317,552,2869,4.197463768115942
4545,7,2875,541,3416,5.314232902033272
4545,8,3423,437,3860,7.832951945080092
4545,9,3868,577,4445,6.703639514731369
4545,10,4452,610,5062,7.298360655737705
4545,11,5068,700,5768,7.24
4545,12,5778,634,6412,9.113564668769715
4545,13,6430,788,7218,8.15989847715736
4545,14,7224,779,8003,9.273427471116817
4546,1,249,973,1222,0.25590955806783144
4546,2,1232,420,1652,2.933333333333333
4546,3,1666,525,2191,3.1733333333333333
4546,4,2231,723,2954,3.0857538035961274
4547,1,28,278,306,0.10071942446043165
4547,2,329,299,628,1.100334448160535
4547,3,672,397,1069,1.6926952141057934
4547,4,1090,321,1411,3.3956386292834893
4547,5,1440,208,1648,6.923076923076923
4547,6,1683,222,1905,7.581081081081081
4547,7,1929,271,2200,7.118081180811808
4547,8,2224,325,2549,6.843076923076923
4548,1,32,104,136,0.3076923076923077
4548,2,145,212,357,0.6839622641509434
4548,3,365,146,511,2.5
4548,4,528,96,624,5.5
4548,5,632,251,883,2.5179282868525896
4548,6,890,199,1089,4.472361809045226
4548,7,1101,174,1275,6.327586206896552
4549,1,11,474,485,0.023206751054852322
4550,1,36,63,99,0.5714285714285714
4550,2,166,850,1016,0.1952941176470588
4550,3,2474,921,3395,2.6862106406080346
4550,4,3397,899,4296,3.778642936596218
4550,5,4298,918,5216,4.681917211328976
4550,6,5218,284,5502,18.37323943661972
4551,1,32,676,708,0.047337278106508875
4551,2,720,492,1212,1.4634146341463414
4551,3,1250,632,1882,1.9778481012658229
4551,4,1905,423,2328,4.50354609929078
4551,5,2368,635,3003,3.7291338582677165
4551,6,3013,504,3517,5.978174603174603
4551,7,3571,650,4221,5.493846153846154
4551,8,4257,797,5054,5.341279799247177
4551,9,5085,675,5760,7.533333333333333
4551,10,5857,756,6613,7.747354497354498
4551,11,6713,844,7557,7.953791469194313
4551,12,7560,28,7588,270.0
4552,1,206,437,643,0.47139588100686497
4552,2,691,242,933,2.855371900826446
4552,3,1014,466,1480,2.1759656652360513
4552,4,1490,214,1704,6.962616822429907
4552,5,1733,263,1996,6.5893536121673
4552,6,2031,246,2277,8.25609756097561
4552,7,2299,245,2544,9.383673469387755
4553,1,162,748,910,0.21657754010695188
4554,1,13,330,343,0.03939393939393939
4554,2,367,574,941,0.6393728222996515
4554,3,967,697,1664,1.387374461979914
4554,4,1800,761,2561,2.3653088042049935
4554,5,2570,49,2619,52.44897959183673
4555,1,19,501,520,0.03792415169660679
4555,2,542,606,1148,0.8943894389438944
4555,3,1165,591,1756,1.9712351945854485
4556,1,128,469,597,0.27292110874200426
4556,2,712,415,1127,1.7156626506024097
4556,3,1171,373,1544,3.1394101876675604
4556,4,1603,552,2155,2.903985507246377
4556,5,2195,481,2676,4.5634095634095635
4556,6,2721,531,3252,5.124293785310734
4556,7,3264,437,3701,7.469107551487414
4556,8,3785,612,4397,6.184640522875817
4556,9,4424,496,4920,8.919354838709678
4556,10,4980,402,5382,12.388059701492537
4556,11,5421,477,5898,11.364779874213836
4556,12,5928,463,6391,12.803455723542116
4556,13,6626,496,7122,13.358870967741936
4556,14,7143,433,7576,16.496535796766743
4556,15,7599,470,8069,16.16808510638298
4557,1,684,702,1386,0.9743589743589743
4557,2,1463,67,1530,21.83582089552239
4557,3,1594,31,1625,51.41935483870968
4557,4,1690,182,1872,9.285714285714286
4557,5,1881,635,2516,2.9622047244094487
4557,6,2525,401,2926,6.296758104738155
4558,1,30,378,408,0.07936507936507936
4558,2,420,226,646,1.8584070796460177
4558,3,676,432,1108,1.5648148148148149
4558,4,1157,637,1794,1.816326530612245
4558,5,1813,381,2194,4.758530183727034
4558,6,2235,506,2741,4.41699604743083
4558,7,2805,493,3298,5.689655172413793
4558,8,3333,648,3981,5.143518518518518
4558,9,3995,973,4968,4.105858170606372
4558,10,4970,118,5088,42.11864406779661
4558,11,5109,504,5613,10.136904761904763
4558,12,5625,691,6316,8.140376266280752
4558,13,6335,855,7190,7.409356725146199
4558,14,7192,81,7273,88.79012345679013
4559,1,775,442,1217,1.753393665158371
4560,1,93,764,857,0.12172774869109948
4560,2,903,1047,1950,0.8624641833810889
4560,3,1958,338,2296,5.792899408284024
4561,1,62,601,663,0.10316139767054909
4561,2,732,764,1496,0.9581151832460733
4561,3,1511,68,1579,22.220588235294116
4561,4,1619,523,2142,3.095602294455067
4561,5,2210,650,2860,3.4
4561,6,2938,676,3614,4.346153846153846
4561,7,3650,536,4186,6.809701492537314
4561,8,4197,418,4615,10.04066985645933
4561,9,4618,367,4985,12.583106267029972
4561,10,5000,95,5095,52.63157894736842
4561,11,5135,390,5525,13.166666666666666
4561,12,5528,309,5837,17.889967637540455
4561,13,5841,76,5917,76.85526315789474
4561,14,5922,136,6058,43.544117647058826
4562,1,258,509,767,0.5068762278978389
4562,2,1041,518,1559,2.0096525096525095
4563,1,238,322,560,0.7391304347826086
4563,2,717,597,1314,1.2010050251256281
4563,3,3707,416,4123,8.911057692307692
4564,1,60,973,1033,0.06166495375128469
4564,2,1035,561,1596,1.8449197860962567
4565,1,128,745,873,0.17181208053691274
4565,2,897,289,1186,3.1038062283737022
4565,3,1216,603,1819,2.0165837479270317
4566,1,17,606,623,0.028052805280528052
4567,1,38,659,697,0.057663125948406675
4567,2,740,766,1506,0.9660574412532638
4568,1,64,425,489,0.15058823529411763
4568,2,523,428,951,1.22196261682243
4569,1,24,647,671,0.03709428129829984
4569,2,692,283,975,2.4452296819787986
4570,1,18,600,618,0.03
4570,2,637,676,1313,0.9423076923076923
4571,1,18,320,338,0.05625
4571,2,1347,997,2344,1.3510531594784354
4571,3,2388,1053,3441,2.2678062678062676
4572,1,46,878,924,0.05239179954441914
4572,2,937,1018,1955,0.9204322200392927
4573,1,53,506,559,0.10474308300395258
4573,2,581,517,1098,1.1237911025145069
4574,1,25,399,424,0.06265664160401002
4575,1,48,877,925,0.05473204104903079
4575,2,993,733,1726,1.354706684856753
4576,1,36,773,809,0.04657179818887452
4577,1,16,598,614,0.026755852842809364
4577,2,630,569,1199,1.1072056239015817
4578,1,511,2,513,255.5
4579,1,351,426,777,0.823943661971831
4579,2,820,426,1246,1.9248826291079812
4579,3,1268,336,1604,3.7738095238095237
4580,1,19,285,304,0.06666666666666667
4580,2,316,140,456,2.257142857142857
4580,3,469,102,571,4.598039215686274
4580,4,597,472,1069,1.2648305084745763
4580,5,1116,341,1457,3.272727272727273
4580,6,1504,708,2212,2.1242937853107344
4580,7,2270,826,3096,2.74818401937046
4580,8,3120,775,3895,4.025806451612903
4581,1,258,526,784,0.49049429657794674
4581,2,794,546,1340,1.4542124542124542
4582,1,107,432,539,0.24768518518518517
4582,2,553,348,901,1.589080459770115
4582,3,914,46,960,19.869565217391305
4583,1,495,4,499,123.75
4583,2,2940,4,2944,735.0
4583,3,5636,4,5640,1409.0
4583,4,5680,232,5912,24.482758620689655
4583,5,5953,256,6209,23.25390625
4583,6,6242,703,6945,8.879089615931722
4584,1,54,365,419,0.14794520547945206
4584,2,443,564,1007,0.7854609929078015
4584,3,1023,497,1520,2.058350100603622
4584,4,1539,660,2199,2.331818181818182
4584,5,2213,378,2591,5.854497354497354
4584,6,2610,587,3197,4.4463373083475295
4584,7,3266,703,3969,4.6458036984352775
4584,8,3987,663,4650,6.013574660633484
4585,1,151,844,995,0.17890995260663506
4585,2,1011,217,1228,4.658986175115207
4585,3,1252,861,2113,1.454123112659698
4586,1,159,340,499,0.4676470588235294
4586,2,523,811,1334,0.6448828606658447
4586,3,1350,963,2313,1.4018691588785046
4586,4,2346,962,3308,2.4386694386694385
4586,5,3321,605,3926,5.489256198347108
4587,1,142,84,226,1.6904761904761905
4588,1,87,726,813,0.11983471074380166
4588,2,876,595,1471,1.4722689075630253
4588,3,1521,991,2512,1.5348133198789102
4589,1,15,575,590,0.02608695652173913
4590,1,352,962,1314,0.3659043659043659
4590,2,1327,619,1946,2.1437802907915993
4590,3,1958,303,2261,6.462046204620462
4590,4,2285,797,3082,2.867001254705144
4590,5,3103,634,3737,4.894321766561514
4590,6,3761,941,4702,3.9968119022316686
4590,7,4715,278,4993,16.96043165467626
4590,8,5013,126,5139,39.785714285714285
4590,9,5153,136,5289,37.88970588235294
4590,10,5414,263,5677,20.58555133079848
4590,11,5803,265,6068,21.89811320754717
4590,12,6091,773,6864,7.879689521345408
4591,1,34,323,357,0.10526315789473684
4591,2,367,474,841,0.7742616033755274
4591,3,857,876,1733,0.978310502283105
4591,4,1769,632,2401,2.7990506329113924
4591,5,2421,957,3378,2.529780564263323
4591,6,3396,1000,4396,3.396
4591,7,4405,419,4824,10.513126491646778
4591,8,4830,489,5319,9.877300613496933
4591,9,5339,338,5677,15.79585798816568
4591,10,5703,972,6675,5.867283950617284
4591,11,6700,360,7060,18.61111111111111
4591,12,7075,669,7744,10.575485799701047
4592,1,23,550,573,0.04181818181818182
4592,2,585,595,1180,0.9831932773109243
4592,3,1190,718,1908,1.6573816155988859
4593,1,13,690,703,0.01884057971014493
4593,2,712,620,1332,1.1483870967741936
4594,1,44,608,652,0.07236842105263158
4594,2,706,590,1296,1.1966101694915254
4594,3,1306,465,1771,2.8086021505376344
4595,1,172,453,625,0.37969094922737306
4595,2,628,429,1057,1.4638694638694638
4595,3,1060,382,1442,2.774869109947644
4595,4,1445,378,1823,3.822751322751323
4595,5,1826,350,2176,5.217142857142857
4595,6,2222,330,2552,6.733333333333333
4595,7,2555,255,2810,10.019607843137255
4595,8,2813,395,3208,7.121518987341772
4595,9,3211,365,3576,8.797260273972602
4595,10,3599,374,3973,9.622994652406417
4595,11,3976,421,4397,9.44418052256532
4595,12,4400,350,4750,12.571428571428571
4595,13,4753,383,5136,12.409921671018276
4595,14,5184,321,5505,16.149532710280372
4595,15,5508,381,5889,14.456692913385826
4595,16,5892,365,6257,16.14246575342466
4595,17,6260,360,6620,17.38888888888889
4595,18,6623,426,7049,15.546948356807512
4595,19,7090,261,7351,27.164750957854405
4595,20,7393,259,7652,28.544401544401545
4595,21,7655,375,8030,20.413333333333334
4596,1,154,683,837,0.22547584187408493
4597,1,15,731,746,0.02051983584131327
4598,1,5,495,500,0.010101010101010102
4599,1,12,345,357,0.034782608695652174
4599,2,370,108,478,3.425925925925926
4599,3,486,286,772,1.6993006993006994
4599,4,784,122,906,6.426229508196721
4599,5,987,373,1360,2.6461126005361932
4599,6,1383,268,1651,5.16044776119403
4599,7,1658,169,1827,9.810650887573965
4599,8,1852,254,2106,7.291338582677166
4599,9,2139,469,2608,4.560767590618337
4599,10,2614,313,2927,8.351437699680512
4599,11,2941,359,3300,8.192200557103064
4599,12,3314,196,3510,16.908163265306122
4599,13,3541,390,3931,9.07948717948718
4599,14,3947,372,4319,10.61021505376344
4599,15,4334,302,4636,14.350993377483444
4599,16,4680,483,5163,9.68944099378882
4599,17,5172,255,5427,20.28235294117647
4599,18,5443,527,5970,10.328273244781784
4599,19,5975,81,6056,73.76543209876543
4600,1,3315,330,3645,10.045454545454545
4600,2,3671,116,3787,31.646551724137932
4600,3,3807,199,4006,19.13065326633166
4600,4,4021,187,4208,21.502673796791445
4600,5,4220,45,4265,93.77777777777777
4600,6,4292,84,4376,51.095238095238095
4601,1,247,674,921,0.3664688427299703
4601,2,930,590,1520,1.576271186440678
4601,3,1531,441,1972,3.4716553287981857
4601,4,2043,615,2658,3.321951219512195
4601,5,2667,604,3271,4.4155629139072845
4601,6,3376,577,3953,5.8509532062391685
4601,7,3981,623,4604,6.390048154093098
4601,8,4648,636,5284,7.3081761006289305
4601,9,5312,855,6167,6.212865497076024
4601,10,6198,797,6995,7.776662484316185
4601,11,7009,213,7222,32.906103286384976
4601,12,7238,410,7648,17.653658536585365
4601,13,7656,280,7936,27.34285714285714
4602,1,26,1894,1920,0.013727560718057022
4602,2,1988,2290,4278,0.868122270742358
4603,1,13,97,110,0.13402061855670103
4603,2,1569,721,2290,2.176144244105409
4603,3,2336,573,2909,4.076788830715532
4603,4,2952,354,3306,8.338983050847459
4603,5,3413,465,3878,7.339784946236559
4603,6,3919,1061,4980,3.6936852026390197
4604,1,37,647,684,0.0571870170015456
4605,1,41,601,642,0.06821963394342762
4605,2,661,596,1257,1.1090604026845639
4605,3,1275,527,1802,2.4193548387096775
4605,4,1829,931,2760,1.9645542427497316
4605,5,2762,391,3153,7.063938618925831
4605,6,3155,475,3630,6.6421052631578945
4606,1,83,497,580,0.16700201207243462
4607,1,48,814,862,0.05896805896805897
4608,1,44,545,589,0.08073394495412844
4608,2,620,743,1363,0.8344549125168237
4608,3,1391,845,2236,1.646153846153846
4608,4,2249,867,3116,2.594002306805075
4608,5,3135,625,3760,5.016
4608,6,3773,964,4737,3.913900414937759
4609,1,36,114,150,0.3157894736842105
4610,1,195,375,570,0.52
4610,2,572,362,934,1.580110497237569
4610,3,936,193,1129,4.849740932642487
4610,4,1173,392,1565,2.99234693877551
4610,5,1567,429,1996,3.652680652680653
4610,6,1998,75,2073,26.64
4610,7,2094,403,2497,5.196029776674938
4610,8,2501,418,2919,5.983253588516747
4610,9,2944,442,3386,6.660633484162896
4610,10,3388,395,3783,8.577215189873417
4610,11,3785,192,3977,19.713541666666668
4610,12,4011,375,4386,10.696
4611,1,32,544,576,0.058823529411764705
4612,1,37,635,672,0.05826771653543307
4613,1,841,319,1160,2.6363636363636362
4613,2,2072,71,2143,29.183098591549296
4613,3,2213,561,2774,3.944741532976827
4613,4,2811,610,3421,4.608196721311476
4613,5,3453,659,4112,5.239757207890744
4614,1,9,73,82,0.1232876712328767
4615,1,54,229,283,0.23580786026200873
4615,2,294,184,478,1.5978260869565217
4615,3,489,244,733,2.0040983606557377
4615,4,741,288,1029,2.5729166666666665
4615,5,1037,298,1335,3.4798657718120807
4615,6,1343,353,1696,3.8045325779036827
4615,7,1704,319,2023,5.341692789968652
4615,8,2031,340,2371,5.973529411764706
4615,9,2379,343,2722,6.9358600583090375
4615,10,2730,354,3084,7.711864406779661
4615,11,3092,399,3491,7.74937343358396
4615,12,3499,422,3921,8.291469194312796
4615,13,3929,379,4308,10.366754617414248
4615,14,4311,424,4735,10.16745283018868
4615,15,4738,458,5196,10.344978165938864
4615,16,5199,416,5615,12.497596153846153
4615,17,5618,433,6051,12.97459584295612
4615,18,6054,445,6499,13.604494382022471
4615,19,6502,487,6989,13.351129363449692
4615,20,6992,476,7468,14.6890756302521
4615,21,7471,519,7990,14.394990366088631
4616,1,18,1203,1221,0.014962593516209476
4617,1,61,419,480,0.14558472553699284
4618,1,177,523,700,0.3384321223709369
4618,2,728,381,1109,1.9107611548556431
4619,1,24,398,422,0.06030150753768844
4620,1,148,1789,1937,0.08272778088317496
4620,2,1980,770,2750,2.5714285714285716
4620,3,2773,785,3558,3.532484076433121
4620,4,3578,731,4309,4.894664842681259
4620,5,4337,756,5093,5.7367724867724865
4620,6,5165,522,5687,9.89463601532567
4620,7,5717,900,6617,6.352222222222222
4620,8,6662,768,7430,8.674479166666666
4621,1,86,81,167,1.0617283950617284
4621,2,194,756,950,0.2566137566137566
4621,3,972,758,1730,1.2823218997361479
4622,1,44,382,426,0.11518324607329843
4623,1,30,188,218,0.1595744680851064
4623,2,236,376,612,0.6276595744680851
4624,1,181,29,210,6.241379310344827
4624,2,2135,431,2566,4.953596287703016
4625,1,24,329,353,0.0729483282674772
4625,2,369,653,1022,0.5650842266462481
4625,3,1127,818,1945,1.3777506112469438
4625,4,1959,838,2797,2.337708830548926
4625,5,2812,977,3789,2.878198567041965
4625,6,3820,253,4073,15.098814229249012
4625,7,4091,95,4186,43.06315789473684
4625,8,4190,45,4235,93.11111111111111
4625,9,4262,357,4619,11.938375350140056
4625,10,4647,648,5295,7.171296296296297
4625,11,5306,1103,6409,4.810516772438803
4625,12,6438,353,6791,18.237960339943342
4625,13,6799,54,6853,125.9074074074074
4626,1,88,970,1058,0.09072164948453608
4627,1,8,309,317,0.025889967637540454
4627,2,327,553,880,0.5913200723327305
4627,3,898,416,1314,2.1586538461538463
4627,4,1372,200,1572,6.86
4628,1,60,729,789,0.0823045267489712
4628,2,2065,619,2684,3.3360258481421647
4629,1,18,55,73,0.32727272727272727
4629,2,109,628,737,0.1735668789808917
4629,3,752,946,1698,0.7949260042283298
4629,4,1706,232,1938,7.353448275862069
4630,1,39,588,627,0.0663265306122449
4631,1,26,100,126,0.26
4631,2,402,891,1293,0.4511784511784512
4631,3,1371,692,2063,1.98121387283237
4631,4,2346,793,3139,2.9583858764186632
4631,5,3240,371,3611,8.733153638814017
4631,6,3681,394,4075,9.342639593908629
4631,7,4174,872,5046,4.786697247706422
4631,8,5190,862,6052,6.020881670533643
4631,9,6137,944,7081,6.501059322033898
4632,1,39,391,430,0.09974424552429667
4632,2,443,295,738,1.5016949152542374
4632,3,755,281,1036,2.6868327402135233
4633,1,88,141,229,0.624113475177305
4633,2,251,145,396,1.7310344827586206
4633,3,400,133,533,3.007518796992481
4633,4,560,133,693,4.2105263157894735
4633,5,711,146,857,4.86986301369863
4633,6,869,147,1016,5.91156462585034
4633,7,1028,246,1274,4.178861788617886
4633,8,1281,135,1416,9.488888888888889
4633,9,1423,131,1554,10.86259541984733
4634,1,895,614,1509,1.4576547231270358
4634,2,1539,884,2423,1.740950226244344
4634,3,2494,807,3301,3.090458488228005
4635,1,42,915,957,0.04590163934426229
4635,2,960,504,1464,1.9047619047619047
4635,3,1631,869,2500,1.8768699654775605
4635,4,2521,731,3252,3.4487004103967167
4635,5,3292,542,3834,6.07380073800738
4635,6,3880,503,4383,7.713717693836978
4635,7,4437,531,4968,8.35593220338983
4635,8,6051,704,6755,8.595170454545455
4636,1,335,873,1208,0.3837342497136312
4636,2,1245,900,2145,1.3833333333333333
4637,1,135,573,708,0.2356020942408377
4637,2,730,381,1111,1.916010498687664
4637,3,1115,412,1527,2.7063106796116503
4637,4,1565,388,1953,4.033505154639175
4637,5,1956,428,2384,4.570093457943925
4637,6,2387,94,2481,25.393617021276597
4638,1,6,82,88,0.07317073170731707
4638,2,101,102,203,0.9901960784313726
4638,3,220,190,410,1.1578947368421053
4639,1,99,192,291,0.515625
4639,2,312,436,748,0.7155963302752294
4640,1,13,188,201,0.06914893617021277
4640,2,214,124,338,1.7258064516129032
4640,3,365,292,657,1.25
4640,4,698,441,1139,1.582766439909297
4640,5,1247,790,2037,1.5784810126582278
4640,6,2282,271,2553,8.420664206642066
4640,7,2842,616,3458,4.613636363636363
4640,8,3474,60,3534,57.9
4640,9,4243,729,4972,5.820301783264746
4640,10,5247,861,6108,6.094076655052265
4640,11,6206,530,6736,11.709433962264152
4640,12,6847,949,7796,7.214963119072708
4641,1,29,59,88,0.4915254237288136
4641,2,95,112,207,0.8482142857142857
4641,3,216,243,459,0.8888888888888888
4641,4,482,431,913,1.1183294663573087
4642,1,9,101,110,0.0891089108910891
4643,1,14,432,446,0.032407407407407406
4644,1,15,240,255,0.0625
4644,2,285,544,829,0.5238970588235294
4644,3,837,34,871,24.61764705882353
4645,1,741,309,1050,2.3980582524271843
4645,2,1081,254,1335,4.255905511811024
4645,3,1359,303,1662,4.485148514851486
4645,4,1999,282,2281,7.088652482269503
4645,5,2283,287,2570,7.954703832752613
4646,1,14,827,841,0.016928657799274487
4647,1,28,292,320,0.0958904109589041
4647,2,349,567,916,0.6155202821869489
4647,3,939,565,1504,1.6619469026548672
4647,4,1533,640,2173,2.3953125
4648,1,120,785,905,0.15286624203821655
4648,2,942,812,1754,1.1600985221674878
4649,1,8,43,51,0.18604651162790697
4649,2,60,349,409,0.17191977077363896
4649,3,464,498,962,0.9317269076305221
4649,4,1025,285,1310,3.5964912280701755
4649,5,1335,436,1771,3.061926605504587
4649,6,1788,475,2263,3.7642105263157895
4649,7,2347,513,2860,4.57504873294347
4649,8,2933,428,3361,6.852803738317757
4649,9,3397,464,3861,7.321120689655173
4649,10,3980,456,4436,8.728070175438596
4649,11,4515,596,5111,7.575503355704698
4649,12,5120,47,5167,108.93617021276596
4650,1,320,904,1224,0.35398230088495575
4650,2,1429,1023,2452,1.3968719452590421
4650,3,2454,1047,3501,2.343839541547278
4650,4,3503,291,3794,12.037800687285223
4650,5,3910,577,4487,6.776429809358752
4650,6,4588,365,4953,12.56986301369863
4650,7,4976,570,5546,8.72982456140351
4650,8,5578,127,5705,43.92125984251968
4651,1,2624,1099,3723,2.3876251137397633
4652,1,11,30,41,0.36666666666666664
4652,2,44,29,73,1.5172413793103448
4652,3,92,26,118,3.5384615384615383
4652,4,122,29,151,4.206896551724138
4652,5,158,29,187,5.448275862068965
4653,1,112,565,677,0.19823008849557522
4653,2,784,566,1350,1.3851590106007068
4653,3,1367,243,1610,5.625514403292181
4653,4,1637,461,2098,3.5509761388286334
4653,5,2129,772,2901,2.7577720207253886
4654,1,36,865,901,0.04161849710982659
4654,2,931,529,1460,1.7599243856332702
4654,3,1500,576,2076,2.6041666666666665
4654,4,2111,526,2637,4.013307984790875
4654,5,2673,615,3288,4.3463414634146345
4655,1,35,35,70,1.0
4655,2,1902,904,2806,2.103982300884956
4656,1,28,169,197,0.16568047337278108
4657,1,225,673,898,0.3343239227340267
4658,1,128,792,920,0.16161616161616163
4659,1,555,829,1384,0.669481302774427
4659,2,1386,368,1754,3.766304347826087
4660,1,32,347,379,0.09221902017291066
4661,1,74,696,770,0.10632183908045977
4661,2,888,533,1421,1.6660412757973733
4662,1,30,789,819,0.03802281368821293
4663,1,2899,387,3286,7.4909560723514215
4663,2,3288,404,3692,8.138613861386139
4663,3,3767,301,4068,12.514950166112957
4663,4,4070,360,4430,11.305555555555555
4664,1,74,484,558,0.15289256198347106
4664,2,604,523,1127,1.1548757170172084
4664,3,1286,416,1702,3.0913461538461537
4664,4,1791,489,2280,3.6625766871165646
4664,5,2323,556,2879,4.178057553956834
4664,6,3251,506,3757,6.424901185770751
4664,7,3827,502,4329,7.623505976095617
4664,8,4654,574,5228,8.10801393728223
4664,9,5238,556,5794,9.420863309352518
4664,10,5814,76,5890,76.5
4664,11,5992,664,6656,9.024096385542169
4664,12,6679,734,7413,9.099455040871934
4665,1,87,189,276,0.4603174603174603
4666,1,108,293,401,0.36860068259385664
4667,1,1503,421,1924,3.5700712589073635
4667,2,2008,485,2493,4.140206185567011
4667,3,2537,349,2886,7.269340974212034
4667,4,2946,266,3212,11.075187969924812
4667,5,3287,315,3602,10.434920634920635
4667,6,3615,148,3763,24.425675675675677
4667,7,3775,296,4071,12.753378378378379
4667,8,4123,236,4359,17.470338983050848
4667,9,4392,262,4654,16.763358778625953
4667,10,4662,238,4900,19.58823529411765
4667,11,4910,355,5265,13.830985915492958
4667,12,5271,331,5602,15.924471299093655
4667,13,5650,218,5868,25.91743119266055
4668,1,23,487,510,0.04722792607802875
4668,2,526,378,904,1.3915343915343916
4669,1,12,982,994,0.012219959266802444
4669,2,1042,1000,2042,1.042
4669,3,2073,266,2339,7.793233082706767
4669,4,2359,268,2627,8.802238805970148
4669,5,2646,321,2967,8.242990654205608
4669,6,3004,458,3462,6.558951965065503
4669,7,3549,681,4230,5.211453744493392
4670,1,367,901,1268,0.40732519422863483
4670,2,1356,669,2025,2.0269058295964126
4670,3,2207,910,3117,2.425274725274725
4670,4,3307,703,4010,4.704125177809388
4670,5,4082,847,4929,4.819362455726092
4670,6,5119,895,6014,5.719553072625699
4670,7,6102,914,7016,6.6761487964989055
4670,8,7104,340,7444,20.894117647058824
4671,1,17,419,436,0.0405727923627685
4671,2,453,395,848,1.1468354430379746
4671,3,872,437,1309,1.9954233409610984
4671,4,1348,419,1767,3.217183770883055
4671,5,1769,403,2172,4.389578163771712
4671,6,2174,382,2556,5.69109947643979
4671,7,2558,386,2944,6.626943005181347
4671,8,2946,393,3339,7.4961832061068705
4671,9,3341,399,3740,8.3734335839599
4671,10,3742,466,4208,8.030042918454935
4671,11,4210,516,4726,8.15891472868217
4672,1,197,44,241,4.4772727272727275
4672,2,275,55,330,5.0
4672,3,1109,1165,2274,0.951931330472103
4672,4,2352,567,2919,4.148148148148148
4673,1,14,871,885,0.016073478760045924
4673,2,898,837,1735,1.0728793309438471
4673,3,1743,1038,2781,1.6791907514450868
4673,4,2789,477,3266,5.846960167714885
4674,1,21,153,174,0.13725490196078433
4674,2,227,48,275,4.729166666666667
4674,3,342,62,404,5.516129032258065
4674,4,416,59,475,7.0508474576271185
4674,5,504,49,553,10.285714285714286
4674,6,559,27,586,20.703703703703702
4674,7,589,37,626,15.91891891891892
4674,8,642,26,668,24.692307692307693
4674,9,680,117,797,5.811965811965812
4675,1,3013,840,3853,3.586904761904762
4675,2,3871,508,4379,7.6200787401574805
4675,3,6876,513,7389,13.403508771929825
4675,4,7404,679,8083,10.904270986745214
4676,1,342,880,1222,0.3886363636363636
4677,1,61,552,613,0.1105072463768116
4678,1,878,737,1615,1.191316146540027
4678,2,1754,1173,2927,1.495311167945439
4678,3,3218,977,4195,3.293756397134084
4678,4,4357,1333,5690,3.2685671417854465
4679,1,99,549,648,0.18032786885245902
4679,2,683,645,1328,1.0589147286821705
4679,3,1347,488,1835,2.7602459016393444
4679,4,1853,453,2306,4.0905077262693155
4679,5,2344,371,2715,6.318059299191375
4679,6,2741,445,3186,6.159550561797753
4679,7,3222,503,3725,6.405566600397615
4679,8,3834,790,4624,4.853164556962025
4679,9,4643,513,5156,9.050682261208577
4680,1,20,348,368,0.05747126436781609
4680,2,380,541,921,0.7024029574861368
4680,3,940,698,1638,1.346704871060172
4680,4,1653,360,2013,4.591666666666667
4680,5,2022,689,2711,2.934687953555878
4680,6,2725,287,3012,9.494773519163763
4681,1,20,524,544,0.03816793893129771
4681,2,552,599,1151,0.9215358931552587
4682,1,70,465,535,0.15053763440860216
4682,2,563,222,785,2.536036036036036
4682,3,824,142,966,5.802816901408451
4683,1,41,804,845,0.05099502487562189
4683,2,852,412,1264,2.0679611650485437
4683,3,1310,789,2099,1.6603295310519646
4683,4,2151,769,2920,2.7971391417425226
4683,5,2967,666,3633,4.454954954954955
4683,6,3641,669,4310,5.4424514200298955
4683,7,4332,636,4968,6.811320754716981
4684,1,185,324,509,0.5709876543209876
4684,2,535,334,869,1.6017964071856288
4684,3,883,439,1322,2.011389521640091
4685,1,125,360,485,0.3472222222222222
4685,2,609,415,1024,1.4674698795180723
4685,3,1092,98,1190,11.142857142857142
4685,4,1223,80,1303,15.2875
4685,5,1341,102,1443,13.147058823529411
4685,6,1480,86,1566,17.209302325581394
4685,7,1613,102,1715,15.813725490196079
4685,8,1767,108,1875,16.36111111111111
4685,9,1929,116,2045,16.629310344827587
4685,10,2069,178,2247,11.623595505617978
4685,11,2270,82,2352,27.682926829268293
4685,12,2390,108,2498,22.12962962962963
4685,13,2546,102,2648,24.96078431372549
4685,14,2700,114,2814,23.68421052631579
4685,15,2830,60,2890,47.166666666666664
4685,16,2937,124,3061,23.68548387096774
4685,17,3112,126,3238,24.6984126984127
4685,18,3257,264,3521,12.337121212121213
4685,19,3534,446,3980,7.923766816143497
4685,20,3992,17,4009,234.8235294117647
4686,1,53,110,163,0.4818181818181818
4686,2,200,110,310,1.8181818181818181
4686,3,332,112,444,2.9642857142857144
4686,4,453,130,583,3.4846153846153847
4686,5,603,132,735,4.568181818181818
4686,6,749,267,1016,2.805243445692884
4686,7,1034,464,1498,2.228448275862069
4686,8,1524,288,1812,5.291666666666667
4687,1,2443,862,3305,2.8341067285382833
4687,2,3307,853,4160,3.876905041031653
4687,3,4162,549,4711,7.581056466302368
4688,1,2137,624,2761,3.4246794871794872
4688,2,2793,886,3679,3.1523702031602707
4688,3,3726,36,3762,103.5
4688,4,3764,38,3802,99.05263157894737
4689,1,228,247,475,0.9230769230769231
4689,2,513,520,1033,0.9865384615384616
4689,3,1068,360,1428,2.966666666666667
4689,4,1469,791,2260,1.8571428571428572
4690,1,24,636,660,0.03773584905660377
4690,2,691,687,1378,1.0058224163027656
4690,3,1408,582,1990,2.4192439862542954
4690,4,2006,240,2246,8.358333333333333
4690,5,2272,532,2804,4.2706766917293235
4690,6,2826,740,3566,3.8189189189189188
4690,7,3574,390,3964,9.164102564102564
4691,1,269,735,1004,0.3659863945578231
4691,2,1010,771,1781,1.3099870298313878
4691,3,1794,837,2631,2.14336917562724
4692,1,97,641,738,0.15132605304212168
4692,2,763,471,1234,1.6199575371549895
4692,3,1271,537,1808,2.366852886405959
4692,4,1828,775,2603,2.358709677419355
4692,5,2667,865,3532,3.083236994219653
4692,6,3558,629,4187,5.656597774244833
4693,1,1175,154,1329,7.62987012987013
4693,2,2106,466,2572,4.51931330472103
4693,3,2582,496,3078,5.205645161290323
4693,4,3088,608,3696,5.078947368421052
4693,5,3706,506,4212,7.324110671936759
4693,6,4396,456,4852,9.640350877192983
4693,7,4986,473,5459,10.541226215644821
4693,8,5604,189,5793,29.650793650793652
4693,9,5906,221,6127,26.72398190045249
4693,10,6206,248,6454,25.024193548387096
4693,11,6594,245,6839,26.914285714285715
4693,12,7075,451,7526,15.687361419068736
4693,13,7578,322,7900,23.53416149068323
4694,1,1287,472,1759,2.7266949152542375
4694,2,1782,750,2532,2.376
4694,3,2570,693,3263,3.7085137085137085
4694,4,3335,683,4018,4.882869692532943
4694,5,4055,146,4201,27.773972602739725
4694,6,4274,457,4731,9.352297592997811
4695,1,170,407,577,0.4176904176904177
4695,2,579,409,988,1.4156479217603912
4695,3,990,628,1618,1.5764331210191083
4695,4,1626,432,2058,3.763888888888889
4695,5,2412,292,2704,8.26027397260274
4695,6,2737,192,2929,14.255208333333334
4695,7,2955,338,3293,8.742603550295858
4696,1,55,972,1027,0.056584362139917695
4696,2,1054,695,1749,1.516546762589928
4696,3,1766,768,2534,2.2994791666666665
4696,4,2545,747,3292,3.4069611780455156
4696,5,3307,918,4225,3.60239651416122
4696,6,4260,1013,5273,4.20533070088845
4696,7,5288,832,6120,6.355769230769231
4696,8,6148,941,7089,6.533475026567482
4696,9,7100,668,7768,10.62874251497006
4697,1,246,573,819,0.4293193717277487
4697,2,999,681,1680,1.4669603524229076
4697,3,1744,840,2584,2.0761904761904764
4697,4,2616,804,3420,3.253731343283582
4698,1,3082,1086,4168,2.837937384898711
4698,2,4195,578,4773,7.257785467128028
4698,3,4929,1067,5996,4.619493908153702
4698,4,6025,706,6731,8.53399433427762
4699,1,461,702,1163,0.6566951566951567
4700,1,307,454,761,0.6762114537444934
4700,2,777,593,1370,1.3102866779089377
4700,3,1380,318,1698,4.339622641509434
4700,4,1706,500,2206,3.412
4700,5,2216,906,3122,2.445916114790287
4701,1,74,563,637,0.13143872113676733
4702,1,30,847,877,0.03541912632821724
4703,1,104,405,509,0.25679012345679014
4703,2,534,276,810,1.934782608695652
4703,3,835,372,1207,2.2446236559139785
4703,4,1219,382,1601,3.1910994764397906
4703,5,1611,298,1909,5.406040268456376
4704,1,262,117,379,2.2393162393162394
4704,2,937,149,1086,6.2885906040268456
4704,3,1092,283,1375,3.8586572438162543
4704,4,1381,512,1893,2.697265625
4704,5,1899,688,2587,2.760174418604651
4704,6,2593,686,3279,3.7798833819241984
4704,7,3285,935,4220,3.513368983957219
4704,8,4226,662,4888,6.38368580060423
4704,9,4894,797,5691,6.1405269761606025
4704,10,5697,757,6454,7.525759577278732
4704,11,6460,978,7438,6.605316973415133
4705,1,62,64,126,0.96875
4705,2,137,593,730,0.23102866779089376
4706,1,303,48,351,6.3125
4706,2,362,84,446,4.309523809523809
4707,1,541,698,1239,0.7750716332378224
4707,2,1515,782,2297,1.9373401534526855
4707,3,2428,831,3259,2.9217809867629363
4707,4,3401,840,4241,4.048809523809524
4707,5,4363,132,4495,33.053030303030305
4707,6,4513,287,4800,15.724738675958188
4708,1,32,976,1008,0.03278688524590164
4708,2,1018,961,1979,1.0593132154006244
4708,3,1987,466,2453,4.263948497854077
4709,1,91,68,159,1.338235294117647
4709,2,169,168,337,1.005952380952381
4709,3,574,118,692,4.864406779661017
4709,4,706,244,950,2.8934426229508197
4709,5,984,250,1234,3.936
4709,6,1582,211,1793,7.497630331753554
4709,7,1823,210,2033,8.68095238095238
4709,8,2091,269,2360,7.773234200743494
4709,9,2381,270,2651,8.818518518518518
4709,10,2660,196,2856,13.571428571428571
4710,1,42,395,437,0.10632911392405063
4710,2,637,861,1498,0.7398373983739838
4711,1,18,388,406,0.04639175257731959
4711,2,415,131,546,3.16793893129771
4711,3,553,213,766,2.596244131455399
4712,1,21,327,348,0.06422018348623854
4712,2,351,338,689,1.0384615384615385
4713,1,63,565,628,0.11150442477876106
4713,2,665,856,1521,0.7768691588785047
4714,1,201,111,312,1.8108108108108107
4714,2,315,110,425,2.8636363636363638
4714,3,428,173,601,2.4739884393063583
4714,4,604,125,729,4.832
4715,1,2994,928,3922,3.226293103448276
4716,1,578,513,1091,1.1267056530214425
4716,2,1866,30,1896,62.2
4716,3,5396,1404,6800,3.843304843304843
4717,1,45,651,696,0.06912442396313365
4717,2,742,553,1295,1.3417721518987342
4717,3,1358,637,1995,2.131868131868132
4717,4,2048,884,2932,2.316742081447964
4717,5,2990,477,3467,6.268343815513627
4717,6,3475,529,4004,6.568998109640832
4717,7,4131,926,5057,4.461123110151188
4717,8,5090,821,5911,6.199756394640682
4717,9,5981,783,6764,7.638569604086846
4717,10,6797,891,7688,7.628507295173962
4718,1,986,9,995,109.55555555555556
4718,2,1516,275,1791,5.512727272727273
4719,1,459,117,576,3.923076923076923
4720,1,888,345,1233,2.5739130434782607
4720,2,1237,244,1481,5.069672131147541
4721,1,158,3,161,52.666666666666664
4722,1,16,26,42,0.6153846153846154
4722,2,51,8,59,6.375
4722,3,73,28,101,2.607142857142857
4722,4,110,47,157,2.3404255319148937
4722,5,173,26,199,6.653846153846154
4722,6,256,70,326,3.657142857142857
4722,7,341,8,349,42.625
4722,8,358,8,366,44.75
4722,9,375,46,421,8.152173913043478
4722,10,430,16,446,26.875
4723,1,79,920,999,0.08586956521739131
4723,2,1007,637,1644,1.5808477237048666
4724,1,19,332,351,0.0572289156626506
4724,2,409,1017,1426,0.40216322517207476
4724,3,1528,728,2256,2.098901098901099
4724,4,2389,624,3013,3.828525641025641
4724,5,3053,625,3678,4.8848
4725,1,91,608,699,0.14967105263157895
4725,2,716,390,1106,1.8358974358974358
4725,3,1122,363,1485,3.090909090909091
4725,4,1500,612,2112,2.450980392156863
4725,5,2180,698,2878,3.1232091690544412
4725,6,2899,816,3715,3.5526960784313726
4725,7,3824,964,4788,3.966804979253112
4725,8,4796,123,4919,38.99186991869919
4725,9,5010,994,6004,5.040241448692153
4725,10,6012,3,6015,2004.0
4726,1,72,838,910,0.08591885441527446
4726,2,922,758,1680,1.2163588390501319
4726,3,1699,887,2586,1.9154453213077791
4726,4,2637,987,3624,2.6717325227963524
4727,1,49,118,167,0.4152542372881356
4727,2,1723,416,2139,4.141826923076923
4727,3,2170,179,2349,12.12290502793296
4727,4,2358,328,2686,7.189024390243903
4727,5,2723,109,2832,24.98165137614679
4727,6,2865,353,3218,8.11614730878187
4727,7,3235,178,3413,18.174157303370787
4727,8,3426,229,3655,14.960698689956331
4727,9,3682,381,4063,9.664041994750656
4727,10,4071,189,4260,21.53968253968254
4727,11,4278,259,4537,16.517374517374517
4727,12,4553,228,4781,19.969298245614034
4727,13,4798,233,5031,20.59227467811159
4727,14,5039,258,5297,19.531007751937985
4727,15,5321,164,5485,32.44512195121951
4727,16,5494,228,5722,24.096491228070175
4727,17,5732,249,5981,23.02008032128514
4727,18,5997,320,6317,18.740625
4727,19,6358,328,6686,19.384146341463413
4727,20,6701,414,7115,16.185990338164252
4727,21,7148,274,7422,26.087591240875913
4727,22,7435,272,7707,27.334558823529413
4727,23,7741,260,8001,29.773076923076925
4728,1,195,610,805,0.319672131147541
4728,2,824,754,1578,1.0928381962864722
4728,3,1600,653,2253,2.450229709035222
4728,4,2278,747,3025,3.0495314591700136
4728,5,3041,1072,4113,2.8367537313432836
4728,6,4120,288,4408,14.305555555555555
4729,1,1030,551,1581,1.8693284936479129
4729,2,1587,754,2341,2.1047745358090184
4730,1,20,810,830,0.024691358024691357
4731,1,145,546,691,0.26556776556776557
4731,2,709,684,1393,1.036549707602339
4731,3,1403,512,1915,2.740234375
4731,4,1928,570,2498,3.382456140350877
4731,5,2513,745,3258,3.3731543624161073
4732,1,430,1018,1448,0.4223968565815324
4733,1,60,558,618,0.10752688172043011
4733,2,635,1388,2023,0.45749279538904897
4733,3,2067,506,2573,4.08498023715415
4733,4,2595,498,3093,5.210843373493976
4734,1,22,312,334,0.07051282051282051
4734,2,342,830,1172,0.41204819277108434
4734,3,1324,861,2185,1.537746806039489
4734,4,2229,918,3147,2.4281045751633985
4734,5,3218,858,4076,3.7505827505827507
4734,6,4218,822,5040,5.131386861313868
4734,7,5102,982,6084,5.1955193482688395
4734,8,6092,823,6915,7.402187120291616
4734,9,6953,917,7870,7.582333696837513
4735,1,346,667,1013,0.5187406296851574
4735,2,1101,884,1985,1.245475113122172
4735,3,2107,699,2806,3.0143061516452074
4736,1,176,509,685,0.34577603143418467
4736,2,722,360,1082,2.0055555555555555
4737,1,1204,650,1854,1.8523076923076922
4737,2,2317,337,2654,6.8753709198813056
4737,3,2668,334,3002,7.9880239520958085
4737,4,3053,604,3657,5.054635761589404
4737,5,3686,618,4304,5.964401294498382
4737,6,5653,395,6048,14.311392405063291
4737,7,6197,176,6373,35.21022727272727
4737,8,7713,65,7778,118.66153846153846
4737,9,7783,48,7831,162.14583333333334
4738,1,60,62,122,0.967741935483871
4738,2,232,91,323,2.5494505494505493
4738,3,342,72,414,4.75
4738,4,1240,93,1333,13.333333333333334
4738,5,2000,66,2066,30.303030303030305
4738,6,2255,96,2351,23.489583333333332
4738,7,2377,267,2644,8.902621722846442
4738,8,4086,364,4450,11.225274725274724
4738,9,4504,352,4856,12.795454545454545
4738,10,5076,505,5581,10.051485148514852
4738,11,5622,50,5672,112.44
4738,12,6037,195,6232,30.95897435897436
4738,13,6347,84,6431,75.55952380952381
4738,14,6664,133,6797,50.10526315789474
4738,15,7260,138,7398,52.608695652173914
4738,16,7461,139,7600,53.67625899280576
4739,1,62,56,118,1.1071428571428572
4739,2,206,404,610,0.5099009900990099
4740,1,39,480,519,0.08125
4740,2,533,683,1216,0.780380673499268
4740,3,1238,676,1914,1.831360946745562
4740,4,1958,759,2717,2.579710144927536
4740,5,2738,423,3161,6.472813238770685
4741,1,24,451,475,0.05321507760532151
4741,2,489,659,1148,0.7420333839150227
4741,3,1210,329,1539,3.6778115501519757
4741,4,1559,349,1908,4.467048710601719
4741,5,1928,334,2262,5.772455089820359
4742,1,156,27,183,5.777777777777778
4742,2,1974,28,2002,70.5
4742,3,2080,259,2339,8.03088803088803
4742,4,2380,240,2620,9.916666666666666
4742,5,2633,213,2846,12.36150234741784
4742,6,2860,243,3103,11.76954732510288
4742,7,3115,230,3345,13.543478260869565
4742,8,3350,381,3731,8.79265091863517
4743,1,457,843,1300,0.5421115065243179
4744,1,79,875,954,0.09028571428571429
4744,2,972,1053,2025,0.9230769230769231
4744,3,2141,1112,3253,1.9253597122302157
4744,4,3271,877,4148,3.7297605473204105
4744,5,4328,1008,5336,4.2936507936507935
4744,6,5354,1063,6417,5.036688617121355
4744,7,6425,303,6728,21.204620462046204
4744,8,6762,715,7477,9.457342657342657
4745,1,63,967,1030,0.06514994829369183
4745,2,1037,346,1383,2.9971098265895955
4746,1,196,573,769,0.34205933682373474
4746,2,782,911,1693,0.858397365532382
4746,3,1703,732,2435,2.3265027322404372
4747,1,46,979,1025,0.04698672114402452
4747,2,1036,416,1452,2.4903846153846154
4747,3,1478,603,2081,2.451077943615257
4747,4,2108,624,2732,3.378205128205128
4747,5,2756,585,3341,4.711111111111111
4747,6,3367,590,3957,5.706779661016949
4747,7,3973,467,4440,8.507494646680943
4748,1,1435,334,1769,4.296407185628743
4749,1,118,177,295,0.6666666666666666
4750,1,1108,313,1421,3.5399361022364215
4750,2,1467,338,1805,4.340236686390533
4750,3,1865,346,2211,5.390173410404624
4750,4,2285,343,2628,6.661807580174927
4750,5,2708,390,3098,6.943589743589744
4750,6,3132,103,3235,30.40776699029126
4750,7,3257,805,4062,4.0459627329192545
4750,8,4064,734,4798,5.536784741144414
4751,1,70,614,684,0.11400651465798045
4752,1,17,359,376,0.04735376044568245
4753,1,1371,356,1727,3.851123595505618
4753,2,1734,224,1958,7.741071428571429
4753,3,1995,310,2305,6.435483870967742
4753,4,2324,448,2772,5.1875
4753,5,2791,472,3263,5.913135593220339
4753,6,3282,465,3747,7.058064516129032
4753,7,3766,513,4279,7.341130604288499
4753,8,4325,450,4775,9.61111111111111
4753,9,4790,410,5200,11.682926829268293
4753,10,5210,40,5250,130.25
4754,1,27,132,159,0.20454545454545456
4754,2,174,32,206,5.4375
4755,1,1037,448,1485,2.314732142857143
4755,2,1502,713,2215,2.1065918653576436
4755,3,2235,477,2712,4.685534591194968
4755,4,2719,501,3220,5.4271457085828345
4755,5,3235,269,3504,12.026022304832713
4755,6,3515,794,4309,4.426952141057934
4755,7,4320,493,4813,8.762677484787018
4755,8,4818,229,5047,21.03930131004367
4756,1,42,422,464,0.0995260663507109
4756,2,500,376,876,1.3297872340425532
4757,1,944,706,1650,1.3371104815864023
4757,2,1662,728,2390,2.282967032967033
4758,1,35,467,502,0.07494646680942184
4758,2,516,404,920,1.2772277227722773
4758,3,947,453,1400,2.0905077262693155
4759,1,25,188,213,0.13297872340425532
4759,2,2275,1000,3275,2.275
4759,3,3953,645,4598,6.1286821705426355
4760,1,9,64,73,0.140625
4760,2,87,75,162,1.16
4760,3,1246,334,1580,3.730538922155689
4760,4,4802,33,4835,145.5151515151515
4761,1,18,500,518,0.036
4762,1,98,46,144,2.130434782608696
4763,1,65,843,908,0.0771055753262159
4764,1,251,376,627,0.6675531914893617
4765,1,14,632,646,0.022151898734177215
4766,1,16,893,909,0.01791713325867861
4767,1,21,553,574,0.0379746835443038
4767,2,824,980,1804,0.8408163265306122
4767,3,5076,741,5817,6.850202429149798
4768,1,151,30,181,5.033333333333333
4768,2,319,170,489,1.8764705882352941
4768,3,693,355,1048,1.952112676056338
4768,4,1244,621,1865,2.003220611916264
4769,1,8,285,293,0.028070175438596492
4769,2,303,388,691,0.7809278350515464
4769,3,1003,600,1603,1.6716666666666666
4770,1,675,29,704,23.275862068965516
4770,2,709,63,772,11.253968253968255
4770,3,780,86,866,9.069767441860465
4770,4,878,81,959,10.839506172839506
4770,5,967,16,983,60.4375
4770,6,998,69,1067,14.46376811594203
4770,7,1079,168,1247,6.4226190476190474
4771,1,84,332,416,0.25301204819277107
4771,2,420,378,798,1.1111111111111112
4772,1,21,1002,1023,0.020958083832335328
4772,2,1037,1097,2134,0.9453053783044667
4772,3,2171,979,3150,2.2175689479060265
4772,4,3173,750,3923,4.230666666666667
4772,5,3946,670,4616,5.88955223880597
4772,6,4649,515,5164,9.027184466019417
4772,7,5188,497,5685,10.438631790744466
4772,8,5707,569,6276,10.0298769771529
4772,9,6297,912,7209,6.904605263157895
4773,1,131,585,716,0.22393162393162394
4773,2,750,333,1083,2.2522522522522523
4773,3,1139,360,1499,3.1638888888888888
4773,4,1518,314,1832,4.834394904458598
4773,5,1892,341,2233,5.548387096774194
4773,6,2282,567,2849,4.0246913580246915
4773,7,2896,390,3286,7.425641025641026
4773,8,3305,563,3868,5.870337477797514
4773,9,3900,310,4210,12.580645161290322
4773,10,4229,267,4496,15.838951310861423
4773,11,4534,433,4967,10.471131639722863
4773,12,5004,361,5365,13.861495844875346
4773,13,5397,313,5710,17.242811501597444
4773,14,5921,376,6297,15.747340425531915
4773,15,6316,324,6640,19.493827160493826
4773,16,6659,354,7013,18.810734463276837
4773,17,7101,328,7429,21.649390243902438
4773,18,7448,440,7888,16.927272727272726
4774,1,214,887,1101,0.24126268320180383
4774,2,1155,276,1431,4.184782608695652
4774,3,1539,942,2481,1.6337579617834395
4774,4,2568,882,3450,2.9115646258503403
4774,5,3476,614,4090,5.6612377850162865
4774,6,4131,102,4233,40.5
4774,7,4294,660,4954,6.506060606060606
4774,8,4987,698,5685,7.144699140401146
4774,9,5714,312,6026,18.314102564102566
4774,10,6076,296,6372,20.527027027027028
4774,11,6418,418,6836,15.354066985645932
4774,12,6858,296,7154,23.16891891891892
4774,13,7194,212,7406,33.93396226415094
4775,1,62,820,882,0.07560975609756097
4775,2,906,607,1513,1.4925864909390445
4775,3,1592,653,2245,2.437978560490046
4775,4,2280,433,2713,5.265588914549654
4775,5,2808,416,3224,6.75
4775,6,3245,459,3704,7.069716775599129
4775,7,3746,772,4518,4.852331606217617
4775,8,4568,442,5010,10.334841628959277
4776,1,151,606,757,0.24917491749174916
4776,2,772,176,948,4.386363636363637
4777,1,227,638,865,0.3557993730407524
4778,1,151,30,181,5.033333333333333
4778,2,319,170,489,1.8764705882352941
4778,3,693,355,1048,1.952112676056338
4778,4,1244,621,1865,2.003220611916264
4779,1,15,205,220,0.07317073170731707
4779,2,234,320,554,0.73125
4779,3,602,400,1002,1.505
4779,4,1220,502,1722,2.4302788844621515
4779,5,1835,521,2356,3.5220729366602685
4779,6,2410,470,2880,5.127659574468085
4779,7,2894,200,3094,14.47
4779,8,3157,257,3414,12.284046692607005
4779,9,3465,540,4005,6.416666666666667
4779,10,4141,967,5108,4.282316442605998
4780,1,166,283,449,0.5865724381625441
4781,1,126,860,986,0.14651162790697675
4781,2,994,784,1778,1.2678571428571428
4781,3,1833,855,2688,2.143859649122807
4781,4,2696,510,3206,5.286274509803921
4781,5,3244,844,4088,3.843601895734597
4781,6,4096,810,4906,5.05679012345679
4781,7,4914,595,5509,8.258823529411766
4781,8,5538,857,6395,6.462077012835473
4781,9,6403,598,7001,10.707357859531772
4782,1,2220,631,2851,3.5182250396196513
4782,2,2899,1002,3901,2.8932135728542914
4782,3,3909,746,4655,5.2399463806970505
4783,1,14,466,480,0.030042918454935622
4783,2,922,478,1400,1.9288702928870294
4784,1,13,169,182,0.07692307692307693
4785,1,23,428,451,0.053738317757009345
4785,2,464,534,998,0.8689138576779026
4785,3,1037,527,1564,1.967741935483871
4785,4,1597,649,2246,2.4607087827426812
4785,5,2280,744,3024,3.064516129032258
4786,1,130,739,869,0.17591339648173207
4787,1,837,290,1127,2.886206896551724
4788,1,486,613,1099,0.7928221859706363
4789,1,22,816,838,0.02696078431372549
4789,2,879,858,1737,1.0244755244755244
4789,3,1781,915,2696,1.946448087431694
4789,4,2740,936,3676,2.927350427350427
4789,5,3706,856,4562,4.329439252336448
4789,6,4595,702,5297,6.545584045584046
4789,7,5342,941,6283,5.676939426142401
4789,8,6309,831,7140,7.592057761732852
4790,1,102,179,281,0.5698324022346368
4790,2,284,163,447,1.7423312883435582
4790,3,452,204,656,2.215686274509804
4790,4,666,51,717,13.058823529411764
4790,5,726,108,834,6.722222222222222
4790,6,840,40,880,21.0
4790,7,888,75,963,11.84
4790,8,978,267,1245,3.662921348314607
4790,9,1270,465,1735,2.7311827956989245
4790,10,1807,100,1907,18.07
4790,11,1920,171,2091,11.228070175438596
4790,12,2217,173,2390,12.815028901734104
4790,13,2430,474,2904,5.1265822784810124
4791,1,1426,536,1962,2.66044776119403
4792,1,16,554,570,0.02888086642599278
4792,2,591,623,1214,0.9486356340288925
4792,3,1225,747,1972,1.6398929049531459
4793,1,160,918,1078,0.17429193899782136
4793,2,1096,583,1679,1.8799313893653515
4793,3,1738,935,2673,1.8588235294117648
4793,4,2690,415,3105,6.481927710843373
4793,5,3168,591,3759,5.3604060913705585
4793,6,3846,297,4143,12.94949494949495
4793,7,4252,942,5194,4.51380042462845
4793,8,5202,947,6149,5.493136219640972
4793,9,6157,645,6802,9.545736434108527
4793,10,6857,942,7799,7.279193205944798
4794,1,2381,96,2477,24.802083333333332
4794,2,2491,836,3327,2.979665071770335
4795,1,74,472,546,0.15677966101694915
4795,2,551,564,1115,0.9769503546099291
4795,3,1125,579,1704,1.9430051813471503
4795,4,1712,683,2395,2.506588579795022
4795,5,2422,615,3037,3.938211382113821
4795,6,3051,486,3537,6.277777777777778
4795,7,3598,509,4107,7.068762278978389
4795,8,4174,366,4540,11.404371584699453
4795,9,4580,412,4992,11.116504854368932
4795,10,5016,568,5584,8.830985915492958
4795,11,5597,505,6102,11.083168316831683
4795,12,6114,370,6484,16.524324324324326
4795,13,6521,385,6906,16.93766233766234
4796,1,34,1025,1059,0.033170731707317075
4797,1,38,557,595,0.06822262118491922
4797,2,660,423,1083,1.5602836879432624
4797,3,1655,732,2387,2.260928961748634
4798,1,451,270,721,1.6703703703703703
4798,2,743,81,824,9.17283950617284
4798,3,854,26,880,32.84615384615385
4799,1,12,721,733,0.016643550624133148
4799,2,751,920,1671,0.816304347826087
4799,3,1683,639,2322,2.6338028169014085
4799,4,2339,973,3312,2.403905447070915
4799,5,3341,692,4033,4.828034682080925
4799,6,4053,893,4946,4.538633818589026
4799,7,4976,647,5623,7.690880989180835
4799,8,5640,836,6476,6.746411483253588
4799,9,6494,943,7437,6.886532343584306
4800,1,262,853,1115,0.3071512309495897
4800,2,1123,619,1742,1.81421647819063
4801,1,29,451,480,0.06430155210643015
4801,2,498,219,717,2.2739726027397262
4802,1,9,77,86,0.11688311688311688
4802,2,93,64,157,1.453125
4802,3,169,93,262,1.8172043010752688
4802,4,278,439,717,0.6332574031890661
4803,1,23,12,35,1.9166666666666667
4803,2,69,588,657,0.11734693877551021
4804,1,4981,917,5898,5.431842966194111
4804,2,5951,407,6358,14.621621621621621
4805,1,17,419,436,0.0405727923627685
4805,2,453,395,848,1.1468354430379746
4805,3,872,437,1309,1.9954233409610984
4805,4,1348,419,1767,3.217183770883055
4805,5,1769,403,2172,4.389578163771712
4805,6,2174,382,2556,5.69109947643979
4806,1,668,440,1108,1.518181818181818
4807,1,78,708,786,0.11016949152542373
4807,2,803,336,1139,2.3898809523809526
4807,3,1170,1012,2182,1.1561264822134387
4807,4,2223,859,3082,2.587892898719441
4807,5,3173,695,3868,4.565467625899281
4807,6,3965,883,4848,4.490373725934315
4807,7,4876,691,5567,7.05643994211288
4807,8,5617,1210,6827,4.642148760330579
4807,9,6843,938,7781,7.295309168443497
4808,1,32,591,623,0.05414551607445008
4808,2,633,323,956,1.9597523219814241
4808,3,978,375,1353,2.608
4809,1,24,109,133,0.22018348623853212
4810,1,22,673,695,0.03268945022288262
4810,2,744,900,1644,0.8266666666666667
4810,3,1662,937,2599,1.7737459978655283
4810,4,2619,784,3403,3.3405612244897958
4810,5,3423,945,4368,3.6222222222222222
4810,6,4397,600,4997,7.328333333333333
4811,1,880,263,1143,3.346007604562738
4811,2,1153,391,1544,2.948849104859335
4811,3,1573,86,1659,18.290697674418606
4811,4,1675,67,1742,25.0
4811,5,1754,278,2032,6.309352517985611
4811,6,2050,295,2345,6.9491525423728815
4811,7,2361,459,2820,5.143790849673203
4811,8,3859,287,4146,13.445993031358885
4811,9,4167,402,4569,10.365671641791044
4811,10,4595,135,4730,34.03703703703704
4811,11,6655,187,6842,35.588235294117645
4811,12,6866,156,7022,44.01282051282051
4811,13,7041,201,7242,35.02985074626866
4811,14,7322,201,7523,36.42786069651741
4811,15,7586,249,7835,30.46586345381526
4812,1,21,411,432,0.051094890510948905
4812,2,513,462,975,1.1103896103896105
4812,3,999,735,1734,1.3591836734693878
4812,4,1763,450,2213,3.917777777777778
4812,5,2258,319,2577,7.078369905956113
4812,6,2601,412,3013,6.313106796116505
4812,7,3034,361,3395,8.404432132963988
4812,8,3416,142,3558,24.056338028169016
4813,1,1400,697,2097,2.0086083213773316
4814,1,28,617,645,0.04538087520259319
4814,2,676,795,1471,0.8503144654088051
4815,1,75,87,162,0.8620689655172413
4815,2,193,336,529,0.5744047619047619
4815,3,560,401,961,1.3965087281795512
4815,4,983,57,1040,17.24561403508772
4815,5,1062,56,1118,18.964285714285715
4815,6,1126,99,1225,11.373737373737374
4815,7,1240,304,1544,4.078947368421052
4815,8,1557,212,1769,7.34433962264151
4815,9,1784,281,2065,6.3487544483985765
4815,10,2082,125,2207,16.656
4815,11,2223,121,2344,18.371900826446282
4815,12,2364,161,2525,14.683229813664596
4815,13,2530,77,2607,32.857142857142854
4815,14,2649,515,3164,5.14368932038835
4815,15,3169,25,3194,126.76
4815,16,3200,81,3281,39.50617283950617
4815,17,3288,221,3509,14.877828054298643
4816,1,10,289,299,0.03460207612456748
4816,2,322,413,735,0.7796610169491526
4816,3,1655,368,2023,4.497282608695652
4816,4,2200,218,2418,10.091743119266056
4816,5,2636,427,3063,6.173302107728337
4816,6,3214,162,3376,19.839506172839506
4816,7,3513,152,3665,23.111842105263158
4816,8,4154,103,4257,40.33009708737864
4816,9,4356,834,5190,5.223021582733813
4816,10,5506,113,5619,48.72566371681416
4816,11,5726,818,6544,7.0
4816,12,6773,828,7601,8.179951690821255
4817,1,1583,216,1799,7.328703703703703
4817,2,1831,685,2516,2.6729927007299272
4818,1,62,673,735,0.09212481426448738
4818,2,900,475,1375,1.894736842105263
4818,3,1599,1220,2819,1.310655737704918
4818,4,2873,985,3858,2.916751269035533
4818,5,4013,1130,5143,3.5513274336283187
4818,6,5567,1149,6716,4.845082680591819
4818,7,7240,676,7916,10.710059171597633
4818,8,7962,120,8082,66.35
4819,1,229,479,708,0.4780793319415449
4819,2,753,750,1503,1.004
4819,3,1548,249,1797,6.216867469879518
4819,4,1848,227,2075,8.140969162995594
4820,1,1243,119,1362,10.445378151260504
4820,2,1395,342,1737,4.078947368421052
4820,3,2443,345,2788,7.081159420289855
4820,4,2790,251,3041,11.115537848605578
4820,5,3043,229,3272,13.2882096069869
4821,1,20,590,610,0.03389830508474576
4821,2,627,575,1202,1.0904347826086958
4821,3,1226,589,1815,2.0814940577249574
4822,1,19,760,779,0.025
4823,1,87,492,579,0.17682926829268292
4823,2,596,544,1140,1.0955882352941178
4824,1,20,423,443,0.04728132387706856
4824,2,471,816,1287,0.5772058823529411
4824,3,1292,171,1463,7.555555555555555
4824,4,1487,834,2321,1.7829736211031175
4824,5,2326,576,2902,4.038194444444445
4824,6,2933,804,3737,3.648009950248756
4824,7,3751,816,4567,4.596813725490196
4824,8,4572,152,4724,30.07894736842105
4824,9,4775,702,5477,6.801994301994302
4824,10,5501,748,6249,7.35427807486631
4824,11,6301,818,7119,7.702933985330073
4824,12,7142,853,7995,8.372801875732709
4825,1,2904,429,3333,6.769230769230769
4826,1,57,27,84,2.111111111111111
4826,2,1713,396,2109,4.325757575757576
4826,3,3339,379,3718,8.810026385224274
4826,4,5461,401,5862,13.618453865336658
4827,1,252,399,651,0.631578947368421
4828,1,975,51,1026,19.11764705882353
4828,2,2795,603,3398,4.635157545605307
4828,3,3414,877,4291,3.8928164196123145
4829,1,1283,934,2217,1.373661670235546
4829,2,2219,626,2845,3.5447284345047922
4829,3,2858,425,3283,6.724705882352941
4829,4,3338,649,3987,5.143297380585516
4830,1,303,336,639,0.9017857142857143
4831,1,41,865,906,0.047398843930635835
4831,2,916,674,1590,1.3590504451038576
4831,3,1605,679,2284,2.3637702503681886
4831,4,2401,371,2772,6.471698113207547
4831,5,2819,662,3481,4.258308157099698
4831,6,3531,474,4005,7.449367088607595
4831,7,4014,275,4289,14.596363636363636
4831,8,4307,648,4955,6.646604938271605
4831,9,4966,975,5941,5.093333333333334
4831,10,5955,134,6089,44.440298507462686
4832,1,124,883,1007,0.1404303510758777
4832,2,1164,204,1368,5.705882352941177
4832,3,1391,205,1596,6.785365853658536
4832,4,1625,479,2104,3.392484342379958
4832,5,2130,504,2634,4.226190476190476
4833,1,29,263,292,0.11026615969581749
4833,2,334,1131,1465,0.2953138815207781
4833,3,1521,1020,2541,1.4911764705882353
4833,4,2692,975,3667,2.761025641025641
4833,5,3760,1069,4829,3.517305893358279
4833,6,4881,361,5242,13.520775623268698
4833,7,5335,891,6226,5.987654320987654
4833,8,6264,146,6410,42.9041095890411
4833,9,6462,654,7116,9.880733944954128
4833,10,7163,423,7586,16.933806146572103
4834,1,470,908,1378,0.5176211453744494
4835,1,697,262,959,2.6603053435114505
4836,1,103,189,292,0.544973544973545
4837,1,23,562,585,0.04092526690391459
4837,2,603,10,613,60.3
4838,1,64,301,365,0.21262458471760798
4838,2,388,409,797,0.9486552567237164
4838,3,824,503,1327,1.6381709741550696
4838,4,1354,900,2254,1.5044444444444445
4838,5,2295,863,3158,2.659327925840093
4838,6,3209,766,3975,4.189295039164491
4838,7,3992,309,4301,12.919093851132686
4839,1,1105,205,1310,5.390243902439025
4839,2,1342,155,1497,8.658064516129032
4839,3,1506,204,1710,7.382352941176471
4839,4,1717,242,1959,7.095041322314049
4839,5,2029,124,2153,16.362903225806452
4839,6,2159,211,2370,10.23222748815166
4839,7,2394,271,2665,8.833948339483396
4839,8,2689,375,3064,7.1706666666666665
4839,9,3133,379,3512,8.266490765171504
4839,10,3527,245,3772,14.395918367346939
4839,11,3785,340,4125,11.132352941176471
4839,12,4146,397,4543,10.443324937027707
4839,13,4587,250,4837,18.348
4839,14,4861,287,5148,16.937282229965156
4839,15,5189,278,5467,18.665467625899282
4839,16,5501,313,5814,17.575079872204473
4839,17,5837,61,5898,95.68852459016394
4839,18,5921,350,6271,16.917142857142856
4839,19,6283,269,6552,23.356877323420075
4839,20,6561,322,6883,20.375776397515526
4839,21,6897,221,7118,31.20814479638009
4839,22,7128,225,7353,31.68
4840,1,206,439,645,0.46924829157175396
4840,2,964,493,1457,1.9553752535496958
4840,3,2273,427,2700,5.323185011709602
4840,4,2708,429,3137,6.312354312354312
4840,5,3145,331,3476,9.501510574018127
4840,6,3536,322,3858,10.98136645962733
4840,7,3994,718,4712,5.562674094707521
4840,8,4777,62,4839,77.04838709677419
4840,9,5635,95,5730,59.31578947368421
4840,10,6231,763,6994,8.166448230668415
4840,11,7003,143,7146,48.97202797202797
4841,1,19,102,121,0.18627450980392157
4841,2,140,1009,1149,0.13875123885034688
4841,3,5844,838,6682,6.973747016706444
4841,4,6693,603,7296,11.099502487562189
4842,1,2276,532,2808,4.2781954887218046
4842,2,2866,582,3448,4.9243986254295535
4842,3,3868,701,4569,5.517831669044223
4842,4,4658,744,5402,6.260752688172043
4842,5,5683,724,6407,7.849447513812155
4842,6,6467,725,7192,8.92
4843,1,363,395,758,0.9189873417721519
4843,2,778,204,982,3.8137254901960786
4843,3,1015,340,1355,2.985294117647059
4843,4,1380,306,1686,4.509803921568627
4843,5,1702,256,1958,6.6484375
4843,6,1974,357,2331,5.529411764705882
4843,7,2368,330,2698,7.175757575757576
4843,8,2748,391,3139,7.028132992327365
4843,9,3179,327,3506,9.7217125382263
4843,10,3547,384,3931,9.236979166666666
4843,11,4002,448,4450,8.933035714285714
4843,12,4546,475,5021,9.570526315789474
4843,13,5057,306,5363,16.526143790849673
4843,14,5479,354,5833,15.477401129943503
4843,15,5920,370,6290,16.0
4843,16,6317,347,6664,18.204610951008647
4843,17,6711,575,7286,11.671304347826087
4843,18,7331,377,7708,19.445623342175065
4844,1,102,1022,1124,0.09980430528375733
4844,2,1658,1030,2688,1.6097087378640778
4844,3,2690,332,3022,8.102409638554217
4845,1,127,1446,1573,0.08782849239280774
4845,2,1662,1534,3196,1.0834419817470664
4845,3,3225,1002,4227,3.218562874251497
4845,4,4266,998,5264,4.274549098196393
4845,5,5328,175,5503,30.445714285714285
4845,6,5544,962,6506,5.762993762993763
4845,7,6518,825,7343,7.90060606060606
4846,1,163,930,1093,0.17526881720430107
4846,2,1216,902,2118,1.3481152993348116
4846,3,2193,1327,3520,1.6525998492840994
4846,4,3541,602,4143,5.882059800664452
4846,5,4183,1013,5196,4.129318854886476
4847,1,27,890,917,0.030337078651685393
4847,2,929,924,1853,1.0054112554112553
4848,1,15,535,550,0.028037383177570093
4849,1,906,53,959,17.09433962264151
4849,2,965,148,1113,6.52027027027027
4849,3,1128,605,1733,1.8644628099173555
4849,4,1740,558,2298,3.118279569892473
4849,5,2302,935,3237,2.462032085561497
4849,6,3242,1006,4248,3.2226640159045727
4849,7,4255,503,4758,8.459244532803181
4849,8,4766,660,5426,7.221212121212122
4850,1,57,903,960,0.06312292358803986
4850,2,970,508,1478,1.9094488188976377
4850,3,1491,504,1995,2.9583333333333335
4851,1,1753,418,2171,4.19377990430622
4851,2,2186,494,2680,4.425101214574899
4851,3,2695,352,3047,7.65625
4851,4,3052,3,3055,1017.3333333333334
4852,1,153,948,1101,0.16139240506329114
4852,2,1110,188,1298,5.904255319148936
4852,3,1314,486,1800,2.7037037037037037
4852,4,1826,395,2221,4.622784810126582
4852,5,2231,783,3014,2.8492975734355044
4853,1,82,383,465,0.21409921671018275
4853,2,484,362,846,1.3370165745856353
4854,1,11,134,145,0.08208955223880597
4854,2,169,427,596,0.3957845433255269
4854,3,656,398,1054,1.6482412060301508
4854,4,1102,89,1191,12.382022471910112
4855,1,2158,361,2519,5.977839335180056
4855,2,2544,3,2547,848.0
4855,3,2572,387,2959,6.645994832041343
4855,4,2979,375,3354,7.944
4856,1,1105,205,1310,5.390243902439025
4856,2,1342,155,1497,8.658064516129032
4856,3,1506,204,1710,7.382352941176471
4856,4,1717,242,1959,7.095041322314049
4856,5,2029,124,2153,16.362903225806452
4856,6,2159,211,2370,10.23222748815166
4856,7,2394,271,2665,8.833948339483396
4856,8,2689,375,3064,7.1706666666666665
4856,9,3133,379,3512,8.266490765171504
4856,10,3527,245,3772,14.395918367346939
4856,11,3785,340,4125,11.132352941176471
4856,12,4146,397,4543,10.443324937027707
4856,13,4587,250,4837,18.348
4856,14,4861,287,5148,16.937282229965156
4856,15,5189,278,5467,18.665467625899282
4856,16,5501,313,5814,17.575079872204473
4856,17,5837,61,5898,95.68852459016394
4856,18,5921,350,6271,16.917142857142856
4856,19,6283,269,6552,23.356877323420075
4856,20,6561,322,6883,20.375776397515526
4856,21,6897,221,7118,31.20814479638009
4856,22,7128,225,7353,31.68
4857,1,9,878,887,0.010250569476082005
4858,1,84,597,681,0.1407035175879397
4858,2,733,1000,1733,0.733
4858,3,1749,454,2203,3.852422907488987
4859,1,3,14,17,0.21428571428571427
4860,1,1531,372,1903,4.115591397849462
4860,2,1909,263,2172,7.258555133079848
4860,3,2221,287,2508,7.7386759581881535
4860,4,2540,336,2876,7.559523809523809
4860,5,2912,491,3403,5.930753564154786
4860,6,3422,211,3633,16.218009478672986
4860,7,3654,294,3948,12.428571428571429
4860,8,3974,369,4343,10.769647696476964
4860,9,4356,295,4651,14.766101694915255
4860,10,4688,238,4926,19.69747899159664
4861,1,1965,755,2720,2.6026490066225167
4862,1,13,630,643,0.020634920634920634
4862,2,671,658,1329,1.0197568389057752
4862,3,1355,970,2325,1.3969072164948453
4862,4,2351,816,3167,2.8811274509803924
4862,5,3187,842,4029,3.7850356294536818
4862,6,4039,810,4849,4.98641975308642
4862,7,4860,814,5674,5.9705159705159705
4863,1,40,858,898,0.046620046620046623
4863,2,924,680,1604,1.3588235294117648
4863,3,1623,530,2153,3.0622641509433963
4864,1,17,357,374,0.047619047619047616
4864,2,393,105,498,3.742857142857143
4864,3,502,163,665,3.079754601226994
4864,4,668,425,1093,1.571764705882353
4865,1,37,363,400,0.10192837465564739
4865,2,422,422,844,1.0
4866,1,43,648,691,0.06635802469135803
4866,2,900,388,1288,2.3195876288659796
4866,3,1337,348,1685,3.8419540229885056
4867,1,37,613,650,0.06035889070146819
4867,2,912,556,1468,1.6402877697841727
4867,3,1545,515,2060,3.0
4867,4,2090,489,2579,4.274028629856851
4867,5,2614,324,2938,8.067901234567902
4867,6,3020,549,3569,5.500910746812386
4867,7,3603,478,4081,7.53765690376569
4867,8,4137,412,4549,10.04126213592233
4867,9,4647,569,5216,8.166959578207381
4867,10,5230,153,5383,34.18300653594771
4868,1,53,445,498,0.11910112359550562
4868,2,715,262,977,2.7290076335877864
4868,3,998,305,1303,3.2721311475409838
4868,4,1370,261,1631,5.24904214559387
4868,5,1783,244,2027,7.307377049180328
4868,6,2054,236,2290,8.703389830508474
4869,1,18,584,602,0.030821917808219176
4870,1,16,255,271,0.06274509803921569
4871,1,344,702,1046,0.49002849002849
4872,1,80,582,662,0.13745704467353953
4873,1,230,827,1057,0.2781136638452237
4874,1,14,445,459,0.03146067415730337
4875,1,240,306,546,0.7843137254901961
4876,1,2378,447,2825,5.319910514541387
4876,2,2854,476,3330,5.995798319327731
4876,3,3346,224,3570,14.9375
4876,4,3578,347,3925,10.311239193083573
4876,5,3966,201,4167,19.73134328358209
4876,6,4262,286,4548,14.902097902097902
4877,1,263,369,632,0.7127371273712737
4878,1,46,311,357,0.14790996784565916
4878,2,370,272,642,1.3602941176470589
4878,3,723,327,1050,2.2110091743119265
4878,4,1101,352,1453,3.127840909090909
4878,5,1492,285,1777,5.235087719298246
4878,6,1781,267,2048,6.670411985018727
4878,7,2122,242,2364,8.768595041322314
4878,8,2433,317,2750,7.6750788643533125
4878,9,2764,334,3098,8.275449101796408
4878,10,3130,312,3442,10.032051282051283
4878,11,3461,97,3558,35.68041237113402
4878,12,3596,185,3781,19.437837837837836
4878,13,3823,185,4008,20.664864864864864
4878,14,4108,3,4111,1369.3333333333333
4879,1,79,138,217,0.572463768115942
4879,2,321,659,980,0.48710166919575115
4880,1,21,914,935,0.022975929978118162
4880,2,987,118,1105,8.364406779661017
4880,3,1117,363,1480,3.077134986225895
4880,4,1489,435,1924,3.4229885057471265
4880,5,1933,550,2483,3.5145454545454546
4881,1,115,1029,1144,0.11175898931000972
4881,2,1147,515,1662,2.2271844660194176
4881,3,1666,79,1745,21.088607594936708
4882,1,80,617,697,0.12965964343598055
4882,2,708,425,1133,1.6658823529411764
4882,3,1162,461,1623,2.5206073752711498
4882,4,1646,270,1916,6.0962962962962965
4882,5,1947,316,2263,6.1613924050632916
4882,6,2286,249,2535,9.180722891566266
4882,7,2553,456,3009,5.598684210526316
4882,8,3087,777,3864,3.972972972972973
4882,9,3942,651,4593,6.055299539170507
4883,1,1030,333,1363,3.093093093093093
4883,2,1373,412,1785,3.3325242718446604
4883,3,1794,380,2174,4.721052631578948
4883,4,2315,343,2658,6.7492711370262395
4883,5,2885,324,3209,8.904320987654321
4883,6,3300,383,3683,8.616187989556137
4883,7,3692,162,3854,22.790123456790123
4884,1,161,185,346,0.8702702702702703
4885,1,79,378,457,0.20899470899470898
4885,2,459,503,962,0.9125248508946322
4886,1,1339,1078,2417,1.2421150278293136
4886,2,2425,1059,3484,2.289896128423041
4886,3,4061,826,4887,4.916464891041162
4886,4,4896,815,5711,6.007361963190184
4886,5,6155,584,6739,10.539383561643836
4886,6,6778,1027,7805,6.599805258033106
4887,1,158,68,226,2.323529411764706
4887,2,505,71,576,7.112676056338028
4887,3,681,599,1280,1.1368948247078463
4887,4,1376,569,1945,2.4182776801405974
4887,5,2318,747,3065,3.103078982597055
4887,6,3117,623,3740,5.003210272873194
4887,7,3760,475,4235,7.91578947368421
4887,8,4540,511,5051,8.88454011741683
4887,9,5175,575,5750,9.0
4887,10,5817,1041,6858,5.587896253602305
4887,11,6866,414,7280,16.584541062801932
4887,12,7415,502,7917,14.770916334661354
4888,1,644,902,1546,0.7139689578713969
4888,2,1608,898,2506,1.7906458797327394
4888,3,2556,919,3475,2.7812840043525573
4889,1,35,434,469,0.08064516129032258
4890,1,38,633,671,0.06003159557661927
4890,2,718,604,1322,1.1887417218543046
4890,3,1349,549,1898,2.4571948998178508
4891,1,83,44,127,1.8863636363636365
4891,2,1499,273,1772,5.490842490842491
4891,3,1832,680,2512,2.6941176470588237
4892,1,26,336,362,0.07738095238095238
4892,2,390,306,696,1.2745098039215685
4893,1,56,724,780,0.07734806629834254
4893,2,795,523,1318,1.520076481835564
4893,3,1344,896,2240,1.5
4893,4,2313,784,3097,2.9502551020408165
4894,1,389,534,923,0.7284644194756554
4894,2,940,365,1305,2.5753424657534247
4895,1,93,530,623,0.17547169811320754
4896,1,23,796,819,0.028894472361809045
4896,2,839,505,1344,1.6613861386138613
4896,3,1364,308,1672,4.428571428571429
4896,4,1723,482,2205,3.574688796680498
4896,5,2236,480,2716,4.658333333333333
4896,6,2771,516,3287,5.37015503875969
4896,7,3296,496,3792,6.645161290322581
4896,8,3795,154,3949,24.642857142857142
4897,1,62,690,752,0.08985507246376812
4898,1,136,735,871,0.18503401360544217
4898,2,1003,973,1976,1.0308324768756423
4898,3,1994,805,2799,2.4770186335403728
4898,4,2807,422,3229,6.651658767772512
4899,1,101,1065,1166,0.09483568075117371
4900,1,1840,795,2635,2.3144654088050314
4901,1,245,1058,1303,0.23156899810964082
4901,2,1578,1058,2636,1.4914933837429112
4901,3,2673,247,2920,10.821862348178138
4901,4,2991,1060,4051,2.8216981132075474
4901,5,4165,970,5135,4.293814432989691
4901,6,5210,922,6132,5.650759219088937
4901,7,6233,993,7226,6.276938569989929
4902,1,38,169,207,0.22485207100591717
4902,2,247,192,439,1.2864583333333333
4902,3,515,280,795,1.8392857142857142
4902,4,840,172,1012,4.883720930232558
4903,1,34,70,104,0.4857142857142857
4903,2,965,3,968,321.6666666666667
4903,3,2581,3,2584,860.3333333333334
4903,4,4514,3,4517,1504.6666666666667
4903,5,6230,3,6233,2076.6666666666665
4903,6,8001,3,8004,2667.0
4904,1,307,454,761,0.6762114537444934
4904,2,777,593,1370,1.3102866779089377
4904,3,1380,318,1698,4.339622641509434
4905,1,458,364,822,1.2582417582417582
4906,1,56,417,473,0.1342925659472422
4906,2,485,398,883,1.2185929648241205
4906,3,899,703,1602,1.2788051209103841
4906,4,1621,783,2404,2.070242656449553
4906,5,2420,420,2840,5.761904761904762
4906,6,2857,585,3442,4.883760683760684
4906,7,3460,495,3955,6.98989898989899
4906,8,3980,487,4467,8.172484599589323
4906,9,4490,609,5099,7.372742200328407
4906,10,5119,733,5852,6.98362892223738
4907,1,11,40,51,0.275
4907,2,84,676,760,0.1242603550295858
4907,3,770,1003,1773,0.7676969092721835
4907,4,1776,1034,2810,1.7176015473887813
4907,5,2813,400,3213,7.0325
4908,1,119,943,1062,0.1261930010604454
4908,2,1069,823,1892,1.298906439854192
4908,3,1919,65,1984,29.523076923076925
4908,4,1994,941,2935,2.1190223166843785
4908,5,2950,465,3415,6.344086021505376
4908,6,3472,554,4026,6.2671480144404335
4908,7,4074,741,4815,5.497975708502024
4908,8,4862,765,5627,6.355555555555555
4908,9,5673,816,6489,6.952205882352941
4908,10,6571,213,6784,30.849765258215964
4908,11,6797,158,6955,43.01898734177215
4909,1,121,815,936,0.14846625766871166
4909,2,999,775,1774,1.2890322580645162
4909,3,1817,663,2480,2.7405731523378583
4909,4,2598,756,3354,3.4365079365079363
4909,5,3475,610,4085,5.69672131147541
4909,6,4198,840,5038,4.997619047619048
4910,1,16,23,39,0.6956521739130435
4910,2,47,82,129,0.573170731707317
4910,3,226,140,366,1.6142857142857143
4910,4,383,132,515,2.9015151515151514
4910,5,534,90,624,5.933333333333334
4911,1,104,545,649,0.1908256880733945
4912,1,80,914,994,0.087527352297593
4912,2,1011,943,1954,1.0721102863202545
4912,3,1980,862,2842,2.296983758700696
4912,4,2859,886,3745,3.22686230248307
4913,1,170,581,751,0.29259896729776247
4914,1,50,497,547,0.1006036217303823
4914,2,558,256,814,2.1796875
4914,3,826,364,1190,2.269230769230769
4914,4,1211,244,1455,4.963114754098361
4914,5,1474,482,1956,3.0580912863070537
4914,6,2136,130,2266,16.43076923076923
4914,7,2277,373,2650,6.10455764075067
4914,8,2667,463,3130,5.760259179265659
4914,9,3167,467,3634,6.781584582441114
4914,10,3766,582,4348,6.470790378006873
4914,11,4383,378,4761,11.595238095238095
4914,12,4787,399,5186,11.997493734335839
4914,13,5244,132,5376,39.72727272727273
4914,14,5407,374,5781,14.457219251336898
4915,1,638,2486,3124,0.25663716814159293
4916,1,27,373,400,0.07238605898123325
4916,2,436,348,784,1.2528735632183907
4916,3,803,592,1395,1.3564189189189189
4917,1,19,268,287,0.0708955223880597
4918,1,23,791,814,0.029077117572692796
4918,2,865,326,1191,2.6533742331288344
4918,3,1217,384,1601,3.1692708333333335
4918,4,1956,417,2373,4.690647482014389
4918,5,2469,126,2595,19.595238095238095
4918,6,2828,969,3797,2.918472652218782
4918,7,4065,448,4513,9.073660714285714
4918,8,4529,147,4676,30.80952380952381
4919,1,23,523,546,0.04397705544933078
4920,1,7,596,603,0.01174496644295302
4920,2,622,634,1256,0.9810725552050473
4920,3,1270,569,1839,2.231985940246046
4920,4,1858,518,2376,3.586872586872587
4920,5,2391,470,2861,5.087234042553192
4920,6,2876,525,3401,5.478095238095238
4920,7,3432,700,4132,4.902857142857143
4920,8,4140,59,4199,70.16949152542372
4920,9,4212,382,4594,11.026178010471204
4920,10,4606,251,4857,18.350597609561753
4920,11,4875,492,5367,9.908536585365853
4920,12,5396,530,5926,10.181132075471698
4920,13,5938,186,6124,31.9247311827957
4920,14,6143,378,6521,16.25132275132275
4920,15,6554,472,7026,13.885593220338983
4920,16,7032,414,7446,16.985507246376812
4920,17,7462,477,7939,15.643605870020965
4921,1,201,883,1084,0.2276330690826727
4921,2,1108,881,1989,1.257661748013621
4921,3,2013,865,2878,2.3271676300578035
4921,4,2902,936,3838,3.1004273504273505
4921,5,3882,797,4679,4.870765370138018
4922,1,17,415,432,0.04096385542168675
4923,1,24,452,476,0.05309734513274336
4924,1,83,221,304,0.3755656108597285
4925,1,403,433,836,0.930715935334873
4925,2,1547,682,2229,2.268328445747801
4925,3,2596,955,3551,2.718324607329843
4925,4,3658,1226,4884,2.9836867862969005
4925,5,4918,317,5235,15.514195583596214
4925,6,5345,1215,6560,4.399176954732511
4926,1,153,566,719,0.2703180212014134
4927,1,66,963,1029,0.06853582554517133
4927,2,1037,900,1937,1.1522222222222223
4928,1,816,795,1611,1.0264150943396226
4928,2,1622,758,2380,2.1398416886543536
4929,1,309,769,1078,0.40182054616384916
4930,1,43,581,624,0.07401032702237521
4931,1,148,48,196,3.0833333333333335
4931,2,360,37,397,9.72972972972973
4931,3,513,180,693,2.85
4931,4,704,218,922,3.229357798165138
4931,5,1014,18,1032,56.333333333333336
4931,6,1067,135,1202,7.9037037037037035
4931,7,1207,177,1384,6.8192090395480225
4931,8,1392,229,1621,6.078602620087336
4931,9,1699,183,1882,9.28415300546448
4931,10,1952,178,2130,10.96629213483146
4931,11,2217,214,2431,10.35981308411215
4931,12,2503,201,2704,12.45273631840796
4931,13,2748,181,2929,15.182320441988951
4931,14,2971,187,3158,15.88770053475936
4931,15,3223,199,3422,16.195979899497488
4931,16,3477,190,3667,18.3
4931,17,3762,193,3955,19.492227979274613
4931,18,4039,23,4062,175.6086956521739
4931,19,4157,218,4375,19.068807339449542
4931,20,4532,67,4599,67.64179104477611
4931,21,4758,254,5012,18.73228346456693
4931,22,5112,215,5327,23.77674418604651
4931,23,5339,211,5550,25.303317535545023
4931,24,5660,242,5902,23.388429752066116
4931,25,6009,3,6012,2003.0
4932,1,21,368,389,0.057065217391304345
4932,2,447,917,1364,0.48745910577971646
4932,3,1402,991,2393,1.4147325933400605
4932,4,2415,842,3257,2.8681710213776723
4933,1,67,879,946,0.07622298065984073
4933,2,1023,356,1379,2.8735955056179776
4933,3,1455,609,2064,2.3891625615763545
4933,4,2092,509,2601,4.110019646365423
4933,5,2627,444,3071,5.916666666666667
4933,6,3104,482,3586,6.439834024896266
4933,7,3622,512,4134,7.07421875
4933,8,4172,456,4628,9.149122807017545
4933,9,4641,100,4741,46.41
4934,1,376,799,1175,0.47058823529411764
4934,2,1205,457,1662,2.636761487964989
4934,3,1674,339,2013,4.938053097345133
4934,4,2029,280,2309,7.246428571428571
4934,5,2328,306,2634,7.607843137254902
4934,6,2648,876,3524,3.0228310502283104
4934,7,3539,476,4015,7.434873949579832
4934,8,4041,525,4566,7.6971428571428575
4935,1,1233,313,1546,3.939297124600639
4936,1,27,390,417,0.06923076923076923
4937,1,27,54,81,0.5
4937,2,317,484,801,0.6549586776859504
4937,3,830,584,1414,1.4212328767123288
4937,4,1436,568,2004,2.528169014084507
4937,5,2016,584,2600,3.452054794520548
4937,6,2622,587,3209,4.466780238500852
4937,7,3254,617,3871,5.273905996758509
4937,8,3891,954,4845,4.078616352201258
4938,1,24,1021,1045,0.023506366307541625
4938,2,1047,702,1749,1.4914529914529915
4939,1,2471,654,3125,3.7782874617737003
4939,2,3191,786,3977,4.059796437659033
4939,3,4019,122,4141,32.942622950819676
4939,4,4224,848,5072,4.981132075471698
4939,5,5163,846,6009,6.102836879432624
4939,6,6024,930,6954,6.47741935483871
4939,7,7001,652,7653,10.737730061349692
4940,1,1053,348,1401,3.0258620689655173
4940,2,1486,849,2335,1.7502944640753828
4940,3,2351,311,2662,7.559485530546624
4940,4,2688,925,3613,2.905945945945946
4940,5,3659,906,4565,4.0386313465783665
4940,6,4577,1015,5592,4.50935960591133
4940,7,5603,204,5807,27.465686274509803
4940,8,5853,872,6725,6.712155963302752
4940,9,6804,498,7302,13.662650602409638
4940,10,7342,534,7876,13.749063670411985
4941,1,186,849,1035,0.21908127208480566
4942,1,11,598,609,0.01839464882943144
4943,1,78,952,1030,0.0819327731092437
4943,2,1047,647,1694,1.6182380216383307
4943,3,1750,322,2072,5.434782608695652
4943,4,2115,324,2439,6.527777777777778
4943,5,2518,905,3423,2.7823204419889502
4943,6,3481,372,3853,9.35752688172043
4943,7,3921,472,4393,8.307203389830509
4943,8,4466,922,5388,4.843817787418655
4943,9,5479,932,6411,5.878755364806867
4944,1,29,649,678,0.04468412942989214
4944,2,713,837,1550,0.8518518518518519
4944,3,1587,600,2187,2.645
4944,4,2214,209,2423,10.5933014354067
4945,1,72,874,946,0.08237986270022883
4945,2,972,498,1470,1.9518072289156627
4946,1,34,570,604,0.05964912280701754
4946,2,631,521,1152,1.2111324376199617
4946,3,1263,584,1847,2.162671232876712
4946,4,1859,599,2458,3.1035058430717863
4946,5,2526,687,3213,3.6768558951965065
4946,6,3246,340,3586,9.547058823529412
4946,7,3629,130,3759,27.915384615384614
4946,8,3794,584,4378,6.4965753424657535
4946,9,4388,542,4930,8.095940959409594
4947,1,43,70,113,0.6142857142857143
4947,2,127,84,211,1.5119047619047619
4947,3,228,509,737,0.44793713163064836
4947,4,1820,855,2675,2.128654970760234
4947,5,2683,407,3090,6.592137592137592
4947,6,3133,365,3498,8.583561643835617
4947,7,3500,294,3794,11.904761904761905
4947,8,3796,323,4119,11.75232198142415
4947,9,4188,357,4545,11.731092436974789
4947,10,4602,367,4969,12.539509536784742
4947,11,4971,116,5087,42.85344827586207
4947,12,5168,310,5478,16.670967741935485
4947,13,5535,399,5934,13.87218045112782
4947,14,5972,266,6238,22.451127819548873
4947,15,7401,252,7653,29.36904761904762
4947,16,7680,46,7726,166.95652173913044
4948,1,103,623,726,0.1653290529695024
4949,1,290,511,801,0.5675146771037182
4950,1,35,90,125,0.3888888888888889
4950,2,130,123,253,1.056910569105691
4950,3,280,155,435,1.8064516129032258
4950,4,438,122,560,3.5901639344262297
4950,5,578,129,707,4.48062015503876
4951,1,133,727,860,0.1829436038514443
4951,2,896,844,1740,1.061611374407583
4951,3,1773,918,2691,1.9313725490196079
4951,4,2740,812,3552,3.374384236453202
4951,5,3646,822,4468,4.435523114355231
4951,6,4477,155,4632,28.883870967741935
4951,7,4656,904,5560,5.150442477876106
4951,8,5624,806,6430,6.977667493796526
4951,9,6460,835,7295,7.736526946107785
4952,1,1850,517,2367,3.5783365570599615
4952,2,4221,428,4649,9.86214953271028
4953,1,73,637,710,0.11459968602825746
4953,2,724,984,1708,0.7357723577235772
4953,3,1719,255,1974,6.741176470588235
4954,1,335,873,1208,0.3837342497136312
4954,2,1245,900,2145,1.3833333333333333
4955,1,542,492,1034,1.1016260162601625
4955,2,1044,771,1815,1.3540856031128405
4955,3,1835,427,2262,4.297423887587822
4955,4,2265,513,2778,4.415204678362573
4955,5,2781,551,3332,5.047186932849365
4955,6,3334,474,3808,7.033755274261603
4955,7,3811,535,4346,7.123364485981308
4955,8,4352,525,4877,8.289523809523809
4955,9,4879,551,5430,8.85480943738657
4955,10,5432,523,5955,10.38623326959847
4955,11,5957,418,6375,14.251196172248804
4955,12,6379,528,6907,12.081439393939394
4955,13,6909,544,7453,12.700367647058824
4955,14,7475,540,8015,13.842592592592593
4956,1,27,853,880,0.031652989449003514
4956,2,907,867,1774,1.0461361014994233
4956,3,2503,499,3002,5.0160320641282565
4956,4,3028,874,3902,3.4645308924485128
4956,5,3948,1025,4973,3.8517073170731706
4956,6,5562,935,6497,5.948663101604278
4956,7,6513,909,7422,7.1650165016501655
4957,1,113,898,1011,0.12583518930957685
4958,1,144,477,621,0.3018867924528302
4958,2,626,830,1456,0.7542168674698795
4959,1,81,676,757,0.11982248520710059
4960,1,52,561,613,0.09269162210338681
4960,2,633,994,1627,0.6368209255533199
4961,1,18,654,672,0.027522935779816515
4961,2,748,751,1499,0.996005326231691
4961,3,1508,722,2230,2.0886426592797784
4961,4,2242,795,3037,2.820125786163522
4961,5,3096,1233,4329,2.510948905109489
4961,6,4334,365,4699,11.873972602739727
4962,1,21,542,563,0.03874538745387454
4963,1,29,564,593,0.051418439716312055
4963,2,622,478,1100,1.301255230125523
4963,3,1130,213,1343,5.305164319248826
4963,4,1374,564,1938,2.4361702127659575
4963,5,1968,561,2529,3.5080213903743314
4963,6,2570,32,2602,80.3125
4963,7,2631,486,3117,5.41358024691358
4964,1,24,599,623,0.04006677796327212
4965,1,111,680,791,0.16323529411764706
4966,1,376,546,922,0.6886446886446886
4966,2,984,196,1180,5.020408163265306
4966,3,1185,35,1220,33.857142857142854
4966,4,1241,83,1324,14.951807228915662
4966,5,1350,49,1399,27.551020408163264
4966,6,2399,473,2872,5.071881606765328
4966,7,2919,172,3091,16.97093023255814
4966,8,3117,259,3376,12.034749034749035
4967,1,299,1039,1338,0.287776708373436
4967,2,1340,861,2201,1.556329849012776
4968,1,10,220,230,0.045454545454545456
4968,2,257,321,578,0.8006230529595015
4968,3,583,252,835,2.3134920634920637
4969,1,46,535,581,0.08598130841121496
4969,2,651,1028,1679,0.6332684824902723
4969,3,1730,1163,2893,1.4875322441960448
4969,4,2960,1087,4047,2.723091076356946
4969,5,4094,1223,5317,3.3475061324611612
4969,6,5389,1183,6572,4.555367709213863
4969,7,6592,766,7358,8.605744125326371
4970,1,16,642,658,0.024922118380062305
4970,2,687,334,1021,2.05688622754491
4970,3,1049,229,1278,4.580786026200873
4970,4,1292,409,1701,3.1589242053789732
4970,5,1733,314,2047,5.519108280254777
4971,1,505,724,1229,0.6975138121546961
4971,2,1238,391,1629,3.166240409207161
4971,3,1637,474,2111,3.4535864978902953
4972,1,34,692,726,0.049132947976878616
4973,1,40,302,342,0.13245033112582782
4973,2,420,179,599,2.346368715083799
4973,3,612,323,935,1.894736842105263
4973,4,1238,460,1698,2.6913043478260867
4973,5,1723,449,2172,3.837416481069042
4973,6,2190,732,2922,2.9918032786885247
4973,7,2924,372,3296,7.860215053763441
4973,8,3298,366,3664,9.010928961748634
4973,9,3681,201,3882,18.313432835820894
4973,10,3890,417,4307,9.32853717026379
4973,11,4398,226,4624,19.460176991150444
4973,12,4633,597,5230,7.760469011725293
4973,13,5265,400,5665,13.1625
4974,1,160,560,720,0.2857142857142857
4975,1,868,678,1546,1.28023598820059
4975,2,1561,689,2250,2.265602322206096
4975,3,2303,701,3004,3.2853067047075606
4975,4,3035,908,3943,3.342511013215859
4975,5,3987,307,4294,12.986970684039088
4976,1,223,340,563,0.6558823529411765
4977,1,26,742,768,0.03504043126684636
4977,2,797,29,826,27.482758620689655
4977,3,2158,566,2724,3.812720848056537
4977,4,2739,914,3653,2.9967177242888403
4977,5,3667,138,3805,26.57246376811594
4977,6,3824,580,4404,6.593103448275862
4977,7,4430,590,5020,7.508474576271187
4977,8,5135,617,5752,8.322528363047002
4977,9,5767,536,6303,10.759328358208956
4977,10,6429,438,6867,14.678082191780822
4977,11,6918,74,6992,93.48648648648648
4977,12,7009,913,7922,7.676889375684556
4978,1,1014,361,1375,2.8088642659279777
4979,1,542,187,729,2.8983957219251337
4979,2,739,230,969,3.2130434782608694
4979,3,974,217,1191,4.488479262672811
4979,4,1198,218,1416,5.495412844036697
4979,5,1457,308,1765,4.73051948051948
4979,6,1795,284,2079,6.320422535211268
4979,7,2086,322,2408,6.478260869565218
4979,8,2435,188,2623,12.952127659574469
4979,9,2652,260,2912,10.2
4979,10,2929,227,3156,12.90308370044053
4979,11,3169,258,3427,12.282945736434108
4979,12,3434,233,3667,14.738197424892704
4979,13,3680,167,3847,22.035928143712574
4979,14,3872,291,4163,13.305841924398626
4979,15,4170,194,4364,21.49484536082474
4979,16,4374,324,4698,13.5
4979,17,4715,162,4877,29.104938271604937
4979,18,4921,267,5188,18.43071161048689
4979,19,5197,254,5451,20.46062992125984
4979,20,5505,342,5847,16.096491228070175
4979,21,5904,291,6195,20.288659793814432
4979,22,6253,283,6536,22.09540636042403
4979,23,6545,344,6889,19.026162790697676
4979,24,6908,448,7356,15.419642857142858
4979,25,7368,56,7424,131.57142857142858
4980,1,2314,43,2357,53.81395348837209
4980,2,2372,86,2458,27.58139534883721
4980,3,2474,277,2751,8.931407942238268
4980,4,2767,472,3239,5.862288135593221
4980,5,3256,253,3509,12.869565217391305
4980,6,3529,546,4075,6.4633699633699635
4980,7,4104,365,4469,11.243835616438357
4980,8,4497,808,5305,5.5655940594059405
4980,9,5330,523,5853,10.191204588910134
4980,10,5916,745,6661,7.940939597315436
4980,11,6719,299,7018,22.471571906354516
4981,1,22,700,722,0.03142857142857143
4981,2,731,617,1348,1.1847649918962724
4981,3,1366,810,2176,1.6864197530864198
4982,1,1525,556,2081,2.7428057553956835
4983,1,60,62,122,0.967741935483871
4983,2,232,91,323,2.5494505494505493
4983,3,342,72,414,4.75
4983,4,1240,93,1333,13.333333333333334
4983,5,2000,66,2066,30.303030303030305
4983,6,2255,96,2351,23.489583333333332
4983,7,2377,267,2644,8.902621722846442
4983,8,4086,364,4450,11.225274725274724
4983,9,4480,36,4516,124.44444444444444
4983,10,4577,46,4623,99.5
4983,11,4850,435,5285,11.149425287356323
4984,1,2967,2,2969,1483.5
4984,2,3611,128,3739,28.2109375
4985,1,29,493,522,0.058823529411764705
4985,2,543,913,1456,0.5947426067907996
4985,3,1467,978,2445,1.5
4985,4,2447,205,2652,11.93658536585366
4985,5,2668,929,3597,2.8719052744886975
4985,6,3612,1010,4622,3.5762376237623763
4985,7,4624,157,4781,29.452229299363058
4985,8,4788,838,5626,5.713603818615752
4985,9,5631,939,6570,5.996805111821086
4985,10,6576,936,7512,7.0256410256410255
4986,1,180,941,1121,0.19128586609989373
4986,2,1129,674,1803,1.675074183976261
4986,3,1831,958,2789,1.9112734864300627
4986,4,2797,966,3763,2.8954451345755694
4986,5,3771,507,4278,7.437869822485207
4986,6,4287,633,4920,6.7725118483412325
4986,7,4932,275,5207,17.934545454545454
4986,8,5218,187,5405,27.90374331550802
4987,1,1325,136,1461,9.742647058823529
4987,2,1490,43,1533,34.651162790697676
4987,3,1535,74,1609,20.743243243243242
4987,4,1612,166,1778,9.710843373493976
4987,5,1780,54,1834,32.96296296296296
4987,6,1908,184,2092,10.369565217391305
4987,7,2095,26,2121,80.57692307692308
4987,8,2123,51,2174,41.627450980392155
4987,9,2245,142,2387,15.809859154929578
4987,10,2390,23,2413,103.91304347826087
4987,11,2415,75,2490,32.2
4987,12,2498,121,2619,20.644628099173552
4987,13,2622,297,2919,8.828282828282829
4987,14,2922,192,3114,15.21875
4987,15,3118,361,3479,8.637119113573407
4987,16,3482,566,4048,6.151943462897527
4987,17,4050,280,4330,14.464285714285714
4987,18,4333,291,4624,14.890034364261169
4987,19,4627,215,4842,21.52093023255814
4987,20,4845,643,5488,7.534992223950233
4988,1,114,755,869,0.1509933774834437
4988,2,894,610,1504,1.4655737704918033
4989,1,276,549,825,0.5027322404371585
4989,2,972,363,1335,2.677685950413223
4989,3,1429,210,1639,6.804761904761905
4989,4,2039,254,2293,8.027559055118111
4989,5,2400,347,2747,6.916426512968299
4989,6,2822,369,3191,7.64769647696477
4989,7,3339,468,3807,7.134615384615385
4989,8,3935,409,4344,9.621026894865526
4989,9,4608,428,5036,10.766355140186915
4989,10,5094,327,5421,15.577981651376147
4989,11,5528,481,6009,11.492723492723492
4989,12,6080,475,6555,12.8
4989,13,6624,509,7133,13.013752455795677
4989,14,7215,337,7552,21.409495548961424
4989,15,7564,198,7762,38.2020202020202
4989,16,7790,204,7994,38.18627450980392
4990,1,148,353,501,0.4192634560906516
4990,2,524,286,810,1.832167832167832
4990,3,847,782,1629,1.0831202046035806
4990,4,1763,511,2274,3.4500978473581214
4990,5,2486,793,3279,3.1349306431273645
4990,6,3360,792,4152,4.242424242424242
4990,7,4184,210,4394,19.923809523809524
4991,1,93,1198,1291,0.07762938230383973
4991,2,1296,611,1907,2.121112929623568
4991,3,1938,1248,3186,1.5528846153846154
4991,4,3191,411,3602,7.763990267639903
4992,1,49,347,396,0.14121037463976946
4993,1,33,20,53,1.65
4993,2,115,751,866,0.15312916111850866
4993,3,925,16,941,57.8125
4993,4,1003,280,1283,3.5821428571428573
4993,5,1353,620,1973,2.182258064516129
4993,6,2041,620,2661,3.291935483870968
4993,7,2677,406,3083,6.593596059113301
4993,8,3098,59,3157,52.50847457627118
4993,9,3186,294,3480,10.83673469387755
4993,10,3490,101,3591,34.554455445544555
4993,11,3618,186,3804,19.451612903225808
4993,12,3815,124,3939,30.766129032258064
4993,13,3956,576,4532,6.868055555555555
4994,1,128,735,863,0.17414965986394557
4994,2,987,973,1960,1.014388489208633
4995,1,376,427,803,0.8805620608899297
4995,2,805,384,1189,2.0963541666666665
4995,3,1218,388,1606,3.1391752577319587
4995,4,1608,297,1905,5.414141414141414
4996,1,107,512,619,0.208984375
4996,2,676,576,1252,1.1736111111111112
4996,3,1263,382,1645,3.306282722513089
4996,4,1666,363,2029,4.589531680440771
4996,5,2078,420,2498,4.947619047619048
4996,6,2519,379,2898,6.646437994722955
4996,7,2906,76,2982,38.23684210526316
4996,8,3006,123,3129,24.4390243902439
4996,9,3171,361,3532,8.78393351800554
4996,10,3565,366,3931,9.740437158469945
4996,11,3952,448,4400,8.821428571428571
4996,12,4423,399,4822,11.085213032581454
4996,13,4832,791,5623,6.108723135271807
4996,14,5791,730,6521,7.932876712328767
4996,15,6558,757,7315,8.663143989431969
4997,1,30,353,383,0.08498583569405099
4997,2,395,474,869,0.8333333333333334
4997,3,891,393,1284,2.267175572519084
4997,4,1295,454,1749,2.852422907488987
4997,5,1760,163,1923,10.797546012269938
4998,1,239,124,363,1.9274193548387097
4998,2,445,89,534,5.0
4998,3,563,184,747,3.0597826086956523
4998,4,991,211,1202,4.696682464454977
4998,5,1234,255,1489,4.8392156862745095
4998,6,1503,200,1703,7.515
4998,7,1781,282,2063,6.315602836879433
4998,8,2079,167,2246,12.449101796407186
4998,9,2287,278,2565,8.226618705035971
4998,10,2643,117,2760,22.58974358974359
4998,11,3070,507,3577,6.055226824457594
4998,12,3593,167,3760,21.51497005988024
4998,13,3772,206,3978,18.310679611650485
4998,14,4209,845,5054,4.981065088757396
4998,15,5068,309,5377,16.401294498381876
4998,16,5393,386,5779,13.971502590673575
4998,17,5790,481,6271,12.037422037422038
4999,1,46,611,657,0.07528641571194762
4999,2,667,489,1156,1.3640081799591002
4999,3,1164,392,1556,2.9693877551020407
4999,4,1585,77,1662,20.584415584415584
4999,5,1673,360,2033,4.647222222222222
4999,6,2050,442,2492,4.638009049773756
4999,7,2504,492,2996,5.0894308943089435
4999,8,3039,255,3294,11.91764705882353
4999,9,3380,481,3861,7.027027027027027
4999,10,3881,551,4432,7.043557168784029
4999,11,4439,456,4895,9.734649122807017
4999,12,4920,397,5317,12.39294710327456
4999,13,5376,321,5697,16.747663551401867
4999,14,5728,527,6255,10.869070208728653
4999,15,6281,155,6436,40.52258064516129
4999,16,6984,344,7328,20.302325581395348
4999,17,7351,654,8005,11.240061162079511
5000,1,20,382,402,0.05235602094240838
5000,2,406,357,763,1.1372549019607843
5000,3,772,246,1018,3.138211382113821
5000,4,1037,333,1370,3.114114114114114
5001,1,10,442,452,0.02262443438914027
5001,2,467,607,1074,0.7693574958813838
5001,3,1089,489,1578,2.226993865030675
5001,4,1583,599,2182,2.642737896494157
5001,5,2189,734,2923,2.982288828337875
5001,6,2928,191,3119,15.329842931937172
5001,7,3127,374,3501,8.36096256684492
5001,8,3508,710,4218,4.940845070422535
5001,9,4227,591,4818,7.152284263959391
5002,1,942,1152,2094,0.8177083333333334
5002,2,2142,1279,3421,1.6747458952306489
5002,3,6987,881,7868,7.930760499432463
5003,1,15,712,727,0.021067415730337078
5004,1,99,947,1046,0.10454065469904963
5005,1,550,307,857,1.791530944625407
5005,2,1383,264,1647,5.238636363636363
5005,3,1848,298,2146,6.201342281879195
5005,4,2180,950,3130,2.294736842105263
5005,5,3145,1009,4154,3.1169474727452924
5005,6,4157,794,4951,5.23551637279597
5005,7,4987,427,5414,11.679156908665105
5005,8,5437,1012,6449,5.372529644268774
5005,9,6465,900,7365,7.183333333333334
5006,1,181,2353,2534,0.07692307692307693
5007,1,334,181,515,1.8453038674033149
5007,2,532,507,1039,1.04930966469428
5008,1,394,803,1197,0.49066002490660027
5008,2,1393,510,1903,2.731372549019608
5009,1,773,865,1638,0.8936416184971099
5010,1,125,577,702,0.21663778162911612
5010,2,723,277,1000,2.6101083032490973
5010,3,1496,498,1994,3.004016064257028
5010,4,2024,660,2684,3.066666666666667
5010,5,2709,402,3111,6.7388059701492535
5011,1,2970,338,3308,8.78698224852071
5011,2,3322,583,3905,5.69811320754717
5011,3,3962,416,4378,9.524038461538462
5011,4,4414,532,4946,8.296992481203008
5012,1,3127,629,3756,4.971383147853736
5012,2,3857,639,4496,6.035993740219093
5013,1,116,931,1047,0.12459720730397422
5013,2,1054,389,1443,2.709511568123393
5013,3,1457,927,2384,1.5717367853290183
5013,4,2391,355,2746,6.735211267605634
5014,1,46,655,701,0.07022900763358779
5014,2,738,504,1242,1.4642857142857142
5015,1,484,513,997,0.9434697855750487
5015,2,1008,117,1125,8.615384615384615
5015,3,1904,326,2230,5.840490797546012
5015,4,2263,380,2643,5.955263157894737
5015,5,2721,636,3357,4.278301886792453
5015,6,3365,613,3978,5.489396411092986
5015,7,4002,692,4694,5.783236994219653
5016,1,78,996,1074,0.0783132530120482
5016,2,1097,1012,2109,1.0839920948616601
5016,3,2129,860,2989,2.4755813953488373
5016,4,3010,951,3961,3.1650893796004205
5016,5,3982,1013,4995,3.930898321816387
5016,6,5017,882,5899,5.688208616780045
5016,7,5921,952,6873,6.21953781512605
5017,1,23,430,453,0.053488372093023255
5017,2,489,376,865,1.300531914893617
5017,3,1530,350,1880,4.371428571428571
5017,4,1920,304,2224,6.315789473684211
5017,5,2271,376,2647,6.039893617021277
5017,6,2752,502,3254,5.48207171314741
5017,7,3272,356,3628,9.191011235955056
5017,8,3765,497,4262,7.575452716297787
5017,9,4275,239,4514,17.88702928870293
5017,10,4524,48,4572,94.25
5018,1,1204,650,1854,1.8523076923076922
5018,2,2317,337,2654,6.8753709198813056
5018,3,2668,334,3002,7.9880239520958085
5018,4,3053,604,3657,5.054635761589404
5018,5,3686,618,4304,5.964401294498382
5018,6,5653,395,6048,14.311392405063291
5018,7,6197,176,6373,35.21022727272727
5018,8,7713,65,7778,118.66153846153846
5018,9,7783,48,7831,162.14583333333334
5018,10,7850,166,8016,47.28915662650602
5019,1,23,117,140,0.19658119658119658
5019,2,165,103,268,1.6019417475728155
5019,3,310,496,806,0.625
5019,4,845,422,1267,2.0023696682464456
5019,5,1307,471,1778,2.774946921443737
5019,6,1816,581,2397,3.125645438898451
5019,7,2445,648,3093,3.7731481481481484
5019,8,3141,660,3801,4.759090909090909
5019,9,3854,668,4522,5.769461077844311
5019,10,4572,671,5243,6.81371087928465
5020,1,1184,733,1917,1.6152796725784448
5020,2,1940,638,2578,3.040752351097179
5020,3,2596,609,3205,4.262725779967159
5020,4,3228,665,3893,4.8541353383458645
5020,5,3905,196,4101,19.9234693877551
5020,6,4136,792,4928,5.222222222222222
5020,7,4952,818,5770,6.053789731051345
5020,8,5805,456,6261,12.730263157894736
5021,1,23,586,609,0.03924914675767918
5021,2,631,635,1266,0.9937007874015747
5022,1,1555,96,1651,16.197916666666668
5022,2,3306,1173,4479,2.8184143222506393
5023,1,22,42,64,0.5238095238095238
5023,2,1148,389,1537,2.9511568123393315
5023,3,2670,408,3078,6.544117647058823
5023,4,6146,173,6319,35.52601156069364
5024,1,138,642,780,0.21495327102803738
5025,1,14,685,699,0.020437956204379562
5025,2,712,657,1369,1.0837138508371384
5025,3,1376,684,2060,2.0116959064327484
5025,4,2068,698,2766,2.962750716332378
5025,5,2778,646,3424,4.30030959752322
5026,1,147,364,511,0.40384615384615385
5026,2,521,645,1166,0.8077519379844961
5026,3,1174,348,1522,3.3735632183908044
5026,4,1533,294,1827,5.214285714285714
5026,5,2608,1004,3612,2.597609561752988
5027,1,21,654,675,0.03211009174311927
5028,1,18,408,426,0.04411764705882353
5029,1,209,967,1176,0.21613236814891418
5030,1,4162,940,5102,4.427659574468085
5030,2,5528,539,6067,10.256029684601113
5030,3,6095,298,6393,20.453020134228186
5031,1,142,84,226,1.6904761904761905
5032,1,33,109,142,0.30275229357798167
5032,2,157,157,314,1.0
5033,1,17,763,780,0.022280471821756225
5033,2,795,1034,1829,0.7688588007736944
5033,3,1840,810,2650,2.271604938271605
5033,4,2658,681,3339,3.9030837004405288
5033,5,3363,632,3995,5.32120253164557
5033,6,4012,756,4768,5.306878306878307
5033,7,4779,656,5435,7.285060975609756
5033,8,5458,612,6070,8.918300653594772
5033,9,6097,743,6840,8.20592193808883
5034,1,26,731,757,0.03556771545827633
5035,1,266,577,843,0.4610051993067591
5035,2,868,474,1342,1.8312236286919832
5035,3,1367,621,1988,2.2012882447665056
5035,4,2032,713,2745,2.849929873772791
5035,5,2866,716,3582,4.0027932960893855
5035,6,3712,792,4504,4.686868686868687
5035,7,4585,895,5480,5.122905027932961
5035,8,5499,835,6334,6.58562874251497
5035,9,6348,828,7176,7.666666666666667
5036,1,186,594,780,0.31313131313131315
5036,2,922,886,1808,1.0406320541760723
5036,3,1810,314,2124,5.764331210191083
5036,4,2365,860,3225,2.75
5037,1,6,208,214,0.028846153846153848
5037,2,240,218,458,1.1009174311926606
5037,3,474,388,862,1.2216494845360826
5037,4,872,197,1069,4.426395939086294
5037,5,1079,367,1446,2.9400544959128063
5037,6,1481,428,1909,3.460280373831776
5038,1,569,606,1175,0.9389438943894389
5038,2,1191,225,1416,5.293333333333333
5039,1,45,329,374,0.13677811550151975
5039,2,385,435,820,0.8850574712643678
5039,3,836,600,1436,1.3933333333333333
5040,1,35,1018,1053,0.0343811394891945
5040,2,1056,576,1632,1.8333333333333333
5040,3,1642,1072,2714,1.5317164179104477
5040,4,2726,225,2951,12.115555555555556
5040,5,3003,704,3707,4.265625
5040,6,3720,209,3929,17.79904306220096
5040,7,4074,281,4355,14.498220640569395
5040,8,4482,271,4753,16.538745387453876
5040,9,4765,395,5160,12.063291139240507
5040,10,5584,313,5897,17.840255591054312
5040,11,5918,137,6055,43.197080291970806
5040,12,6083,211,6294,28.829383886255926
5041,1,272,143,415,1.902097902097902
5042,1,162,939,1101,0.17252396166134185
5043,1,23,388,411,0.059278350515463915
5043,2,425,508,933,0.8366141732283464
5043,3,943,232,1175,4.064655172413793
5043,4,1187,457,1644,2.597374179431072
5043,5,1673,587,2260,2.8500851788756387
5043,6,2273,662,2935,3.433534743202417
5043,7,2945,384,3329,7.669270833333333
5043,8,3343,451,3794,7.412416851441241
5044,1,43,965,1008,0.04455958549222798
5044,2,1018,644,1662,1.5807453416149069
5044,3,2527,805,3332,3.139130434782609
5044,4,3369,1031,4400,3.267701260911736
5044,5,4440,398,4838,11.155778894472363
5044,6,4847,425,5272,11.40470588235294
5044,7,5281,278,5559,18.996402877697843
5044,8,5569,367,5936,15.174386920980927
5044,9,5946,403,6349,14.754342431761787
5044,10,6359,330,6689,19.26969696969697
5044,11,6699,269,6968,24.903345724907062
5044,12,6978,188,7166,37.11702127659574
5044,13,7177,200,7377,35.885
5044,14,7391,204,7595,36.23039215686274
5044,15,7605,333,7938,22.83783783783784
5045,1,46,168,214,0.27380952380952384
5045,2,227,146,373,1.5547945205479452
5045,3,394,536,930,0.7350746268656716
5046,1,45,398,443,0.11306532663316583
5046,2,467,530,997,0.8811320754716981
5046,3,998,38,1036,26.263157894736842
5046,4,1050,255,1305,4.117647058823529
5046,5,1341,227,1568,5.907488986784141
5046,6,2404,904,3308,2.65929203539823
5046,7,3335,916,4251,3.640829694323144
5047,1,463,875,1338,0.5291428571428571
5047,2,1369,551,1920,2.484573502722323
5047,3,1938,360,2298,5.383333333333334
5048,1,136,388,524,0.35051546391752575
5048,2,571,392,963,1.4566326530612246
5048,3,968,40,1008,24.2
5048,4,1037,413,1450,2.5108958837772395
5049,1,388,646,1034,0.6006191950464397
5050,1,8,318,326,0.025157232704402517
5050,2,334,304,638,1.0986842105263157
5050,3,649,831,1480,0.7809867629362214
5050,4,1496,560,2056,2.6714285714285713
5051,1,17,378,395,0.04497354497354497
5052,1,16,170,186,0.09411764705882353
5052,2,221,533,754,0.4146341463414634
5053,1,124,882,1006,0.14058956916099774
5054,1,25,430,455,0.05813953488372093
5054,2,478,782,1260,0.6112531969309463
5054,3,1268,440,1708,2.881818181818182
5055,1,57,18,75,3.1666666666666665
5055,2,81,45,126,1.8
5055,3,138,48,186,2.875
5055,4,197,40,237,4.925
5056,1,52,46,98,1.1304347826086956
5056,2,116,156,272,0.7435897435897436
5056,3,287,249,536,1.1526104417670682
5056,4,554,298,852,1.8590604026845639
5057,1,58,397,455,0.14609571788413098
5057,2,507,849,1356,0.5971731448763251
5057,3,1378,199,1577,6.924623115577889
5057,4,1604,290,1894,5.531034482758621
5057,5,1935,460,2395,4.206521739130435
5058,1,36,572,608,0.06293706293706294
5059,1,268,693,961,0.38672438672438675
5059,2,1080,868,1948,1.2442396313364055
5059,3,2090,867,2957,2.4106113033448673
5059,4,2996,295,3291,10.155932203389831
5059,5,3455,867,4322,3.9850057670126873
5059,6,4379,690,5069,6.346376811594203
5059,7,5094,775,5869,6.572903225806452
5060,1,22,867,889,0.025374855824682813
5061,1,2314,35,2349,66.11428571428571
5061,2,2369,368,2737,6.4375
5061,3,2759,380,3139,7.260526315789473
5061,4,3182,578,3760,5.505190311418685
5062,1,269,801,1070,0.3358302122347066
5063,1,47,158,205,0.2974683544303797
5063,2,231,139,370,1.6618705035971224
5063,3,386,240,626,1.6083333333333334
5063,4,652,361,1013,1.8060941828254848
5063,5,1036,462,1498,2.242424242424242
5063,6,1525,411,1936,3.710462287104623
5064,1,148,941,1089,0.15727948990435706
5064,2,1097,332,1429,3.3042168674698793
5065,1,18,92,110,0.1956521739130435
5065,2,136,89,225,1.5280898876404494
5065,3,241,332,573,0.7259036144578314
5065,4,580,360,940,1.6111111111111112
5065,5,974,301,1275,3.2358803986710964
5066,1,31,476,507,0.06512605042016807
5066,2,510,465,975,1.096774193548387
5066,3,1008,653,1661,1.5436447166921898
5067,1,44,58,102,0.7586206896551724
5068,1,31,529,560,0.05860113421550094
5068,2,1502,743,2245,2.0215343203230147
5068,3,2276,387,2663,5.881136950904393
5068,4,2685,1115,3800,2.408071748878924
5068,5,3815,997,4812,3.8264794383149447
5068,6,4825,997,5822,4.839518555667001
5068,7,5836,460,6296,12.68695652173913
5069,1,1957,730,2687,2.680821917808219
5069,2,2695,1006,3701,2.6789264413518885
5069,3,3703,798,4501,4.640350877192983
5069,4,4506,677,5183,6.655834564254062
5069,5,5188,692,5880,7.497109826589595
5069,6,5893,127,6020,46.40157480314961
5069,7,6025,36,6061,167.36111111111111
5069,8,6066,424,6490,14.306603773584905
5069,9,6494,589,7083,11.025466893039049
5070,1,323,611,934,0.5286415711947627
5070,2,1309,633,1942,2.0679304897314377
5070,3,2045,606,2651,3.3745874587458746
5071,1,62,820,882,0.07560975609756097
5072,1,46,406,452,0.11330049261083744
5072,2,493,100,593,4.93
5072,3,623,116,739,5.370689655172414
5072,4,747,265,1012,2.818867924528302
5072,5,1034,187,1221,5.529411764705882
5072,6,1256,314,1570,4.0
5072,7,1579,384,1963,4.111979166666667
5072,8,1979,418,2397,4.73444976076555
5072,9,2425,274,2699,8.85036496350365
5073,1,33,643,676,0.05132192846034215
5073,2,728,492,1220,1.4796747967479675
5073,3,1299,454,1753,2.8612334801762116
5073,4,1798,432,2230,4.162037037037037
5074,1,592,102,694,5.803921568627451
5074,2,739,4,743,184.75
5074,3,807,741,1548,1.0890688259109311
5074,4,1561,613,2174,2.5464926590538335
5074,5,2263,894,3157,2.5313199105145414
5074,6,3238,795,4033,4.072955974842768
5074,7,4046,888,4934,4.556306306306307
5074,8,4953,917,5870,5.401308615049073
5074,9,5873,447,6320,13.138702460850112
5074,10,6358,907,7265,7.009922822491731
5075,1,1850,517,2367,3.5783365570599615
5075,2,4221,428,4649,9.86214953271028
5075,3,6511,390,6901,16.694871794871794
5076,1,12,563,575,0.021314387211367674
5077,1,75,522,597,0.14367816091954022
5078,1,21,914,935,0.022975929978118162
5079,1,115,514,629,0.2237354085603113
5080,1,16,113,129,0.1415929203539823
5080,2,264,165,429,1.6
5080,3,456,208,664,2.1923076923076925
5081,1,3455,1788,5243,1.9323266219239374
5082,1,22,698,720,0.03151862464183381
5083,1,443,78,521,5.67948717948718
5083,2,549,45,594,12.2
5083,3,606,66,672,9.181818181818182
5083,4,691,77,768,8.974025974025974
5083,5,802,74,876,10.837837837837839
5083,6,1200,125,1325,9.6
5083,7,1483,126,1609,11.76984126984127
5083,8,1620,142,1762,11.408450704225352
5083,9,1797,138,1935,13.021739130434783
5083,10,1941,14,1955,138.64285714285714
5083,11,2086,124,2210,16.822580645161292
5083,12,2367,156,2523,15.173076923076923
5083,13,2565,178,2743,14.410112359550562
5083,14,2924,159,3083,18.38993710691824
5083,15,3288,180,3468,18.266666666666666
5083,16,3654,144,3798,25.375
5083,17,3974,186,4160,21.365591397849464
5083,18,4437,195,4632,22.753846153846155
5083,19,4950,176,5126,28.125
5083,20,5310,170,5480,31.235294117647058
5083,21,5845,148,5993,39.49324324324324
5083,22,6309,161,6470,39.18633540372671
5083,23,6731,101,6832,66.64356435643565
5083,24,6841,93,6934,73.55913978494624
5083,25,7839,117,7956,67.0
5084,1,98,817,915,0.11995104039167687
5084,2,935,901,1836,1.0377358490566038
5084,3,1847,753,2600,2.452855245683931
5084,4,2728,966,3694,2.824016563146998
5084,5,3766,520,4286,7.242307692307692
5084,6,4324,531,4855,8.143126177024483
5084,7,4899,626,5525,7.825878594249201
5084,8,5544,199,5743,27.85929648241206
5084,9,5887,10,5897,588.7
5084,10,6093,856,6949,7.117990654205608
5084,11,6973,582,7555,11.981099656357388
5085,1,95,876,971,0.10844748858447488
5086,1,147,540,687,0.2722222222222222
5087,1,301,726,1027,0.41460055096418735
5087,2,1046,212,1258,4.933962264150943
5087,3,1292,685,1977,1.8861313868613139
5087,4,1993,431,2424,4.624129930394432
5087,5,2437,24,2461,101.54166666666667
5087,6,2835,667,3502,4.250374812593703
5087,7,3512,326,3838,10.773006134969325
5087,8,3847,807,4654,4.767038413878563
5087,9,4813,337,5150,14.281899109792285
5087,10,5176,332,5508,15.590361445783133
5087,11,5770,395,6165,14.60759493670886
5087,12,7236,18,7254,402.0
5088,1,405,667,1072,0.6071964017991005
5088,2,1094,500,1594,2.188
5089,1,88,395,483,0.22278481012658227
5089,2,515,382,897,1.3481675392670156
5090,1,103,611,714,0.1685761047463175
5091,1,886,67,953,13.223880597014926
5091,2,983,496,1479,1.9818548387096775
5091,3,1486,300,1786,4.953333333333333
5091,4,1798,78,1876,23.05128205128205
5091,5,2426,695,3121,3.4906474820143885
5091,6,3155,391,3546,8.069053708439897
5092,1,41,829,870,0.04945717732207479
5093,1,48,1082,1130,0.04436229205175601
5093,2,1138,317,1455,3.589905362776025
5093,3,2409,1101,3510,2.188010899182561
5093,4,3520,272,3792,12.941176470588236
5093,5,4824,644,5468,7.490683229813665
5093,6,6780,1103,7883,6.1468721668177695
5094,1,158,619,777,0.2552504038772213
5095,1,65,754,819,0.08620689655172414
5096,1,707,1413,2120,0.5003538570417552
5096,2,2142,1854,3996,1.1553398058252426
5096,3,6066,675,6741,8.986666666666666
5097,1,15,700,715,0.02142857142857143
5098,1,733,981,1714,0.7471967380224261
5099,1,261,2,263,130.5
5099,2,360,291,651,1.2371134020618557
5099,3,847,2,849,423.5
5099,4,1134,2,1136,567.0
5099,5,1552,2,1554,776.0
5099,6,1841,2,1843,920.5
5099,7,2061,158,2219,13.044303797468354
5099,8,2266,224,2490,10.116071428571429
5099,9,2702,357,3059,7.568627450980392
5100,1,1254,1164,2418,1.077319587628866
5100,2,2457,165,2622,14.89090909090909
5100,3,2689,724,3413,3.7140883977900554
5100,4,3438,169,3607,20.34319526627219
5100,5,3639,207,3846,17.579710144927535
5100,6,4148,333,4481,12.456456456456456
5100,7,4528,487,5015,9.297741273100616
5101,1,31,715,746,0.043356643356643354
5102,1,34,73,107,0.4657534246575342
5102,2,111,73,184,1.5205479452054795
5102,3,190,47,237,4.042553191489362
5103,1,59,512,571,0.115234375
5104,1,115,403,518,0.2853598014888337
5104,2,579,737,1316,0.7856173677069199
5105,1,63,820,883,0.07682926829268293
5105,2,1178,815,1993,1.445398773006135
5105,3,1994,243,2237,8.205761316872428
5105,4,2295,813,3108,2.822878228782288
5105,5,3160,661,3821,4.780635400907715
5105,6,3871,702,4573,5.514245014245014
5105,7,4681,476,5157,9.834033613445378
5105,8,5359,669,6028,8.010463378176382
5105,9,6131,640,6771,9.5796875
5106,1,15,534,549,0.028089887640449437
5106,2,577,526,1103,1.096958174904943
5107,1,5098,934,6032,5.458244111349036
5107,2,6045,955,7000,6.329842931937173
5107,3,7005,767,7772,9.132985658409387
5108,1,327,660,987,0.4954545454545455
5108,2,1011,474,1485,2.132911392405063
5108,3,1502,497,1999,3.022132796780684
5108,4,2279,997,3276,2.2858575727181543
5108,5,3321,588,3909,5.6479591836734695
5109,1,5,24,29,0.20833333333333334
5109,2,40,31,71,1.2903225806451613
5109,3,83,37,120,2.2432432432432434
5109,4,223,237,460,0.9409282700421941
5109,5,622,306,928,2.0326797385620914
5110,1,170,500,670,0.34
5111,1,218,963,1181,0.22637590861889928
5111,2,1244,645,1889,1.9286821705426356
5111,3,1920,826,2746,2.324455205811138
5111,4,2823,355,3178,7.952112676056338
5111,5,3208,423,3631,7.583924349881797
5111,6,3763,397,4160,9.478589420654911
5111,7,4183,545,4728,7.675229357798165
5111,8,4812,566,5378,8.501766784452297
5111,9,5479,537,6016,10.202979515828678
5111,10,6064,671,6735,9.03725782414307
5112,1,529,251,780,2.1075697211155378
5113,1,23,662,685,0.03474320241691843
5114,1,26,183,209,0.14207650273224043
5114,2,222,268,490,0.8283582089552238
5114,3,504,355,859,1.419718309859155
5115,1,137,97,234,1.4123711340206186
5115,2,319,163,482,1.9570552147239264
5115,3,623,240,863,2.595833333333333
5116,1,667,921,1588,0.7242128121606949
5116,2,1593,634,2227,2.5126182965299684
5116,3,2286,475,2761,4.812631578947369
5116,4,2765,448,3213,6.171875
5116,5,3235,843,4078,3.837485172004745
5116,6,4082,653,4735,6.25114854517611
5116,7,4789,495,5284,9.674747474747475
5116,8,5312,476,5788,11.159663865546218
5116,9,5829,501,6330,11.634730538922156
5116,10,6485,709,7194,9.146685472496474
5116,11,7234,529,7763,13.674858223062381
5117,1,3011,1017,4028,2.960668633235005
5118,1,12,488,500,0.02459016393442623
5119,1,50,740,790,0.06756756756756757
5119,2,876,613,1489,1.429037520391517
5119,3,1525,325,1850,4.6923076923076925
5120,1,371,882,1253,0.42063492063492064
5120,2,1264,334,1598,3.784431137724551
5121,1,21,914,935,0.022975929978118162
5121,2,987,118,1105,8.364406779661017
5122,1,70,465,535,0.15053763440860216
5122,2,580,626,1206,0.9265175718849841
5122,3,1213,949,2162,1.2781875658587987
5122,4,2197,753,2950,2.9176626826029217
5122,5,2964,572,3536,5.181818181818182
5122,6,3630,971,4601,3.738414006179197
5122,7,4665,915,5580,5.098360655737705
5123,1,43,399,442,0.10776942355889724
5123,2,464,359,823,1.2924791086350975
5123,3,866,877,1743,0.9874572405929305
5124,1,138,496,634,0.2782258064516129
5124,2,640,552,1192,1.1594202898550725
5124,3,1206,823,2029,1.465370595382746
5124,4,2047,739,2786,2.769959404600812
5124,5,2807,952,3759,2.948529411764706
5124,6,3806,316,4122,12.044303797468354
5124,7,4243,738,4981,5.749322493224932
5124,8,5099,990,6089,5.150505050505051
5124,9,6103,326,6429,18.720858895705522
5124,10,6604,639,7243,10.334898278560251
5124,11,7262,606,7868,11.983498349834983
5125,1,1609,584,2193,2.7551369863013697
5125,2,5982,622,6604,9.617363344051446
5126,1,41,389,430,0.10539845758354756
5126,2,434,471,905,0.921443736730361
5126,3,910,435,1345,2.0919540229885056
5126,4,1351,89,1440,15.179775280898877
5127,1,284,590,874,0.48135593220338985
5127,3,876,66,942,13.272727272727273
5127,4,1017,316,1333,3.2183544303797467
5127,5,1343,265,1608,5.067924528301887
5127,6,1616,276,1892,5.855072463768116
5127,7,1992,340,2332,5.858823529411764
5127,8,2349,522,2871,4.5
5127,9,2972,567,3539,5.241622574955908
5127,10,3561,229,3790,15.550218340611353
5127,11,3829,334,4163,11.464071856287426
5127,84,4170,271,4441,15.387453874538746
5127,86,4482,247,4729,18.14574898785425
5127,87,4736,300,5036,15.786666666666667
5127,88,5051,516,5567,9.78875968992248
5128,1,60,973,1033,0.06166495375128469
5128,2,1035,561,1596,1.8449197860962567
5128,3,1615,374,1989,4.318181818181818
5128,4,2032,531,2563,3.8267419962335216
5129,1,21,510,531,0.041176470588235294
5130,1,367,502,869,0.7310756972111554
5130,2,903,1007,1910,0.8967229394240318
5130,3,2098,200,2298,10.49
5130,4,2306,491,2797,4.696537678207739
5130,5,2804,314,3118,8.929936305732484
5130,6,3131,1061,4192,2.9509896324222433
5130,7,4224,487,4711,8.673511293634498
5130,8,4730,982,5712,4.816700610997963
5131,1,91,243,334,0.37448559670781895
5131,2,412,196,608,2.1020408163265305
5132,1,71,868,939,0.08179723502304148
5132,2,1096,955,2051,1.1476439790575916
5133,1,225,35,260,6.428571428571429
5133,2,287,180,467,1.5944444444444446
5133,3,590,282,872,2.0921985815602837
5133,4,906,356,1262,2.544943820224719
5133,5,1299,607,1906,2.14003294892916
5133,6,1916,525,2441,3.6495238095238096
5134,1,32,558,590,0.05734767025089606
5135,1,81,4,85,20.25
5135,2,1237,626,1863,1.976038338658147
5135,3,2450,761,3211,3.219448094612352
5135,4,5590,109,5699,51.28440366972477
5136,1,51,100,151,0.51
5136,2,154,123,277,1.2520325203252032
5136,3,280,199,479,1.407035175879397
5136,4,482,175,657,2.7542857142857144
5136,5,660,220,880,3.0
5136,6,883,261,1144,3.3831417624521074
5136,7,1147,214,1361,5.359813084112149
5136,8,1364,140,1504,9.742857142857142
5136,9,1507,162,1669,9.302469135802468
5136,10,1672,221,1893,7.5656108597285066
5136,11,1896,259,2155,7.32046332046332
5136,12,2158,204,2362,10.57843137254902
5136,13,2365,215,2580,11.0
5137,1,27,54,81,0.5
5137,2,234,543,777,0.430939226519337
5137,3,2779,772,3551,3.599740932642487
5137,4,3563,27,3590,131.96296296296296
5137,5,4056,462,4518,8.779220779220779
5137,6,4532,804,5336,5.63681592039801
5137,7,6058,929,6987,6.520990312163617
5137,8,7054,858,7912,8.221445221445222
5138,1,198,533,731,0.3714821763602251
5139,1,13,518,531,0.025096525096525095
5139,2,589,406,995,1.4507389162561577
5140,1,1218,800,2018,1.5225
5140,2,2063,860,2923,2.3988372093023256
5140,3,3019,937,3956,3.2219850586979724
5140,4,4107,677,4784,6.066469719350074
5140,5,5002,779,5781,6.421052631578948
5140,6,6213,602,6815,10.320598006644518
5140,7,6889,506,7395,13.614624505928854
5141,1,86,593,679,0.14502529510961215
5141,2,693,434,1127,1.596774193548387
5141,3,1167,488,1655,2.3913934426229506
5141,4,1706,566,2272,3.0141342756183747
5141,5,2350,565,2915,4.15929203539823
5141,6,3003,404,3407,7.433168316831683
5141,7,3529,459,3988,7.688453159041394
5142,1,7,31,38,0.22580645161290322
5142,2,46,36,82,1.2777777777777777
5142,3,98,176,274,0.5568181818181818
5142,4,278,44,322,6.318181818181818
5142,5,329,54,383,6.092592592592593
5143,1,26,1350,1376,0.01925925925925926
5144,1,23,544,567,0.042279411764705885
5144,2,589,477,1066,1.2348008385744236
5145,1,84,1769,1853,0.047484454494064444
5146,1,101,261,362,0.38697318007662834
5147,1,72,1176,1248,0.061224489795918366
5147,2,1250,1221,2471,1.0237510237510237
5147,3,2473,1242,3715,1.9911433172302737
5147,4,3717,810,4527,4.588888888888889
5147,5,4566,1212,5778,3.767326732673267
5147,6,5780,1248,7028,4.631410256410256
5147,7,7030,861,7891,8.164924506387921
5148,1,23,91,114,0.25274725274725274
5148,2,130,203,333,0.6403940886699507
5149,1,11,535,546,0.020560747663551402
5150,1,475,1157,1632,0.4105445116681072
5150,2,1669,418,2087,3.992822966507177
5150,3,2158,897,3055,2.4057971014492754
5150,4,3525,1291,4816,2.7304415182029436
5150,5,4873,519,5392,9.389210019267823
5150,6,5532,733,6265,7.547066848567531
5150,7,6489,1119,7608,5.798927613941019
5151,1,45,895,940,0.05027932960893855
5151,2,943,444,1387,2.123873873873874
5151,3,1464,600,2064,2.44
5151,4,2125,619,2744,3.4329563812600967
5151,5,2840,658,3498,4.316109422492401
5151,6,3547,505,4052,7.023762376237624
5151,7,4117,617,4734,6.672609400324149
5151,8,4810,594,5404,8.097643097643097
5151,9,5488,560,6048,9.8
5151,10,6106,582,6688,10.491408934707904
5151,11,6759,597,7356,11.321608040201005
5151,12,7399,505,7904,14.651485148514851
5152,1,2417,371,2788,6.514824797843666
5152,2,4089,418,4507,9.782296650717702
5152,3,7065,366,7431,19.30327868852459
5153,1,28,690,718,0.04057971014492753
5153,2,748,635,1383,1.1779527559055119
5153,3,1397,315,1712,4.434920634920635
5154,1,32,521,553,0.061420345489443376
5155,1,13,32,45,0.40625
5156,1,63,913,976,0.06900328587075576
5156,2,995,493,1488,2.0182555780933065
5156,3,1496,751,2247,1.992010652463382
5157,1,24,586,610,0.040955631399317405
5157,2,643,530,1173,1.2132075471698114
5158,1,176,509,685,0.34577603143418467
5159,1,61,892,953,0.06838565022421525
5160,1,40,139,179,0.28776978417266186
5160,2,203,650,853,0.3123076923076923
5161,1,83,193,276,0.43005181347150256
5161,2,411,469,880,0.8763326226012793
5161,3,881,360,1241,2.4472222222222224
5161,4,1242,341,1583,3.6422287390029324
5161,5,1584,371,1955,4.269541778975741
5161,6,1956,356,2312,5.49438202247191
5161,7,2313,406,2719,5.697044334975369
5161,8,2720,314,3034,8.662420382165605
5162,1,62,820,882,0.07560975609756097
5162,2,906,607,1513,1.4925864909390445
5162,3,1592,653,2245,2.437978560490046
5162,4,2280,433,2713,5.265588914549654
5162,5,2808,416,3224,6.75
5162,6,3245,459,3704,7.069716775599129
5162,7,3746,772,4518,4.852331606217617
5162,8,4568,442,5010,10.334841628959277
5162,9,5051,656,5707,7.699695121951219
5163,1,2942,1161,4103,2.534022394487511
5163,2,4130,288,4418,14.340277777777779
5164,1,265,986,1251,0.268762677484787
5164,2,1289,287,1576,4.491289198606272
5164,3,1629,273,1902,5.967032967032967
5164,4,1911,115,2026,16.617391304347827
5164,5,2173,197,2370,11.030456852791879
5164,6,2392,155,2547,15.432258064516128
5164,7,2560,242,2802,10.578512396694215
5164,8,2829,243,3072,11.641975308641975
5164,9,3091,1001,4092,3.087912087912088
5164,10,4105,82,4187,50.0609756097561
5164,11,4209,364,4573,11.563186813186814
5164,12,4586,325,4911,14.11076923076923
5164,13,4927,463,5390,10.6414686825054
5164,14,5408,283,5691,19.109540636042404
5164,15,5709,371,6080,15.388140161725067
5164,16,6088,320,6408,19.025
5164,17,6456,302,6758,21.37748344370861
5165,1,681,1155,1836,0.5896103896103896
5165,2,2891,1265,4156,2.2853754940711464
5165,3,5354,1168,6522,4.583904109589041
5166,1,182,629,811,0.2893481717011129
5167,1,54,651,705,0.08294930875576037
5167,2,724,510,1234,1.419607843137255
5167,3,1256,499,1755,2.5170340681362724
5167,4,1782,302,2084,5.900662251655629
5167,5,2116,197,2313,10.741116751269036
5167,6,2343,101,2444,23.198019801980198
5167,7,2451,431,2882,5.68677494199536
5167,8,2978,528,3506,5.640151515151516
5167,9,3527,889,4416,3.967379077615298
5167,10,4463,938,5401,4.757995735607676
5167,11,5422,225,5647,24.09777777777778
5167,12,5666,375,6041,15.109333333333334
5167,13,6056,243,6299,24.921810699588477
5167,14,6329,386,6715,16.39637305699482
5167,15,6755,136,6891,49.669117647058826
5167,16,6900,201,7101,34.32835820895522
5167,17,7129,608,7737,11.725328947368421
5167,18,7757,285,8042,27.217543859649123
5168,1,20,286,306,0.06993006993006994
5168,2,312,735,1047,0.42448979591836733
5169,1,80,1035,1115,0.07729468599033816
5169,2,1408,49,1457,28.73469387755102
5169,3,1524,63,1587,24.19047619047619
5169,4,1608,190,1798,8.463157894736842
5170,1,81,158,239,0.5126582278481012
5170,2,256,240,496,1.0666666666666667
5170,3,512,415,927,1.2337349397590363
5171,1,21,554,575,0.03790613718411552
5171,2,700,463,1163,1.511879049676026
5171,3,1212,725,1937,1.6717241379310346
5172,1,10,381,391,0.026246719160104987
5173,1,13,97,110,0.13402061855670103
5173,2,1569,721,2290,2.176144244105409
5173,3,2336,573,2909,4.076788830715532
5173,4,2952,354,3306,8.338983050847459
5173,5,3413,465,3878,7.339784946236559
5173,6,3919,997,4916,3.9307923771313944
5174,1,19,543,562,0.034990791896869246
5174,2,569,411,980,1.3844282238442822
5175,1,2082,338,2420,6.159763313609467
5176,1,1815,430,2245,4.22093023255814
5176,2,2272,546,2818,4.1611721611721615
5177,1,124,378,502,0.328042328042328
5177,2,511,43,554,11.883720930232558
5178,1,8,211,219,0.037914691943127965
5179,1,688,574,1262,1.1986062717770034
5179,2,1475,457,1932,3.227571115973742
5179,3,2020,404,2424,5.0
5179,4,2551,385,2936,6.625974025974026
5180,1,262,863,1125,0.30359212050984935
5180,2,1189,1029,2218,1.1554907677356656
5180,3,2224,371,2595,5.994609164420485
5180,4,2604,793,3397,3.283732660781841
5180,5,3435,942,4377,3.6464968152866244
5180,6,4384,116,4500,37.793103448275865
5180,7,4519,324,4843,13.947530864197532
5180,8,4854,75,4929,64.72
5180,9,4980,925,5905,5.383783783783784
5180,10,5916,372,6288,15.903225806451612
5180,11,6341,966,7307,6.564182194616977
5180,12,7316,336,7652,21.773809523809526
5181,1,115,859,974,0.13387660069848661
5182,1,721,1998,2719,0.3608608608608609
5182,2,4371,3677,8048,1.1887408213217296
5183,1,6007,51,6058,117.7843137254902
5183,2,6077,273,6350,22.26007326007326
5183,3,6355,408,6763,15.575980392156863
5184,1,29,284,313,0.10211267605633803
5185,1,528,876,1404,0.6027397260273972
5185,2,1408,895,2303,1.5731843575418993
5185,3,2307,226,2533,10.20796460176991
5186,1,94,152,246,0.618421052631579
5187,1,686,613,1299,1.1190864600326265
5187,2,1334,559,1893,2.3864042933810374
5187,3,1922,513,2435,3.746588693957115
5187,4,2464,614,3078,4.013029315960912
5187,5,3105,947,4052,3.2787750791974655
5187,6,4062,463,4525,8.773218142548597
5187,7,4613,308,4921,14.977272727272727
5187,8,5196,390,5586,13.323076923076924
5188,1,863,621,1484,1.3896940418679549
5188,2,1736,273,2009,6.358974358974359
5188,3,2094,227,2321,9.224669603524228
5188,4,2634,470,3104,5.604255319148936
5188,5,3111,47,3158,66.19148936170212
5188,6,3381,524,3905,6.452290076335878
5188,7,3947,322,4269,12.25776397515528
5188,8,4334,163,4497,26.588957055214724
5188,9,4579,367,4946,12.47683923705722
5188,10,5018,299,5317,16.782608695652176
5188,11,5441,297,5738,18.31986531986532
5188,12,5745,57,5802,100.78947368421052
5188,13,5902,225,6127,26.23111111111111
5188,14,6176,239,6415,25.84100418410042
5188,15,6455,168,6623,38.42261904761905
5189,1,71,959,1030,0.0740354535974974
5189,2,1041,630,1671,1.6523809523809523
5189,3,1712,709,2421,2.414668547249647
5190,1,20,769,789,0.02600780234070221
5190,2,804,874,1678,0.919908466819222
5191,1,208,8,216,26.0
5191,2,229,119,348,1.9243697478991597
5191,3,903,186,1089,4.854838709677419
5191,4,1194,228,1422,5.2368421052631575
5191,5,2235,259,2494,8.62934362934363
5191,6,2513,162,2675,15.512345679012345
5191,7,2682,600,3282,4.47
5191,8,3441,419,3860,8.212410501193318
5191,9,3935,216,4151,18.21759259259259
5191,10,6346,3,6349,2115.3333333333335
5191,11,6366,15,6381,424.4
5191,12,6411,777,7188,8.250965250965251
5192,1,32,214,246,0.14953271028037382
5192,2,274,268,542,1.0223880597014925
5192,3,569,439,1008,1.296127562642369
5192,4,1032,145,1177,7.117241379310345
5192,5,1207,303,1510,3.9834983498349836
5192,6,1543,87,1630,17.735632183908045
5193,1,37,338,375,0.10946745562130178
5193,2,395,376,771,1.050531914893617
5193,3,776,3,779,258.6666666666667
5194,1,36,86,122,0.4186046511627907
5195,1,39,780,819,0.05
5195,2,871,254,1125,3.4291338582677167
5196,1,15,716,731,0.02094972067039106
5196,2,753,634,1387,1.1876971608832807
5196,3,1408,858,2266,1.641025641025641
5196,4,2277,846,3123,2.6914893617021276
5196,5,3227,891,4118,3.621773288439955
5197,1,2793,859,3652,3.251455180442375
5197,2,3667,712,4379,5.150280898876405
5197,3,4456,724,5180,6.154696132596685
5197,4,5219,177,5396,29.48587570621469
5197,5,5522,584,6106,9.455479452054794
5198,1,38,733,771,0.05184174624829468
5198,2,809,568,1377,1.4242957746478873
5199,1,19,488,507,0.0389344262295082
5200,1,282,553,835,0.5099457504520796
5200,2,860,691,1551,1.244573082489146
5200,3,1632,541,2173,3.0166358595194085
5201,1,36,645,681,0.05581395348837209
5201,2,704,671,1375,1.0491803278688525
5201,3,1397,268,1665,5.212686567164179
5201,4,1674,491,2165,3.409368635437882
5201,5,2175,601,2776,3.6189683860232944
5201,6,2786,660,3446,4.221212121212122
5201,7,3479,653,4132,5.327718223583461
5201,8,4146,122,4268,33.98360655737705
5201,9,4291,329,4620,13.042553191489361
5201,10,4639,229,4868,20.25764192139738
5201,11,4910,487,5397,10.082135523613964
5202,1,1180,1022,2202,1.1545988258317026
5203,1,464,533,997,0.8705440900562852
5203,2,1028,561,1589,1.8324420677361855
5203,3,1594,772,2366,2.064766839378238
5203,4,2380,621,3001,3.8325281803542675
5203,5,3011,649,3660,4.63944530046225
5203,6,3683,460,4143,8.006521739130434
5203,7,4168,354,4522,11.774011299435028
5203,8,4525,941,5466,4.808714133900106
5203,9,5486,1097,6583,5.000911577028259
5203,10,6674,1090,7764,6.122935779816514
5204,1,482,510,992,0.9450980392156862
5204,2,2159,400,2559,5.3975
5204,3,2631,502,3133,5.241035856573705
5204,4,3166,565,3731,5.603539823008849
5205,1,321,311,632,1.0321543408360128
5206,1,476,877,1353,0.5427594070695553
5206,2,1404,545,1949,2.5761467889908256
5206,3,2358,907,3265,2.599779492833517
5206,4,3582,688,4270,5.2063953488372094
5206,5,4715,851,5566,5.54054054054054
5206,6,5840,878,6718,6.651480637813211
5206,7,6724,200,6924,33.62
5207,1,20,418,438,0.04784688995215311
5208,1,2086,29,2115,71.93103448275862
5208,2,2778,39,2817,71.23076923076923
5208,3,3389,787,4176,4.306226175349428
5208,4,6042,441,6483,13.700680272108844
5208,5,7211,224,7435,32.191964285714285
5209,1,1209,34,1243,35.55882352941177
5209,2,1249,273,1522,4.575091575091575
5209,3,1535,381,1916,4.028871391076115
5210,1,82,200,282,0.41
5210,2,299,107,406,2.794392523364486
5210,3,425,120,545,3.5416666666666665
5210,4,585,175,760,3.342857142857143
5210,5,771,189,960,4.079365079365079
5210,6,977,164,1141,5.9573170731707314
5210,7,1168,201,1369,5.810945273631841
5210,8,1378,153,1531,9.006535947712418
5211,1,1262,771,2033,1.6368352788586251
5211,2,3278,601,3879,5.454242928452579
5211,3,5187,790,5977,6.565822784810127
5211,4,7360,693,8053,10.62049062049062
5212,1,539,378,917,1.4259259259259258
5212,2,937,131,1068,7.152671755725191
5212,3,1077,33,1110,32.63636363636363
5213,1,228,916,1144,0.24890829694323144
5214,1,68,14,82,4.857142857142857
5214,2,86,40,126,2.15
5214,3,129,17,146,7.588235294117647
5214,4,155,35,190,4.428571428571429
5214,5,194,19,213,10.210526315789474
5214,6,234,29,263,8.068965517241379
5214,7,269,46,315,5.8478260869565215
5214,8,319,26,345,12.26923076923077
5214,9,368,26,394,14.153846153846153
5214,10,408,30,438,13.6
5214,11,453,81,534,5.592592592592593
5214,12,544,449,993,1.2115812917594655
5215,1,125,330,455,0.3787878787878788
5215,2,462,274,736,1.686131386861314
5216,1,128,239,367,0.5355648535564853
5217,1,40,692,732,0.057803468208092484
5217,2,766,853,1619,0.8980070339976554
5217,3,1645,756,2401,2.175925925925926
5218,1,367,36,403,10.194444444444445
5219,1,57,59,116,0.9661016949152542
5219,2,123,24,147,5.125
5219,3,170,315,485,0.5396825396825397
5219,4,507,380,887,1.3342105263157895
5219,5,938,612,1550,1.5326797385620916
5219,6,1556,23,1579,67.65217391304348
5219,7,1640,441,2081,3.7188208616780045
5219,8,2126,550,2676,3.8654545454545453
5220,1,32,302,334,0.10596026490066225
5220,2,348,366,714,0.9508196721311475
5220,3,758,326,1084,2.3251533742331287
5220,4,1089,304,1393,3.5822368421052633
5220,5,1398,245,1643,5.706122448979592
5221,1,24,639,663,0.03755868544600939
5221,2,687,416,1103,1.6514423076923077
5221,3,1150,750,1900,1.5333333333333334
5221,4,1921,263,2184,7.304182509505703
5221,5,2206,703,2909,3.1379800853485063
5222,1,788,26,814,30.307692307692307
5222,2,3184,265,3449,12.015094339622642
5222,3,3485,186,3671,18.736559139784948
5222,4,3695,641,4336,5.764430577223089
5222,5,4364,779,5143,5.602053915275995
5222,6,5170,791,5961,6.5360303413400755
5222,7,5992,22,6014,272.3636363636364
5223,1,56,573,629,0.09773123909249563
5223,2,639,314,953,2.035031847133758
5223,3,1003,915,1918,1.0961748633879782
5223,4,1971,906,2877,2.1754966887417218
5224,1,59,540,599,0.10925925925925926
5224,2,611,422,1033,1.447867298578199
5225,1,24,438,462,0.0547945205479452
5226,1,438,928,1366,0.47198275862068967
5226,2,1375,168,1543,8.18452380952381
5226,3,1554,516,2070,3.011627906976744
5227,1,155,590,745,0.2627118644067797
5228,1,81,559,640,0.1449016100178891
5229,1,1087,896,1983,1.2131696428571428
5229,2,1988,385,2373,5.163636363636364
5230,1,32,781,813,0.040973111395646605
5231,1,2898,140,3038,20.7
5231,2,3051,341,3392,8.947214076246334
5231,3,3402,935,4337,3.6385026737967916
5231,4,4343,946,5289,4.590909090909091
5231,5,6401,599,7000,10.686143572621035
5231,6,7034,639,7673,11.007824726134585
5232,1,49,521,570,0.09404990403071017
5232,2,576,671,1247,0.8584202682563339
5232,3,1266,434,1700,2.9170506912442398
5232,4,1719,577,2296,2.979202772963605
5232,5,2354,236,2590,9.974576271186441
5233,1,167,450,617,0.3711111111111111
5233,2,794,695,1489,1.1424460431654677
5233,3,1571,684,2255,2.296783625730994
5233,4,2298,495,2793,4.642424242424243
5233,5,2849,288,3137,9.89236111111111
5234,1,57,30,87,1.9
5234,2,97,30,127,3.2333333333333334
5234,3,141,22,163,6.409090909090909
5234,4,172,34,206,5.0588235294117645
5234,5,226,23,249,9.826086956521738
5234,6,252,32,284,7.875
5234,7,286,44,330,6.5
5234,8,336,46,382,7.304347826086956
5234,9,408,70,478,5.828571428571428
5235,1,12,579,591,0.02072538860103627
5235,2,607,553,1160,1.0976491862567812
5235,3,1220,868,2088,1.4055299539170507
5235,4,2172,644,2816,3.372670807453416
5235,5,2872,590,3462,4.867796610169491
5236,1,34,73,107,0.4657534246575342
5236,2,111,73,184,1.5205479452054795
5236,3,190,47,237,4.042553191489362
5236,4,242,72,314,3.361111111111111
5237,1,30,885,915,0.03389830508474576
5237,2,949,991,1940,0.9576185671039354
5237,3,1943,248,2191,7.834677419354839
5238,1,160,672,832,0.23809523809523808
5238,2,4345,953,5298,4.559286463798531
5238,3,5384,513,5897,10.495126705653021
5239,1,366,357,723,1.0252100840336134
5239,2,728,279,1007,2.609318996415771
5240,1,3938,477,4415,8.255765199161425
5240,2,4417,508,4925,8.69488188976378
5240,3,4993,582,5575,8.579037800687285
5240,4,5601,392,5993,14.28826530612245
5240,5,6016,484,6500,12.429752066115702
5240,6,6527,691,7218,9.445730824891461
5241,1,2389,22,2411,108.5909090909091
5241,2,5544,724,6268,7.657458563535911
5241,3,6410,934,7344,6.862955032119914
5241,4,7392,714,8106,10.352941176470589
5242,1,53,65,118,0.8153846153846154
5242,2,165,429,594,0.38461538461538464
5242,3,636,431,1067,1.4756380510440836
5243,1,36,200,236,0.18
5244,1,162,437,599,0.3707093821510298
5245,1,145,600,745,0.24166666666666667
5245,2,837,686,1523,1.2201166180758019
5245,3,1539,612,2151,2.514705882352941
5246,1,54,229,283,0.23580786026200873
5246,2,294,184,478,1.5978260869565217
5246,3,489,244,733,2.0040983606557377
5246,4,741,288,1029,2.5729166666666665
5246,5,1037,298,1335,3.4798657718120807
5246,6,1343,353,1696,3.8045325779036827
5246,7,1704,319,2023,5.341692789968652
5246,8,2031,340,2371,5.973529411764706
5246,9,2379,343,2722,6.9358600583090375
5246,10,2730,354,3084,7.711864406779661
5246,11,3092,399,3491,7.74937343358396
5246,12,3499,422,3921,8.291469194312796
5247,1,294,427,721,0.6885245901639344
5247,2,724,659,1383,1.0986342943854324
5248,1,1040,634,1674,1.640378548895899
5249,1,862,126,988,6.841269841269841
5249,2,1878,138,2016,13.608695652173912
5249,3,2703,364,3067,7.425824175824176
5249,4,4112,350,4462,11.748571428571429
5250,1,42,228,270,0.18421052631578946
5250,2,301,167,468,1.8023952095808384
5251,1,39,606,645,0.06435643564356436
5251,2,668,879,1547,0.7599544937428896
5252,1,150,685,835,0.21897810218978103
5252,2,859,728,1587,1.179945054945055
5252,3,1652,604,2256,2.7350993377483444
5252,4,2280,639,2919,3.568075117370892
5253,1,161,303,464,0.5313531353135313
5253,2,472,336,808,1.4047619047619047
5253,3,816,304,1120,2.6842105263157894
5254,1,492,34,526,14.470588235294118
5254,2,941,949,1890,0.9915700737618546
5254,3,1914,175,2089,10.937142857142858
5255,1,17,1006,1023,0.016898608349900597
5255,2,1038,743,1781,1.3970390309555856
5255,3,1794,927,2721,1.935275080906149
5255,4,2727,1028,3755,2.65272373540856
5255,5,3757,383,4140,9.809399477806789
5255,6,4172,159,4331,26.238993710691823
5255,7,4348,489,4837,8.89161554192229
5255,8,4844,143,4987,33.87412587412587
5255,9,4997,482,5479,10.367219917012449
5255,10,5499,453,5952,12.139072847682119
5255,11,5964,394,6358,15.137055837563452
5255,12,6368,245,6613,25.991836734693877
5256,1,11,679,690,0.016200294550810016
5257,1,29,612,641,0.04738562091503268
5257,2,663,525,1188,1.262857142857143
5257,3,1211,783,1994,1.5466155810983397
5257,4,2027,349,2376,5.808022922636103
5257,5,2401,353,2754,6.801699716713881
5257,6,2779,501,3280,5.54690618762475
5257,7,3329,282,3611,11.804964539007091
5257,8,3628,293,3921,12.382252559726963
5257,9,3944,167,4111,23.61676646706587
5257,10,4154,281,4435,14.782918149466193
5257,11,4502,387,4889,11.633074935400517
5257,12,4924,795,5719,6.1937106918239
5257,13,5744,781,6525,7.354673495518566
5257,14,6563,989,7552,6.635995955510617
5258,1,25,1003,1028,0.024925224327018942
5258,2,1036,737,1773,1.4056987788331072
5258,3,1793,843,2636,2.1269276393831555
5259,1,38,724,762,0.052486187845303865
5260,1,38,297,335,0.12794612794612795
5261,1,271,208,479,1.3028846153846154
5261,2,509,257,766,1.9805447470817121
5261,3,837,250,1087,3.348
5261,4,1135,247,1382,4.5951417004048585
5261,5,1409,254,1663,5.547244094488189
5261,6,1770,305,2075,5.80327868852459
5261,7,2182,276,2458,7.905797101449275
5261,8,2472,201,2673,12.298507462686567
5261,9,2725,323,3048,8.436532507739939
5261,10,3071,228,3299,13.469298245614034
5261,11,3332,239,3571,13.94142259414226
5262,1,13,286,299,0.045454545454545456
5262,2,321,331,652,0.9697885196374623
5262,3,667,373,1040,1.7882037533512065
5263,1,17,122,139,0.13934426229508196
5263,2,143,320,463,0.446875
5263,3,473,691,1164,0.6845151953690304
5263,4,1184,644,1828,1.8385093167701863
5263,5,1860,606,2466,3.0693069306930694
5264,1,80,333,413,0.24024024024024024
5264,2,462,655,1117,0.7053435114503817
5264,3,1148,473,1621,2.427061310782241
5265,1,46,912,958,0.05043859649122807
5265,2,983,717,1700,1.3709902370990237
5265,3,2386,948,3334,2.5168776371308015
5265,4,3358,944,4302,3.5572033898305087
5265,5,4316,622,4938,6.938906752411576
5265,6,4964,294,5258,16.8843537414966
5265,7,5289,941,6230,5.620616365568544
5265,8,6282,195,6477,32.215384615384615
5265,9,6492,912,7404,7.118421052631579
5266,1,51,158,209,0.3227848101265823
5266,2,843,733,1576,1.150068212824011
5267,1,58,964,1022,0.06016597510373444
5267,2,1024,180,1204,5.688888888888889
5268,1,31,243,274,0.12757201646090535
5268,2,287,267,554,1.0749063670411985
5268,3,583,244,827,2.389344262295082
5268,4,841,358,1199,2.3491620111731844
5269,1,653,594,1247,1.0993265993265993
5269,2,1275,597,1872,2.135678391959799
5270,1,9,150,159,0.06
5270,2,172,106,278,1.6226415094339623
5270,3,292,86,378,3.395348837209302
5270,4,400,142,542,2.816901408450704
5270,5,559,176,735,3.1761363636363638
5271,1,24,111,135,0.21621621621621623
5272,1,1898,640,2538,2.965625
5272,2,2554,214,2768,11.934579439252337
5272,3,2780,186,2966,14.946236559139784
5272,4,2973,202,3175,14.717821782178218
5272,5,3188,368,3556,8.66304347826087
5272,6,4840,58,4898,83.44827586206897
5272,7,6273,385,6658,16.293506493506495
5273,1,3708,28,3736,132.42857142857142
5273,2,7607,103,7710,73.85436893203884
5274,1,353,292,645,1.2089041095890412
5274,2,653,325,978,2.0092307692307694
5275,1,23,428,451,0.053738317757009345
5275,2,464,534,998,0.8689138576779026
5275,3,1037,527,1564,1.967741935483871
5275,4,1597,649,2246,2.4607087827426812
5275,5,2280,744,3024,3.064516129032258
5276,1,68,622,690,0.10932475884244373
5276,2,725,689,1414,1.0522496371552976
5276,3,1461,687,2148,2.126637554585153
5276,4,2166,947,3113,2.287222808870116
5276,5,3158,913,4071,3.4589266155531218
5276,6,4120,494,4614,8.34008097165992
5276,7,4632,687,5319,6.74235807860262
5276,8,5384,986,6370,5.460446247464503
5276,9,6433,813,7246,7.9126691266912665
5276,10,7262,278,7540,26.12230215827338
5276,11,7549,454,8003,16.62775330396476
5277,1,490,847,1337,0.5785123966942148
5278,1,70,61,131,1.1475409836065573
5278,2,143,597,740,0.23953098827470687
5278,3,744,348,1092,2.1379310344827585
5278,4,1121,417,1538,2.6882494004796165
5278,5,1598,152,1750,10.513157894736842
5278,6,1781,351,2132,5.074074074074074
5278,7,2171,409,2580,5.308068459657702
5279,1,329,419,748,0.7852028639618138
5279,2,967,283,1250,3.4169611307420493
5279,3,1256,97,1353,12.948453608247423
5280,1,54,803,857,0.06724782067247821
5280,2,864,704,1568,1.2272727272727273
5281,1,404,801,1205,0.5043695380774033
5281,2,1207,801,2008,1.5068664169787764
5281,3,2010,88,2098,22.84090909090909
5282,1,25,306,331,0.08169934640522876
5283,1,12,571,583,0.021015761821366025
5283,2,595,847,1442,0.7024793388429752
5284,1,207,11,218,18.818181818181817
5284,2,272,134,406,2.029850746268657
5284,3,487,193,680,2.523316062176166
5284,4,716,164,880,4.365853658536586
5284,5,906,189,1095,4.7936507936507935
5285,1,173,443,616,0.3905191873589165
5285,2,646,456,1102,1.4166666666666667
5285,3,1113,222,1335,5.013513513513513
5285,4,1355,246,1601,5.508130081300813
5286,1,13,617,630,0.02106969205834684
5287,1,18,92,110,0.1956521739130435
5287,2,136,89,225,1.5280898876404494
5287,3,241,332,573,0.7259036144578314
5287,4,580,360,940,1.6111111111111112
5287,5,974,301,1275,3.2358803986710964
5287,6,1312,481,1793,2.727650727650728
5288,1,2508,438,2946,5.726027397260274
5288,2,3232,372,3604,8.688172043010752
5288,3,3668,546,4214,6.717948717948718
5288,4,4354,464,4818,9.383620689655173
5288,5,4985,393,5378,12.684478371501273
5288,6,5430,377,5807,14.403183023872678
5288,7,6361,400,6761,15.9025
5288,8,6870,301,7171,22.823920265780732
5288,9,7231,166,7397,43.56024096385542
5288,10,7456,284,7740,26.253521126760564
5289,1,42,737,779,0.05698778833107191
5289,2,788,798,1586,0.9874686716791979
5289,3,1609,485,2094,3.3175257731958765
5289,4,2111,368,2479,5.736413043478261
5289,5,2490,213,2703,11.690140845070422
5289,6,2716,74,2790,36.7027027027027
5290,1,13,508,521,0.025590551181102362
5291,1,1535,1001,2536,1.5334665334665334
5291,2,2561,596,3157,4.296979865771812
5291,3,3235,789,4024,4.100126742712294
5291,4,4104,746,4850,5.501340482573727
5292,1,451,270,721,1.6703703703703703
5292,2,743,81,824,9.17283950617284
5292,3,854,26,880,32.84615384615385
5292,4,911,348,1259,2.617816091954023
5292,5,1277,136,1413,9.389705882352942
5292,6,1428,290,1718,4.924137931034482
5293,1,11,706,717,0.015580736543909348
5294,1,90,691,781,0.13024602026049203
5295,1,120,843,963,0.1423487544483986
5296,1,631,549,1180,1.1493624772313298
5296,2,1213,589,1802,2.059422750424448
5296,3,1824,653,2477,2.7932618683001533
5297,1,394,803,1197,0.49066002490660027
5297,2,1393,510,1903,2.731372549019608
5298,1,10,829,839,0.012062726176115802
5298,2,876,676,1552,1.2958579881656804
5298,3,1560,980,2540,1.5918367346938775
5298,4,2632,343,2975,7.673469387755102
5298,5,3011,541,3552,5.565619223659889
5298,6,3569,982,4551,3.634419551934827
5298,7,4560,614,5174,7.4267100977198695
5298,8,5205,959,6164,5.427528675703858
5298,9,6189,831,7020,7.447653429602888
5298,10,7040,809,7849,8.702101359703338
5299,1,42,139,181,0.302158273381295
5299,2,189,177,366,1.0677966101694916
5299,3,376,191,567,1.968586387434555
5300,1,15,311,326,0.04823151125401929
5300,2,356,404,760,0.8811881188118812
5300,3,767,471,1238,1.6284501061571126
5300,4,1259,345,1604,3.6492753623188405
5300,5,1618,523,2141,3.0936902485659656
5300,6,2166,296,2462,7.3175675675675675
5300,7,2493,480,2973,5.19375
5300,8,2997,199,3196,15.06030150753769
5300,9,3221,228,3449,14.12719298245614
5300,10,3481,336,3817,10.360119047619047
5300,11,3996,539,4535,7.413729128014842
5301,1,476,67,543,7.104477611940299
5301,2,642,154,796,4.1688311688311686
5301,3,1234,590,1824,2.0915254237288137
5302,1,222,334,556,0.6646706586826348
5303,1,9,57,66,0.15789473684210525
5303,2,71,137,208,0.5182481751824818
5303,3,215,1030,1245,0.2087378640776699
5303,4,1248,1008,2256,1.2380952380952381
5303,5,2259,220,2479,10.268181818181818
5303,6,2483,131,2614,18.954198473282442
5303,7,2630,503,3133,5.2286282306163026
5303,8,3179,201,3380,15.81592039800995
5303,9,3399,57,3456,59.63157894736842
5303,10,3506,851,4357,4.119858989424207
5303,11,4410,249,4659,17.710843373493976
5303,12,4679,687,5366,6.810771470160116
5304,1,16,700,716,0.022857142857142857
5304,2,729,337,1066,2.163204747774481
5304,3,1077,593,1670,1.8161888701517706
5304,4,1685,817,2502,2.0624235006119953
5304,5,2513,335,2848,7.501492537313433
5304,6,2874,718,3592,4.002785515320334
5305,1,22,434,456,0.05069124423963134
5305,2,458,482,940,0.950207468879668
5306,1,38,492,530,0.07723577235772358
5306,2,597,304,901,1.9638157894736843
5306,3,988,468,1456,2.111111111111111
5307,1,40,208,248,0.19230769230769232
5307,2,278,222,500,1.2522522522522523
5307,3,513,134,647,3.828358208955224
5307,4,655,90,745,7.277777777777778
5307,5,752,320,1072,2.35
5307,6,1081,339,1420,3.1887905604719764
5307,7,1434,725,2159,1.9779310344827585
5307,8,2168,464,2632,4.672413793103448
5307,9,2732,116,2848,23.551724137931036
5307,10,2851,319,3170,8.93730407523511
5307,11,3327,178,3505,18.691011235955056
5307,12,3719,276,3995,13.47463768115942
5307,13,4047,265,4312,15.271698113207547
5307,14,4340,212,4552,20.471698113207548
5307,15,5789,474,6263,12.213080168776372
5307,16,6313,301,6614,20.973421926910298
5307,17,6627,462,7089,14.344155844155845
5307,18,7110,640,7750,11.109375
5307,19,7767,234,8001,33.19230769230769
5308,1,592,102,694,5.803921568627451
5308,2,739,4,743,184.75
5308,3,807,741,1548,1.0890688259109311
5308,4,1561,613,2174,2.5464926590538335
5308,5,2263,894,3157,2.5313199105145414
5308,6,3238,795,4033,4.072955974842768
5308,7,4046,888,4934,4.556306306306307
5308,8,4953,917,5870,5.401308615049073
5308,9,5873,447,6320,13.138702460850112
5308,10,6358,907,7265,7.009922822491731
5309,1,759,1223,1982,0.6206050695012265
5309,2,2090,209,2299,10.0
5309,3,2358,447,2805,5.275167785234899
5309,4,2897,600,3497,4.828333333333333
5309,5,3557,645,4202,5.514728682170543
5310,1,36,865,901,0.04161849710982659
5310,2,931,529,1460,1.7599243856332702
5310,3,1500,576,2076,2.6041666666666665
5310,4,2111,526,2637,4.013307984790875
5310,5,2673,615,3288,4.3463414634146345
5310,6,3317,521,3838,6.366602687140115
5310,7,3892,525,4417,7.413333333333333
5310,8,4437,355,4792,12.498591549295774
5311,1,15,393,408,0.03816793893129771
5312,1,592,26,618,22.76923076923077
5312,2,657,4,661,164.25
5312,3,761,1449,2210,0.5251897860593513
5312,4,2224,353,2577,6.30028328611898
5312,5,2588,86,2674,30.093023255813954
5312,6,5313,837,6150,6.347670250896058
5313,1,163,954,1117,0.1708595387840671
5313,2,1153,1007,2160,1.1449851042701091
5313,3,2202,997,3199,2.208625877632899
5313,4,3236,1042,4278,3.105566218809981
5313,5,4312,892,5204,4.834080717488789
5313,6,5239,939,6178,5.579339723109691
5313,7,6215,836,7051,7.434210526315789
5313,8,7083,792,7875,8.943181818181818
5314,1,62,601,663,0.10316139767054909
5314,2,732,764,1496,0.9581151832460733
5314,3,1511,68,1579,22.220588235294116
5314,4,1619,523,2142,3.095602294455067
5314,5,2210,650,2860,3.4
5314,6,2938,676,3614,4.346153846153846
5314,7,3650,536,4186,6.809701492537314
5314,8,4197,418,4615,10.04066985645933
5314,9,4618,367,4985,12.583106267029972
5314,10,5000,95,5095,52.63157894736842
5314,11,5135,390,5525,13.166666666666666
5314,12,5528,58,5586,95.3103448275862
5314,13,5591,168,5759,33.279761904761905
5315,1,510,540,1050,0.9444444444444444
5316,1,153,360,513,0.425
5317,1,23,1065,1088,0.0215962441314554
5317,2,1138,2070,3208,0.5497584541062802
5317,3,3245,1235,4480,2.6275303643724697
5317,4,4562,1322,5884,3.4508320726172466
5318,1,41,602,643,0.0681063122923588
5318,2,684,444,1128,1.5405405405405406
5318,3,1169,360,1529,3.2472222222222222
5318,4,1543,425,1968,3.6305882352941174
5318,5,2076,365,2441,5.6876712328767125
5319,1,33,352,385,0.09375
5319,2,397,393,790,1.0101781170483461
5319,3,820,424,1244,1.9339622641509433
5319,4,1267,713,1980,1.7769985974754559
5319,5,1990,477,2467,4.171907756813417
5319,6,2483,349,2832,7.114613180515759
5319,7,2850,266,3116,10.714285714285714
5319,8,3131,954,4085,3.2819706498951784
5319,9,4105,503,4608,8.1610337972167
5319,10,4625,701,5326,6.59771754636234
5319,11,5344,663,6007,8.060331825037707
5319,12,6028,596,6624,10.114093959731544
5319,13,6633,394,7027,16.83502538071066
5319,14,7053,661,7714,10.670196671709531
5320,1,42,915,957,0.04590163934426229
5320,2,960,504,1464,1.9047619047619047
5321,1,95,538,633,0.17657992565055763
5321,2,728,537,1265,1.355679702048417
5321,3,1362,590,1952,2.3084745762711862
5321,4,1989,919,2908,2.1643090315560394
5321,5,2947,810,3757,3.6382716049382715
5322,1,162,290,452,0.5586206896551724
5322,2,459,387,846,1.186046511627907
5322,3,957,876,1833,1.0924657534246576
5322,4,1854,875,2729,2.1188571428571428
5322,5,2749,874,3623,3.145308924485126
5322,6,3694,834,4528,4.429256594724221
5322,7,4570,266,4836,17.18045112781955
5322,8,4918,309,5227,15.915857605177994
5322,9,5279,526,5805,10.036121673003802
5323,1,23,12,35,1.9166666666666667
5323,2,69,650,719,0.10615384615384615
5324,1,827,495,1322,1.6707070707070708
5324,2,1330,475,1805,2.8
5324,3,1813,571,2384,3.1751313485113837
5324,4,2392,503,2895,4.755467196819086
5325,1,207,752,959,0.2752659574468085
5325,2,1068,892,1960,1.1973094170403586
5326,1,26,19,45,1.368421052631579
5327,1,97,310,407,0.31290322580645163
5327,2,454,367,821,1.237057220708447
5327,3,868,441,1309,1.9682539682539681
5327,4,1338,409,1747,3.271393643031785
5328,1,902,876,1778,1.0296803652968036
5328,2,1781,850,2631,2.0952941176470588
5328,3,2662,860,3522,3.0953488372093023
5328,4,3535,843,4378,4.193357058125741
5328,5,4389,270,4659,16.255555555555556
5328,6,4708,831,5539,5.66546329723225
5328,7,5550,815,6365,6.809815950920245
5328,8,6456,571,7027,11.306479859894921
5329,1,130,894,1024,0.14541387024608501
5329,2,1036,422,1458,2.4549763033175354
5329,3,1467,767,2234,1.9126466753585398
5329,4,2246,660,2906,3.403030303030303
5329,5,2917,641,3558,4.5507020280811235
5330,1,111,680,791,0.16323529411764706
5330,2,811,289,1100,2.8062283737024223
5331,1,328,844,1172,0.3886255924170616
5331,2,1175,588,1763,1.998299319727891
5332,1,457,754,1211,0.6061007957559682
5332,2,1225,361,1586,3.3933518005540164
5332,3,1599,551,2150,2.901996370235935
5332,4,2176,344,2520,6.325581395348837
5332,5,2545,568,3113,4.480633802816901
5332,6,3129,747,3876,4.188755020080321
5333,1,1187,1030,2217,1.1524271844660194
5333,2,2316,892,3208,2.596412556053812
5333,3,3230,100,3330,32.3
5333,4,3363,443,3806,7.591422121896162
5333,5,3814,534,4348,7.142322097378277
5333,6,4372,546,4918,8.007326007326007
5333,7,4938,697,5635,7.084648493543759
5333,8,6632,12,6644,552.6666666666666
5333,9,7592,363,7955,20.914600550964188
5334,1,471,722,1193,0.6523545706371191
5334,2,1213,923,2136,1.314192849404117
5335,1,52,765,817,0.06797385620915032
5335,2,1110,333,1443,3.3333333333333335
5335,3,1506,621,2127,2.42512077294686
5335,4,2153,712,2865,3.023876404494382
5335,5,2904,655,3559,4.433587786259542
5335,6,3594,665,4259,5.404511278195489
5335,7,4289,920,5209,4.66195652173913
5335,8,5229,152,5381,34.401315789473685
5335,9,6059,826,6885,7.335351089588378
5336,1,288,241,529,1.1950207468879668
5336,2,569,216,785,2.634259259259259
5337,1,43,74,117,0.581081081081081
5337,2,555,533,1088,1.0412757973733584
5337,3,1623,405,2028,4.007407407407407
5337,4,2143,401,2544,5.344139650872818
5337,5,2590,44,2634,58.86363636363637
5337,6,2752,419,3171,6.5680190930787585
5337,7,3253,387,3640,8.405684754521964
5338,1,97,27,124,3.5925925925925926
5338,2,131,129,260,1.0155038759689923
5338,3,292,153,445,1.908496732026144
5338,4,451,140,591,3.2214285714285715
5338,5,595,128,723,4.6484375
5338,6,732,135,867,5.4222222222222225
5338,7,877,119,996,7.369747899159663
5338,8,1028,131,1159,7.847328244274809
5338,9,1165,134,1299,8.694029850746269
5338,10,1323,154,1477,8.590909090909092
5338,11,1487,139,1626,10.697841726618705
5339,1,85,59,144,1.4406779661016949
5339,2,954,748,1702,1.2754010695187166
5340,1,38,605,643,0.0628099173553719
5341,1,47,388,435,0.1211340206185567
5341,2,443,388,831,1.1417525773195876
5342,1,77,813,890,0.09471094710947109
5342,2,901,254,1155,3.547244094488189
5343,1,94,835,929,0.1125748502994012
5344,1,19,345,364,0.05507246376811594
5344,2,376,112,488,3.357142857142857
5344,3,506,309,815,1.6375404530744337
5344,4,838,269,1107,3.1152416356877324
5344,5,1113,233,1346,4.776824034334764
5344,6,1389,522,1911,2.660919540229885
5344,7,1923,646,2569,2.976780185758514
5345,1,360,565,925,0.6371681415929203
5346,1,11,383,394,0.028720626631853787
5346,2,409,156,565,2.621794871794872
5347,1,300,534,834,0.5617977528089888
5347,2,842,515,1357,1.6349514563106795
5347,3,1367,583,1950,2.3447684391080617
5348,1,27,864,891,0.03125
5349,1,58,376,434,0.15425531914893617
5350,1,144,811,955,0.17755856966707767
5350,2,1039,611,1650,1.7004909983633387
5351,1,68,725,793,0.09379310344827586
5351,2,812,775,1587,1.047741935483871
5352,1,34,618,652,0.05501618122977346
5352,2,654,448,1102,1.4598214285714286
5352,3,1137,679,1816,1.6745213549337261
5352,4,1824,391,2215,4.664961636828645
5352,5,2217,539,2756,4.11317254174397
5352,6,2758,376,3134,7.335106382978723
5352,7,3146,478,3624,6.581589958158996
5352,8,3626,216,3842,16.787037037037038
5352,9,3844,466,4310,8.24892703862661
5352,10,4337,388,4725,11.177835051546392
5352,11,4733,271,5004,17.464944649446494
5352,12,5006,425,5431,11.778823529411765
5352,13,5448,296,5744,18.405405405405407
5352,14,5772,357,6129,16.168067226890756
5352,15,6140,488,6628,12.581967213114755
5352,16,6646,540,7186,12.307407407407407
5352,17,7196,475,7671,15.149473684210527
5352,18,7682,84,7766,91.45238095238095
5353,1,23,315,338,0.07301587301587302
5354,1,34,60,94,0.5666666666666667
5354,2,1092,629,1721,1.7360890302066774
5354,3,1741,148,1889,11.763513513513514
5355,1,135,939,1074,0.14376996805111822
5355,2,1088,618,1706,1.7605177993527508
5355,3,1719,119,1838,14.445378151260504
5355,4,1848,118,1966,15.661016949152541
5355,5,1985,957,2942,2.0741901776384535
5355,6,2949,139,3088,21.215827338129497
5355,7,3101,741,3842,4.184885290148448
5355,8,3970,953,4923,4.16579223504722
5355,9,5321,994,6315,5.353118712273642
5355,10,6403,994,7397,6.441649899396379
5356,1,59,646,705,0.0913312693498452
5356,2,762,456,1218,1.6710526315789473
5356,3,1280,552,1832,2.318840579710145
5356,4,1910,466,2376,4.098712446351931
5356,5,2400,396,2796,6.0606060606060606
5356,6,2847,473,3320,6.019027484143764
5356,7,3420,1005,4425,3.4029850746268657
5356,8,4432,222,4654,19.963963963963963
5356,9,4718,566,5284,8.335689045936396
5356,10,5347,795,6142,6.725786163522012
5357,1,236,630,866,0.3746031746031746
5357,2,891,691,1582,1.2894356005788712
5357,3,1601,783,2384,2.044699872286079
5357,4,2413,533,2946,4.527204502814259
5358,1,26,516,542,0.050387596899224806
5358,2,555,318,873,1.7452830188679245
5358,3,897,658,1555,1.3632218844984803
5358,4,1565,544,2109,2.8768382352941178
5358,5,2132,517,2649,4.123791102514507
5359,1,9,610,619,0.014754098360655738
5359,2,639,607,1246,1.0527182866556837
5359,3,1257,429,1686,2.93006993006993
5359,4,3997,533,4530,7.49906191369606
5359,5,7439,480,7919,15.497916666666667
5360,1,383,767,1150,0.49934810951760106
5360,2,1349,866,2215,1.5577367205542725
5360,3,2303,659,2962,3.494688922610015
5361,1,14,598,612,0.023411371237458192
5361,2,649,456,1105,1.4232456140350878
5361,3,1119,237,1356,4.7215189873417724
5361,4,1375,155,1530,8.870967741935484
5361,5,1546,99,1645,15.616161616161616
5361,6,1668,38,1706,43.89473684210526
5362,1,7,216,223,0.032407407407407406
5362,2,286,532,818,0.5375939849624061
5362,3,859,519,1378,1.6551059730250481
5362,4,1405,545,1950,2.5779816513761467
5362,5,1980,648,2628,3.0555555555555554
5362,6,2666,927,3593,2.8759439050701188
5362,7,3615,890,4505,4.061797752808989
5363,1,37,518,555,0.07142857142857142
5363,2,566,216,782,2.6203703703703702
5363,3,799,489,1288,1.6339468302658486
5364,1,442,82,524,5.390243902439025
5364,2,532,47,579,11.319148936170214
5364,3,1032,558,1590,1.8494623655913978
5364,4,1618,640,2258,2.528125
5365,1,162,332,494,0.4879518072289157
5365,2,508,45,553,11.28888888888889
5366,1,73,637,710,0.11459968602825746
5366,2,724,984,1708,0.7357723577235772
5366,3,1719,255,1974,6.741176470588235
5367,1,78,858,936,0.09090909090909091
5367,2,981,574,1555,1.7090592334494774
5367,3,1564,1003,2567,1.5593220338983051
5367,4,3018,1008,4026,2.994047619047619
5367,5,4048,412,4460,9.825242718446601
5368,1,31,529,560,0.05860113421550094
5368,2,1563,743,2306,2.1036339165545086
5368,3,2337,387,2724,6.038759689922481
5369,1,99,840,939,0.11785714285714285
5369,2,942,305,1247,3.088524590163934
5370,1,186,775,961,0.24
5370,2,983,808,1791,1.2165841584158417
5370,3,1811,965,2776,1.8766839378238342
5370,4,2809,376,3185,7.470744680851064
5371,1,1505,1023,2528,1.4711632453567938
5371,2,2530,67,2597,37.76119402985075
5371,3,3064,717,3781,4.273361227336123
5372,1,57,27,84,2.111111111111111
5372,2,1713,396,2109,4.325757575757576
5372,3,3339,379,3718,8.810026385224274
5372,4,5461,401,5862,13.618453865336658
5373,1,842,280,1122,3.007142857142857
5374,1,142,89,231,1.595505617977528
5374,2,316,510,826,0.6196078431372549
5374,3,880,389,1269,2.2622107969151672
5374,4,1561,471,2032,3.314225053078556
5375,1,13,414,427,0.03140096618357488
5375,2,454,548,1002,0.8284671532846716
5375,3,1014,555,1569,1.827027027027027
5375,4,1585,409,1994,3.8753056234718826
5376,1,1455,65,1520,22.384615384615383
5376,2,1555,49,1604,31.73469387755102
5376,3,1741,1033,2774,1.685382381413359
5376,4,2776,190,2966,14.610526315789473
5376,5,3075,179,3254,17.178770949720672
5377,1,682,3,685,227.33333333333334
5377,2,1843,3,1846,614.3333333333334
5378,1,120,415,535,0.2891566265060241
5379,1,1193,529,1722,2.2551984877126654
5379,2,1823,1105,2928,1.6497737556561085
5379,3,2976,1031,4007,2.886517943743938
5379,4,4147,1060,5207,3.9122641509433964
5379,5,5251,263,5514,19.96577946768061
5379,6,5529,657,6186,8.415525114155251
5379,7,6194,801,6995,7.7328339575530585
5379,8,7003,503,7506,13.922465208747514
5379,9,7515,590,8105,12.73728813559322
5380,1,186,394,580,0.4720812182741117
5381,1,118,241,359,0.4896265560165975
5381,2,375,188,563,1.9946808510638299
5382,1,277,8,285,34.625
5382,2,309,294,603,1.0510204081632653
5383,1,508,721,1229,0.7045769764216366
5384,1,59,1213,1272,0.048639736191261336
5384,2,1289,329,1618,3.917933130699088
5384,3,1635,186,1821,8.790322580645162
5384,4,1840,501,2341,3.6726546906187623
5385,1,124,882,1006,0.14058956916099774
5385,2,1029,678,1707,1.5176991150442478
5386,1,11,855,866,0.012865497076023392
5386,2,888,475,1363,1.8694736842105264
5387,1,136,834,970,0.1630695443645084
5387,2,979,986,1965,0.9929006085192698
5387,3,1978,1028,3006,1.924124513618677
5387,4,3118,850,3968,3.6682352941176473
5387,5,3986,974,4960,4.092402464065708
5387,6,5005,45,5050,111.22222222222223
5387,7,5105,1049,6154,4.866539561487131
5387,8,6172,1040,7212,5.934615384615385
5388,1,2216,304,2520,7.2894736842105265
5388,2,2537,357,2894,7.106442577030812
5388,3,2903,430,3333,6.751162790697674
5388,4,3343,364,3707,9.184065934065934
5389,1,32,48,80,0.6666666666666666
5389,2,101,353,454,0.28611898016997167
5389,3,458,357,815,1.2829131652661065
5389,4,821,385,1206,2.1324675324675324
5389,5,1208,374,1582,3.229946524064171
5390,1,29,963,992,0.030114226375908618
5391,1,104,762,866,0.13648293963254593
5392,1,19,638,657,0.029780564263322883
5392,2,674,421,1095,1.6009501187648456
5392,3,1121,69,1190,16.246376811594203
5393,1,45,937,982,0.048025613660619
5393,2,988,427,1415,2.3138173302107727
5393,3,1428,458,1886,3.1179039301310043
5393,4,1895,508,2403,3.7303149606299213
5394,1,298,933,1231,0.31939978563772775
5394,2,1237,624,1861,1.982371794871795
5395,1,69,304,373,0.22697368421052633
5395,2,425,235,660,1.8085106382978724
5396,1,43,326,369,0.13190184049079753
5396,2,389,186,575,2.0913978494623655
5396,3,592,48,640,12.333333333333334
5396,4,655,39,694,16.794871794871796
5396,5,712,50,762,14.24
5396,6,769,34,803,22.61764705882353
5396,7,811,38,849,21.342105263157894
5396,8,853,37,890,23.054054054054053
5396,9,898,64,962,14.03125
5396,10,975,279,1254,3.4946236559139785
5396,11,1269,25,1294,50.76
5396,12,1349,261,1610,5.168582375478927
5396,13,1626,285,1911,5.705263157894737
5396,14,1929,441,2370,4.374149659863946
5396,15,2380,427,2807,5.573770491803279
5396,16,2821,489,3310,5.768916155419223
5397,1,10,143,153,0.06993006993006994
5397,2,164,452,616,0.36283185840707965
5397,3,624,429,1053,1.4545454545454546
5397,4,1067,196,1263,5.4438775510204085
5398,1,181,385,566,0.4701298701298701
5399,1,938,464,1402,2.021551724137931
5399,2,1427,1242,2669,1.1489533011272142
5400,1,96,986,1082,0.0973630831643002
5400,2,1096,806,1902,1.3598014888337469
5400,3,1923,280,2203,6.867857142857143
5400,4,2233,855,3088,2.6116959064327485
5400,5,3104,563,3667,5.513321492007105
5400,6,3682,801,4483,4.596754057428215
5400,7,4509,901,5410,5.004439511653718
5400,8,5439,365,5804,14.901369863013699
5400,9,5821,183,6004,31.808743169398905
5400,10,6011,555,6566,10.830630630630631
5400,11,6576,575,7151,11.436521739130434
5400,12,7167,269,7436,26.643122676579925
5400,13,7457,302,7759,24.692052980132452
5401,1,85,682,767,0.12463343108504399
5401,2,787,751,1538,1.047936085219707
5401,3,1552,487,2039,3.186858316221766
5402,1,60,81,141,0.7407407407407407
5402,2,545,585,1130,0.9316239316239316
5403,1,38,718,756,0.052924791086350974
5403,2,767,87,854,8.816091954022989
5403,3,862,154,1016,5.597402597402597
5403,4,1033,233,1266,4.4334763948497855
5403,5,1283,440,1723,2.915909090909091
5403,6,1744,138,1882,12.63768115942029
5403,7,1898,105,2003,18.076190476190476
5403,8,2022,109,2131,18.55045871559633
5403,9,2146,468,2614,4.585470085470085
5404,1,98,711,809,0.13783403656821377
5405,1,81,920,1001,0.08804347826086957
5405,2,1008,438,1446,2.3013698630136985
5405,3,1513,667,2180,2.2683658170914542
5405,4,2308,904,3212,2.5530973451327434
5405,5,3421,934,4355,3.6627408993576016
5405,6,4362,938,5300,4.650319829424307
5405,7,5307,513,5820,10.345029239766081
5405,8,5907,875,6782,6.750857142857143
5405,9,6789,465,7254,14.6
5405,10,7313,722,8035,10.128808864265928
5406,1,229,270,499,0.8481481481481481
5406,2,665,380,1045,1.75
5407,1,10,22,32,0.45454545454545453
5407,2,49,78,127,0.6282051282051282
5408,1,21,8,29,2.625
5408,2,38,11,49,3.4545454545454546
5408,3,78,843,921,0.09252669039145907
5408,4,957,400,1357,2.3925
5408,5,1386,867,2253,1.5986159169550174
5408,6,2263,701,2964,3.2282453637660486
5408,7,2974,857,3831,3.47024504084014
5408,8,3843,990,4833,3.881818181818182
5408,9,4849,311,5160,15.591639871382636
5408,10,5182,1043,6225,4.968360498561841
5408,11,6235,346,6581,18.020231213872833
5408,12,6623,1094,7717,6.053930530164534
5409,1,59,2514,2573,0.023468575974542563
5409,2,2684,2535,5219,1.0587771203155818
5409,3,6626,224,6850,29.580357142857142
5410,1,6,25,31,0.24
5410,2,109,103,212,1.058252427184466
5410,3,259,90,349,2.8777777777777778
5410,4,397,394,791,1.0076142131979695
5410,5,799,437,1236,1.82837528604119
5410,6,1244,301,1545,4.132890365448505
5410,7,1553,300,1853,5.176666666666667
5410,8,1861,324,2185,5.743827160493828
5410,9,2193,240,2433,9.1375
5411,1,30,647,677,0.04636785162287481
5411,2,680,395,1075,1.7215189873417722
5412,1,137,1174,1311,0.11669505962521294
5412,2,1385,1091,2476,1.2694775435380385
5412,3,2493,870,3363,2.8655172413793104
5412,4,3449,1083,4532,3.1846722068328717
5413,1,320,964,1284,0.33195020746887965
5413,2,1291,983,2274,1.313326551373347
5413,3,2306,974,3280,2.3675564681724848
5414,1,129,10,139,12.9
5414,2,203,7,210,29.0
5414,3,354,8,362,44.25
5414,4,383,19,402,20.157894736842106
5414,5,413,10,423,41.3
5414,6,434,9,443,48.22222222222222
5414,7,522,14,536,37.285714285714285
5414,8,541,29,570,18.655172413793103
5414,9,575,13,588,44.23076923076923
5414,10,593,25,618,23.72
5414,11,622,19,641,32.73684210526316
5414,12,711,14,725,50.785714285714285
5414,13,745,31,776,24.032258064516128
5414,14,788,14,802,56.285714285714285
5414,15,816,18,834,45.333333333333336
5414,16,905,18,923,50.27777777777778
5414,17,959,15,974,63.93333333333333
5414,18,1136,29,1165,39.172413793103445
5414,19,1219,16,1235,76.1875
5414,20,1239,45,1284,27.533333333333335
5414,21,1305,20,1325,65.25
5414,22,1333,48,1381,27.770833333333332
5414,23,1391,43,1434,32.348837209302324
5414,24,2035,55,2090,37.0
5414,25,2106,7,2113,300.85714285714283
5414,26,2175,11,2186,197.72727272727272
5414,27,2275,37,2312,61.486486486486484
5414,28,2324,64,2388,36.3125
5414,29,2399,2,2401,1199.5
5415,1,15,717,732,0.02092050209205021
5416,1,721,924,1645,0.7803030303030303
5416,2,1663,625,2288,2.6608
5416,3,2313,732,3045,3.1598360655737703
5416,4,3063,455,3518,6.731868131868132
5416,5,3572,1027,4599,3.4780915287244403
5416,6,4683,858,5541,5.458041958041958
5416,7,5563,1059,6622,5.253068932955618
5417,1,77,925,1002,0.08324324324324324
5417,2,1064,1024,2088,1.0390625
5417,3,2117,416,2533,5.0889423076923075
5418,1,44,4,48,11.0
5418,2,480,349,829,1.3753581661891117
5419,1,30,514,544,0.058365758754863814
5420,1,2470,526,2996,4.695817490494297
5420,2,3088,925,4013,3.3383783783783785
5421,1,24,526,550,0.045627376425855515
5422,1,398,781,1179,0.5096030729833547
5422,2,1229,720,1949,1.7069444444444444
5423,1,946,794,1740,1.1914357682619647
5424,1,73,623,696,0.11717495987158909
5424,2,698,596,1294,1.1711409395973154
5424,3,1296,702,1998,1.8461538461538463
5425,1,34,321,355,0.1059190031152648
5425,2,364,386,750,0.9430051813471503
5425,3,771,452,1223,1.7057522123893805
5425,4,1230,209,1439,5.885167464114833
5425,5,1452,371,1823,3.9137466307277626
5425,6,1849,397,2246,4.657430730478589
5426,1,26,461,487,0.05639913232104121
5426,2,505,386,891,1.3082901554404145
5426,3,902,231,1133,3.9047619047619047
5427,1,9,45,54,0.2
5428,1,187,598,785,0.31270903010033446
5428,2,972,511,1483,1.9021526418786692
5428,3,1650,581,2231,2.8399311531841653
5428,4,2261,558,2819,4.051971326164875
5428,5,2850,327,3177,8.715596330275229
5428,6,3202,466,3668,6.871244635193133
5429,1,75,779,854,0.0962772785622593
5429,2,905,1115,2020,0.8116591928251121
5429,3,2070,842,2912,2.4584323040380047
5429,4,2920,93,3013,31.397849462365592
5429,5,3152,1091,4243,2.8890925756186983
5429,6,4285,533,4818,8.039399624765478
5429,7,4887,672,5559,7.272321428571429
5429,8,5620,605,6225,9.289256198347108
5429,9,6276,618,6894,10.155339805825243
5429,10,6960,13,6973,535.3846153846154
5429,11,7052,1005,8057,7.016915422885572
5430,1,219,645,864,0.3395348837209302
5431,1,130,554,684,0.23465703971119134
5431,2,709,103,812,6.883495145631068
5431,3,959,600,1559,1.5983333333333334
5431,4,1670,476,2146,3.508403361344538
5431,5,2175,213,2388,10.211267605633802
5432,1,43,158,201,0.2721518987341772
5432,2,476,456,932,1.043859649122807
5433,1,15,393,408,0.03816793893129771
5433,2,420,354,774,1.1864406779661016
5433,3,802,875,1677,0.9165714285714286
5434,1,889,481,1370,1.8482328482328483
5435,1,92,457,549,0.2013129102844639
5435,2,642,576,1218,1.1145833333333333
5436,1,14,189,203,0.07407407407407407
5436,2,210,157,367,1.3375796178343948
5436,3,375,165,540,2.272727272727273
5436,4,558,37,595,15.08108108108108
5436,5,653,42,695,15.547619047619047
5436,6,700,40,740,17.5
5436,7,756,83,839,9.108433734939759
5436,8,851,23,874,37.0
5436,9,884,60,944,14.733333333333333
5437,1,19,957,976,0.019853709508881923
5438,1,241,3,244,80.33333333333333
5438,2,258,3,261,86.0
5438,3,269,3,272,89.66666666666667
5438,4,280,2,282,140.0
5438,5,290,3,293,96.66666666666667
5438,6,302,5,307,60.4
5438,7,316,4,320,79.0
5438,8,484,4,488,121.0
5438,9,496,2,498,248.0
5438,10,508,4,512,127.0
5438,11,565,2,567,282.5
5438,12,577,3,580,192.33333333333334
5438,13,589,4,593,147.25
5438,14,602,3,605,200.66666666666666
5438,15,614,3,617,204.66666666666666
5438,16,626,5,631,125.2
5438,17,640,4,644,160.0
5439,1,74,41,115,1.8048780487804879
5439,2,553,3,556,184.33333333333334
5439,3,1327,3,1330,442.3333333333333
5439,4,1837,3,1840,612.3333333333334
5439,5,1866,48,1914,38.875
5439,6,2849,619,3468,4.6025848142164785
5439,7,5318,509,5827,10.447937131630649
5439,8,5844,25,5869,233.76
5439,9,5971,314,6285,19.015923566878982
5439,10,6313,327,6640,19.30581039755352
5439,11,6652,354,7006,18.7909604519774
5439,12,7019,320,7339,21.934375
5440,1,25,508,533,0.04921259842519685
5441,1,18,456,474,0.039473684210526314
5442,1,20,359,379,0.055710306406685235
5443,1,20,348,368,0.05747126436781609
5443,2,380,541,921,0.7024029574861368
5443,3,940,698,1638,1.346704871060172
5443,4,1653,360,2013,4.591666666666667
5443,5,2022,689,2711,2.934687953555878
5444,1,2305,427,2732,5.398126463700234
5444,2,2905,672,3577,4.322916666666667
5445,1,114,623,737,0.18298555377207062
5446,1,14,191,205,0.07329842931937172
5446,2,217,155,372,1.4
5447,1,664,654,1318,1.0152905198776758
5447,2,1385,461,1846,3.004338394793926
5447,3,1858,474,2332,3.919831223628692
5447,4,2360,535,2895,4.411214953271028
5448,1,59,451,510,0.13082039911308205
5448,2,531,484,1015,1.0971074380165289
5448,3,1080,712,1792,1.5168539325842696
5448,4,1803,347,2150,5.195965417867435
5448,5,2158,405,2563,5.328395061728395
5448,6,2573,486,3059,5.294238683127572
5448,7,3069,646,3715,4.75077399380805
5448,8,3763,456,4219,8.25219298245614
5448,9,4240,313,4553,13.54632587859425
5449,1,14,321,335,0.04361370716510903
5449,2,358,640,998,0.559375
5449,3,1048,579,1627,1.8100172711571676
5449,4,1677,464,2141,3.6142241379310347
5450,1,4064,55,4119,73.89090909090909
5450,2,4129,617,4746,6.692058346839546
5450,3,4886,503,5389,9.713717693836978
5450,4,5522,440,5962,12.55
5450,5,6013,168,6181,35.791666666666664
5450,6,6204,110,6314,56.4
5450,7,6326,530,6856,11.935849056603773
5450,8,6885,342,7227,20.13157894736842
5450,9,7378,327,7705,22.56269113149847
5450,10,7715,291,8006,26.512027491408936
5451,1,279,462,741,0.6038961038961039
5452,1,57,964,1021,0.05912863070539419
5452,2,1045,571,1616,1.8301225919439579
5452,3,1625,557,2182,2.9174147217235187
5452,4,2207,1017,3224,2.1701081612586037
5452,5,3230,427,3657,7.56440281030445
5452,6,3724,554,4278,6.722021660649819
5452,7,4287,885,5172,4.84406779661017
5452,8,5190,629,5819,8.251192368839428
5452,9,5837,98,5935,59.56122448979592
5452,10,5966,265,6231,22.513207547169813
5452,11,6370,572,6942,11.136363636363637
5452,12,6948,61,7009,113.90163934426229
5452,13,7047,503,7550,14.009940357852882
5452,14,7560,473,8033,15.9830866807611
5453,1,220,249,469,0.8835341365461847
5453,2,729,595,1324,1.2252100840336135
5453,3,1587,195,1782,8.138461538461538
5454,1,16,76,92,0.21052631578947367
5454,2,109,74,183,1.472972972972973
5454,3,234,3,237,78.0
5455,1,67,151,218,0.44370860927152317
5455,2,453,258,711,1.755813953488372
5455,3,714,42,756,17.0
5455,4,764,89,853,8.584269662921349
5455,5,890,215,1105,4.1395348837209305
5455,6,1204,206,1410,5.844660194174757
5455,7,1441,236,1677,6.1059322033898304
5455,8,1700,465,2165,3.6559139784946235
5455,9,2200,321,2521,6.853582554517134
5455,10,2535,136,2671,18.639705882352942
5455,11,2682,65,2747,41.261538461538464
5455,12,2759,481,3240,5.735966735966736
5455,13,3279,499,3778,6.571142284569138
5455,14,3833,684,4517,5.603801169590644
5456,1,118,574,692,0.20557491289198607
5457,1,9,421,430,0.021377672209026127
5457,2,478,399,877,1.1979949874686717
5457,3,908,554,1462,1.6389891696750902
5457,4,1498,635,2133,2.3590551181102364
5457,5,2170,562,2732,3.8612099644128115
5457,6,2859,602,3461,4.749169435215947
5457,7,3515,551,4066,6.379310344827586
5457,8,4085,630,4715,6.484126984126984
5458,1,85,66,151,1.2878787878787878
5458,2,176,627,803,0.2807017543859649
5458,3,881,409,1290,2.154034229828851
5458,4,1354,331,1685,4.090634441087613
5458,5,1755,166,1921,10.572289156626505
5458,6,1999,619,2618,3.2294022617124396
5458,7,2672,288,2960,9.277777777777779
5458,8,3018,400,3418,7.545
5458,9,3492,365,3857,9.567123287671233
5458,10,3937,465,4402,8.466666666666667
5459,1,53,113,166,0.4690265486725664
5459,2,196,266,462,0.7368421052631579
5460,1,124,562,686,0.2206405693950178
5461,1,188,494,682,0.3805668016194332
5461,2,827,662,1489,1.2492447129909365
5461,3,1546,223,1769,6.932735426008969
5461,4,2036,561,2597,3.629233511586453
5462,1,15,433,448,0.03464203233256351
5462,2,475,455,930,1.043956043956044
5463,1,203,576,779,0.3524305555555556
5463,2,807,542,1349,1.488929889298893
5464,1,12,511,523,0.023483365949119372
5464,2,549,759,1308,0.7233201581027668
5464,3,1329,213,1542,6.23943661971831
5464,4,1555,391,1946,3.976982097186701
5464,5,1979,333,2312,5.942942942942943
5464,6,2329,665,2994,3.5022556390977444
5464,7,3021,386,3407,7.8264248704663215
5464,8,3438,427,3865,8.05152224824356
5464,9,3935,891,4826,4.41638608305275
5464,10,4850,564,5414,8.599290780141844
5464,11,5434,393,5827,13.826972010178118
5465,1,86,750,836,0.11466666666666667
5465,2,856,714,1570,1.1988795518207283
5465,3,1603,708,2311,2.2641242937853105
5466,1,12,188,200,0.06382978723404255
5466,2,221,154,375,1.4350649350649352
5466,3,394,269,663,1.4646840148698885
5466,4,676,250,926,2.704
5466,5,981,207,1188,4.739130434782608
5467,1,69,387,456,0.17829457364341086
5467,2,468,734,1202,0.6376021798365122
5467,3,1219,678,1897,1.7979351032448379
5467,4,1930,660,2590,2.9242424242424243
5467,5,2727,685,3412,3.9810218978102188
5467,6,3442,601,4043,5.72712146422629
5467,7,4059,63,4122,64.42857142857143
5467,8,4128,258,4386,16.0
5467,9,4409,145,4554,30.406896551724138
5467,10,4584,10,4594,458.4
5468,1,813,271,1084,3.0
5469,1,1149,980,2129,1.1724489795918367
5469,2,2155,742,2897,2.904312668463612
5469,3,2989,920,3909,3.248913043478261
5469,4,3970,862,4832,4.6055684454756385
5470,1,2314,808,3122,2.863861386138614
5470,2,3124,904,4028,3.4557522123893807
5470,3,4030,960,4990,4.197916666666667
5470,4,4992,717,5709,6.96234309623431
5471,1,18,434,452,0.041474654377880185
5471,2,482,591,1073,0.8155668358714044
5471,3,1119,777,1896,1.4401544401544402
5471,4,1924,777,2701,2.4761904761904763
5471,5,2736,1011,3747,2.706231454005935
5472,1,74,520,594,0.1423076923076923
5472,2,626,472,1098,1.326271186440678
5472,3,1174,897,2071,1.3088071348940915
5472,4,2315,867,3182,2.6701268742791235
5472,5,3236,899,4135,3.599555061179088
5472,6,4270,616,4886,6.931818181818182
5472,7,5185,572,5757,9.064685314685315
5472,8,5873,566,6439,10.376325088339222
5472,9,6628,654,7282,10.134556574923547
5472,10,7347,149,7496,49.308724832214764
5473,1,1033,273,1306,3.7838827838827838
5473,2,1415,395,1810,3.5822784810126582
5474,1,109,378,487,0.28835978835978837
5474,2,490,383,873,1.279373368146214
5474,3,876,388,1264,2.2577319587628866
5474,4,1267,382,1649,3.316753926701571
5474,5,1652,375,2027,4.405333333333333
5474,6,2030,384,2414,5.286458333333333
5474,7,2417,375,2792,6.445333333333333
5474,8,2795,376,3171,7.433510638297872
5474,9,3174,362,3536,8.767955801104973
5474,10,3539,378,3917,9.362433862433862
5474,11,3920,368,4288,10.652173913043478
5474,12,4291,379,4670,11.321899736147758
5474,13,4673,378,5051,12.362433862433862
5474,14,5054,321,5375,15.744548286604362
5474,15,5378,296,5674,18.16891891891892
5475,1,68,882,950,0.07709750566893424
5475,2,1720,784,2504,2.193877551020408
5475,3,2577,569,3146,4.528998242530756
5475,4,3221,637,3858,5.056514913657771
5475,5,3931,602,4533,6.529900332225914
5475,6,4613,683,5296,6.75402635431918
5475,7,5374,822,6196,6.537712895377129
5476,1,390,611,1001,0.6382978723404256
5476,2,1009,661,1670,1.5264750378214826
5477,1,48,714,762,0.06722689075630252
5477,2,820,910,1730,0.9010989010989011
5477,3,1883,525,2408,3.5866666666666664
5477,4,2481,546,3027,4.543956043956044
5477,5,3106,774,3880,4.012919896640827
5478,1,204,587,791,0.3475298126064736
5478,2,1302,425,1727,3.063529411764706
5478,3,1767,493,2260,3.584178498985801
5478,4,2377,462,2839,5.145021645021645
5478,5,2910,434,3344,6.7050691244239635
5478,6,3379,455,3834,7.426373626373627
5478,7,4187,435,4622,9.62528735632184
5478,8,4664,576,5240,8.097222222222221
5478,9,5261,271,5532,19.41328413284133
5478,10,5615,411,6026,13.661800486618004
5478,11,6045,278,6323,21.744604316546763
5478,12,6385,154,6539,41.46103896103896
5478,13,6563,116,6679,56.577586206896555
5478,14,6733,190,6923,35.43684210526316
5478,15,7546,117,7663,64.4957264957265
5479,1,48,44,92,1.0909090909090908
5479,2,1851,363,2214,5.099173553719008
5479,3,2224,404,2628,5.5049504950495045
5479,4,2635,511,3146,5.156555772994129
5480,1,227,162,389,1.4012345679012346
5480,2,402,392,794,1.0255102040816326
5480,3,839,466,1305,1.8004291845493563
5480,4,1330,251,1581,5.298804780876494
5481,1,74,934,1008,0.07922912205567452
5481,2,1014,901,1915,1.125416204217536
5481,3,1921,249,2170,7.714859437751004
5482,1,33,469,502,0.07036247334754797
5482,2,537,587,1124,0.9148211243611585
5482,3,1235,709,1944,1.7418899858956276
5482,4,2003,734,2737,2.7288828337874658
5482,5,2782,698,3480,3.98567335243553
5482,6,3502,498,4000,7.032128514056225
5482,7,4021,636,4657,6.322327044025157
5482,8,4685,687,5372,6.819505094614265
5482,9,5825,511,6336,11.399217221135029
5482,10,6816,943,7759,7.2279957582184515
5482,11,7767,157,7924,49.47133757961783
5483,1,154,736,890,0.20923913043478262
5484,1,18,569,587,0.03163444639718805
5484,2,606,558,1164,1.086021505376344
5484,3,1177,211,1388,5.578199052132701
5484,4,1400,350,1750,4.0
5484,5,1761,235,1996,7.493617021276596
5484,6,2005,206,2211,9.733009708737864
5484,7,2228,159,2387,14.0125786163522
5484,8,2399,403,2802,5.9528535980148884
5484,9,2925,446,3371,6.558295964125561
5484,10,3385,292,3677,11.592465753424657
5484,11,3731,444,4175,8.403153153153154
5484,12,4195,444,4639,9.448198198198199
5484,13,4657,328,4985,14.198170731707316
5484,14,5016,411,5427,12.204379562043796
5484,15,5436,287,5723,18.94076655052265
5484,16,5742,215,5957,26.706976744186047
5484,17,5972,243,6215,24.5761316872428
5484,18,6237,359,6596,17.37325905292479
5485,1,41,389,430,0.10539845758354756
5485,2,434,471,905,0.921443736730361
5485,3,910,435,1345,2.0919540229885056
5485,4,1351,89,1440,15.179775280898877
5485,5,1467,368,1835,3.9864130434782608
5485,6,1843,416,2259,4.430288461538462
5485,7,2277,382,2659,5.960732984293194
5486,1,1262,771,2033,1.6368352788586251
5486,2,3278,601,3879,5.454242928452579
5486,3,5187,790,5977,6.565822784810127
5486,4,7360,693,8053,10.62049062049062
5487,1,29,504,533,0.057539682539682536
5488,1,3153,60,3213,52.55
5488,2,3233,90,3323,35.922222222222224
5488,3,3334,63,3397,52.92063492063492
5488,4,3445,178,3623,19.353932584269664
5488,5,3652,255,3907,14.321568627450981
5488,6,3933,374,4307,10.516042780748663
5489,1,1636,941,2577,1.738575982996812
5489,2,2580,271,2851,9.52029520295203
5489,3,2870,904,3774,3.174778761061947
5489,4,3776,216,3992,17.48148148148148
5489,5,4007,251,4258,15.96414342629482
5490,1,341,188,529,1.8138297872340425
5491,1,6,17,23,0.35294117647058826
5491,2,253,327,580,0.7737003058103975
5491,3,603,282,885,2.1382978723404253
5491,4,920,311,1231,2.9581993569131835
5491,5,1249,326,1575,3.831288343558282
5491,6,1582,333,1915,4.7507507507507505
5491,7,2137,322,2459,6.636645962732919
5491,8,2466,261,2727,9.448275862068966
5491,9,2880,335,3215,8.597014925373134
5491,10,3221,357,3578,9.022408963585434
5491,11,3585,302,3887,11.870860927152318
5491,12,3952,304,4256,13.0
5491,13,4322,329,4651,13.136778115501519
5491,14,4685,257,4942,18.229571984435797
5491,15,4988,311,5299,16.038585209003216
5491,16,5342,356,5698,15.00561797752809
5491,17,5706,324,6030,17.61111111111111
5491,18,6038,196,6234,30.806122448979593
5491,19,6336,345,6681,18.36521739130435
5491,20,6689,188,6877,35.579787234042556
5492,1,233,822,1055,0.28345498783454987
5492,2,1073,503,1576,2.1332007952286283
5492,3,1595,430,2025,3.7093023255813953
5492,4,2041,642,2683,3.1791277258566977
5492,5,2698,1041,3739,2.5917387127761766
5492,6,3742,571,4313,6.553415061295972
5492,7,4374,172,4546,25.430232558139537
5493,1,620,473,1093,1.3107822410147991
5493,2,1096,387,1483,2.8320413436692506
5493,3,1502,278,1780,5.402877697841727
5493,4,1783,372,2155,4.793010752688172
5493,5,2158,400,2558,5.395
5494,1,602,451,1053,1.334811529933481
5495,1,8,212,220,0.03773584905660377
5496,1,60,552,612,0.10869565217391304
5496,2,619,364,983,1.7005494505494505
5496,3,1001,702,1703,1.4259259259259258
5496,4,1741,555,2296,3.136936936936937
5496,5,2324,642,2966,3.61993769470405
5496,6,2973,358,3331,8.304469273743017
5496,7,3345,809,4154,4.134734239802225
5496,8,4165,440,4605,9.465909090909092
5496,9,4645,451,5096,10.299334811529933
5496,10,5110,527,5637,9.696394686907022
5496,11,5647,523,6170,10.797323135755258
5496,12,6187,511,6698,12.107632093933464
5496,13,6710,489,7199,13.721881390593047
5496,14,7218,567,7785,12.73015873015873
5497,1,223,816,1039,0.27328431372549017
5497,2,1393,462,1855,3.015151515151515
5497,3,1873,544,2417,3.443014705882353
5497,4,3183,622,3805,5.117363344051447
5497,5,4211,362,4573,11.632596685082873
5497,6,5086,484,5570,10.508264462809917
5498,1,367,502,869,0.7310756972111554
5498,2,903,1007,1910,0.8967229394240318
5498,3,2098,200,2298,10.49
5498,4,2306,491,2797,4.696537678207739
5498,5,2804,314,3118,8.929936305732484
5498,6,3131,1061,4192,2.9509896324222433
5499,1,65,287,352,0.2264808362369338
5499,2,376,211,587,1.7819905213270142
5499,3,598,329,927,1.817629179331307
5500,1,16,188,204,0.0851063829787234
5500,2,210,58,268,3.6206896551724137
5501,1,22,339,361,0.06489675516224189
5501,2,428,380,808,1.1263157894736842
5501,3,821,276,1097,2.9746376811594204
5501,4,1119,480,1599,2.33125
5501,5,1627,455,2082,3.575824175824176
5501,6,2092,325,2417,6.436923076923077
5501,7,2437,456,2893,5.344298245614035
5502,1,20,76,96,0.2631578947368421
5502,2,163,124,287,1.314516129032258
5502,3,357,94,451,3.797872340425532
5502,4,540,111,651,4.864864864864865
5502,5,657,145,802,4.531034482758621
5502,6,821,86,907,9.546511627906977
5502,7,938,193,1131,4.860103626943006
5502,8,1150,101,1251,11.386138613861386
5503,1,54,730,784,0.07397260273972603
5504,1,242,896,1138,0.2700892857142857
5504,2,1141,147,1288,7.761904761904762
5504,3,1323,919,2242,1.439608269858542
5505,1,73,637,710,0.11459968602825746
5505,2,724,984,1708,0.7357723577235772
5506,1,6,42,48,0.14285714285714285
5506,2,83,820,903,0.10121951219512196
5506,3,1003,1229,2232,0.8161106590724166
5506,4,2513,208,2721,12.08173076923077
5506,5,2763,126,2889,21.928571428571427
5506,6,2924,161,3085,18.161490683229815
5506,7,3174,191,3365,16.61780104712042
5506,8,3419,465,3884,7.352688172043011
5506,9,3948,202,4150,19.544554455445546
5506,10,4192,562,4754,7.459074733096085
5506,11,4831,168,4999,28.75595238095238
5506,12,5059,707,5766,7.155586987270156
5506,13,5781,381,6162,15.173228346456693
5507,1,70,614,684,0.11400651465798045
5508,1,16,408,424,0.0392156862745098
5509,1,970,490,1460,1.9795918367346939
5509,2,1474,671,2145,2.19672131147541
5509,3,4795,560,5355,8.5625
5509,4,6264,856,7120,7.317757009345795
5509,5,7156,691,7847,10.356005788712011
5509,6,7853,136,7989,57.74264705882353
5510,1,420,71,491,5.915492957746479
5511,1,1199,418,1617,2.8684210526315788
5511,2,1653,536,2189,3.083955223880597
5511,3,2206,469,2675,4.70362473347548
5511,4,2692,478,3170,5.631799163179917
5511,5,3187,487,3674,6.544147843942505
5511,6,3691,489,4180,7.548057259713701
5511,7,4197,548,4745,7.658759124087592
5511,8,4762,558,5320,8.53405017921147
5511,9,5337,671,6008,7.9538002980625935
5511,10,6025,453,6478,13.300220750551876
5511,11,6514,585,7099,11.135042735042735
5511,12,7144,550,7694,12.989090909090908
5512,1,139,929,1068,0.1496232508073197
5512,2,1156,614,1770,1.8827361563517915
5512,3,1910,619,2529,3.08562197092084
5512,4,2571,212,2783,12.127358490566039
5513,1,13,131,144,0.09923664122137404
5513,2,150,291,441,0.5154639175257731
5514,1,31,356,387,0.08707865168539326
5514,2,404,342,746,1.1812865497076024
5514,3,760,189,949,4.021164021164021
5514,4,958,175,1133,5.474285714285714
5514,5,1143,337,1480,3.391691394658754
5514,6,1499,340,1839,4.408823529411765
5515,1,40,777,817,0.05148005148005148
5515,2,849,888,1737,0.956081081081081
5515,3,1759,544,2303,3.233455882352941
5516,1,42,353,395,0.11898016997167139
5517,1,80,914,994,0.087527352297593
5517,2,1011,943,1954,1.0721102863202545
5518,1,218,963,1181,0.22637590861889928
5518,2,1244,645,1889,1.9286821705426356
5518,3,1920,826,2746,2.324455205811138
5518,4,2823,355,3178,7.952112676056338
5518,5,3208,423,3631,7.583924349881797
5518,6,3763,397,4160,9.478589420654911
5518,7,4183,545,4728,7.675229357798165
5518,8,4812,566,5378,8.501766784452297
5518,9,5479,537,6016,10.202979515828678
5519,1,44,450,494,0.09777777777777778
5520,1,157,22,179,7.136363636363637
5520,2,193,33,226,5.848484848484849
5520,3,231,679,910,0.3402061855670103
5521,1,14,355,369,0.03943661971830986
5521,2,377,404,781,0.9331683168316832
5521,3,845,340,1185,2.485294117647059
5521,4,1196,413,1609,2.8958837772397095
5521,5,1648,403,2051,4.089330024813896
5521,6,2135,424,2559,5.035377358490566
5521,7,2732,565,3297,4.8353982300884955
5522,1,43,404,447,0.10643564356435643
5522,2,470,598,1068,0.7859531772575251
5523,1,948,549,1497,1.726775956284153
5523,2,1501,147,1648,10.210884353741497
5524,1,204,274,478,0.7445255474452555
5525,1,299,859,1158,0.3480791618160652
5525,2,1160,309,1469,3.7540453074433655
5525,3,1515,467,1982,3.2441113490364026
5525,4,2010,281,2291,7.153024911032029
5525,5,2306,739,3045,3.1204330175913397
5525,6,3067,30,3097,102.23333333333333
5525,7,3166,245,3411,12.922448979591836
5525,8,3473,684,4157,5.0774853801169595
5525,9,4174,621,4795,6.721417069243156
5526,1,16,437,453,0.036613272311212815
5527,1,27,802,829,0.03366583541147132
5528,1,1509,755,2264,1.9986754966887417
5529,1,74,904,978,0.08185840707964602
5530,1,504,812,1316,0.6206896551724138
5530,2,1370,324,1694,4.228395061728395
5530,3,1717,398,2115,4.314070351758794
5530,4,2125,453,2578,4.690949227373069
5530,5,2592,333,2925,7.783783783783784
5530,6,2935,13,2948,225.76923076923077
5530,7,2959,579,3538,5.110535405872193
5530,8,3550,372,3922,9.543010752688172
5530,9,3933,206,4139,19.09223300970874
5530,10,4146,282,4428,14.702127659574469
5530,11,4440,973,5413,4.563206577595067
5530,12,6166,675,6841,9.134814814814815
5531,1,83,558,641,0.14874551971326164
5531,2,694,853,1547,0.813599062133646
5531,3,1571,789,2360,1.991128010139417
5531,4,2391,838,3229,2.8532219570405726
5531,5,3263,522,3785,6.25095785440613
5531,6,4064,575,4639,7.067826086956522
5531,7,4650,738,5388,6.300813008130081
5531,8,5400,749,6149,7.209612817089453
5532,1,189,933,1122,0.20257234726688103
5532,2,1124,510,1634,2.203921568627451
5532,3,1636,608,2244,2.6907894736842106
5532,4,2246,606,2852,3.706270627062706
5532,5,2854,682,3536,4.18475073313783
5532,6,3538,708,4246,4.997175141242938
5532,7,4248,635,4883,6.689763779527559
5532,8,4885,555,5440,8.801801801801801
5532,9,5467,400,5867,13.6675
5532,10,5878,411,6289,14.30170316301703
5533,1,23,213,236,0.107981220657277
5533,2,251,527,778,0.476280834914611
5534,1,25,178,203,0.1404494382022472
5535,1,25,547,572,0.04570383912248629
5535,2,593,251,844,2.362549800796813
5536,1,9,77,86,0.11688311688311688
5536,2,93,64,157,1.453125
5536,3,169,93,262,1.8172043010752688
5536,4,278,439,717,0.6332574031890661
5536,5,739,570,1309,1.2964912280701755
5537,1,201,455,656,0.44175824175824174
5537,2,702,329,1031,2.1337386018237083
5537,3,1068,435,1503,2.4551724137931035
5537,4,1538,216,1754,7.12037037037037
5538,1,532,951,1483,0.5594111461619348
5538,2,1495,269,1764,5.557620817843866
5538,3,1818,471,2289,3.859872611464968
5538,4,2302,642,2944,3.5856697819314642
5538,5,3083,508,3591,6.068897637795276
5538,6,3725,503,4228,7.405566600397615
5538,7,4391,525,4916,8.363809523809524
5538,8,5037,455,5492,11.07032967032967
5538,9,5539,311,5850,17.810289389067524
5538,10,5885,308,6193,19.107142857142858
5538,11,6314,506,6820,12.478260869565217
5538,12,6849,299,7148,22.906354515050168
5538,13,7197,467,7664,15.411134903640257
5539,1,811,588,1399,1.379251700680272
5539,2,1445,720,2165,2.0069444444444446
5539,3,2622,289,2911,9.07266435986159
5539,4,3760,381,4141,9.868766404199475
5539,5,4184,848,5032,4.933962264150943
5539,6,5034,549,5583,9.169398907103826
5539,7,5611,923,6534,6.079089924160347
5539,8,6540,855,7395,7.649122807017544
5539,9,7397,377,7774,19.620689655172413
5540,1,18,470,488,0.03829787234042553
5540,2,492,82,574,6.0
5540,3,595,309,904,1.9255663430420713
5541,1,833,928,1761,0.8976293103448276
5541,2,1791,943,2734,1.8992576882290562
5541,3,2743,808,3551,3.39480198019802
5541,4,3567,628,4195,5.679936305732484
5541,5,4205,123,4328,34.1869918699187
5541,6,4357,937,5294,4.649946638207044
5541,7,5300,953,6253,5.561385099685205
5541,8,6259,360,6619,17.386111111111113
5541,9,6636,106,6742,62.60377358490566
5541,10,7243,193,7436,37.52849740932643
5542,1,22,333,355,0.06606606606606606
5542,2,436,544,980,0.8014705882352942
5542,3,1002,593,1595,1.6897133220910623
5542,4,1606,47,1653,34.170212765957444
5543,1,19,332,351,0.0572289156626506
5543,2,409,1017,1426,0.40216322517207476
5543,3,1528,728,2256,2.098901098901099
5543,4,2389,624,3013,3.828525641025641
5543,5,3053,625,3678,4.8848
5543,6,3719,769,4488,4.836150845253576
5544,1,794,65,859,12.215384615384615
5544,2,871,146,1017,5.965753424657534
5545,1,327,660,987,0.4954545454545455
5546,1,262,120,382,2.183333333333333
5546,2,1192,107,1299,11.14018691588785
5546,3,1305,181,1486,7.209944751381215
5546,4,1492,615,2107,2.4260162601626014
5546,5,2113,524,2637,4.032442748091603
5546,6,2644,484,3128,5.462809917355372
5546,7,3136,486,3622,6.4526748971193415
5546,8,3628,779,4407,4.657252888318357
5546,9,4413,555,4968,7.951351351351351
5546,10,4974,774,5748,6.426356589147287
5546,11,5754,734,6488,7.839237057220709
5546,12,6494,287,6781,22.627177700348433
5547,1,17,357,374,0.047619047619047616
5548,1,262,123,385,2.130081300813008
5548,2,943,356,1299,2.648876404494382
5548,3,1305,362,1667,3.6049723756906076
5548,4,1673,915,2588,1.828415300546448
5548,5,2594,723,3317,3.587828492392808
5548,6,3323,994,4317,3.3430583501006037
5548,7,4323,869,5192,4.974683544303797
5548,8,5198,985,6183,5.2771573604060915
5548,9,6189,756,6945,8.186507936507937
5548,10,6951,1005,7956,6.916417910447761
5549,1,81,1007,1088,0.0804369414101291
5550,1,14,905,919,0.015469613259668509
5550,2,928,912,1840,1.0175438596491229
5550,3,1914,1077,2991,1.777158774373259
5550,4,3000,748,3748,4.010695187165775
5550,5,3837,17,3854,225.7058823529412
5550,6,3884,974,4858,3.9876796714579057
5550,7,4910,1139,6049,4.310798946444249
5550,8,6058,506,6564,11.972332015810277
5550,9,6572,824,7396,7.975728155339806
5551,1,46,493,539,0.09330628803245436
5551,2,547,972,1519,0.5627572016460906
5551,3,1521,963,2484,1.5794392523364487
5551,4,2487,644,3131,3.861801242236025
5551,5,3133,394,3527,7.951776649746193
5551,6,3532,950,4482,3.7178947368421054
5552,1,76,557,633,0.13644524236983843
5552,2,644,11,655,58.54545454545455
5552,3,668,13,681,51.38461538461539
5553,1,41,687,728,0.05967976710334789
5553,2,730,630,1360,1.1587301587301588
5553,3,1362,572,1934,2.3811188811188813
5553,4,1944,36,1980,54.0
5553,5,1994,48,2042,41.541666666666664
5553,6,2051,693,2744,2.95959595959596
5553,7,2746,630,3376,4.358730158730158
5553,8,3378,576,3954,5.864583333333333
5553,9,3956,643,4599,6.152410575427683
5554,1,112,714,826,0.1568627450980392
5554,2,849,587,1436,1.4463373083475297
5554,3,1516,343,1859,4.419825072886297
5554,4,1883,725,2608,2.597241379310345
5554,5,2679,777,3456,3.447876447876448
5554,6,3487,829,4316,4.20627261761158
5555,1,360,42,402,8.571428571428571
5555,2,411,717,1128,0.5732217573221757
5555,3,1139,195,1334,5.841025641025641
5555,4,1339,317,1656,4.2239747634069404
5555,5,1666,714,2380,2.3333333333333335
5555,6,2385,262,2647,9.103053435114504
5555,7,2658,41,2699,64.82926829268293
5555,8,2712,735,3447,3.6897959183673468
5555,9,3477,343,3820,10.137026239067055
5555,10,4159,20,4179,207.95
5555,11,4184,129,4313,32.434108527131784
5555,12,4317,756,5073,5.7103174603174605
5555,13,5087,850,5937,5.984705882352941
5555,14,5969,390,6359,15.305128205128206
5555,15,6485,350,6835,18.52857142857143
5555,16,6844,139,6983,49.23741007194245
5555,17,6998,56,7054,124.96428571428571
5555,18,7068,736,7804,9.603260869565217
5556,1,116,397,513,0.29219143576826195
5556,2,515,352,867,1.4630681818181819
5556,3,869,302,1171,2.877483443708609
5556,4,1182,227,1409,5.20704845814978
5556,5,1491,351,1842,4.247863247863248
5556,6,1865,517,2382,3.607350096711799
5557,1,13,1853,1866,0.007015650296815974
5557,2,2136,2225,4361,0.96
5557,3,4507,2422,6929,1.8608587943848058
5558,1,3391,441,3832,7.6893424036281175
5558,2,3843,435,4278,8.83448275862069
5558,3,4287,284,4571,15.095070422535212
5558,4,4578,295,4873,15.51864406779661
5559,1,47,338,385,0.1390532544378698
5559,2,387,405,792,0.9555555555555556
5559,3,795,354,1149,2.2457627118644066
5560,1,376,799,1175,0.47058823529411764
5560,2,1205,457,1662,2.636761487964989
5560,3,1674,339,2013,4.938053097345133
5560,4,2029,280,2309,7.246428571428571
5560,5,2328,306,2634,7.607843137254902
5560,6,2648,876,3524,3.0228310502283104
5560,7,3539,476,4015,7.434873949579832
5560,8,4041,525,4566,7.6971428571428575
5561,1,25,763,788,0.0327653997378768
5561,2,838,976,1814,0.8586065573770492
5561,3,1954,627,2581,3.116427432216906
5561,4,2668,817,3485,3.265605875152999
5561,5,3560,1143,4703,3.114610673665792
5562,1,173,65,238,2.6615384615384614
5562,2,318,74,392,4.297297297297297
5562,3,437,88,525,4.965909090909091
5562,4,2945,459,3404,6.416122004357298
5562,5,3429,214,3643,16.023364485981308
5562,6,3685,158,3843,23.32278481012658
5562,7,3919,648,4567,6.047839506172839
5562,8,4599,260,4859,17.68846153846154
5562,9,4886,94,4980,51.97872340425532
5562,10,5010,192,5202,26.09375
5563,1,61,345,406,0.17681159420289855
5564,1,205,197,402,1.0406091370558375
5564,2,523,212,735,2.4669811320754715
5564,3,878,106,984,8.283018867924529
5564,4,1049,118,1167,8.889830508474576
5564,5,1229,80,1309,15.3625
5565,1,408,414,822,0.9855072463768116
5565,2,831,344,1175,2.4156976744186047
5565,3,3987,263,4250,15.159695817490494
5565,4,4259,468,4727,9.100427350427351
5565,5,6252,366,6618,17.081967213114755
5565,6,6627,426,7053,15.556338028169014
5565,7,7062,543,7605,13.005524861878452
5566,1,27,22,49,1.2272727272727273
5566,2,199,550,749,0.3618181818181818
5566,3,795,35,830,22.714285714285715
5566,4,1718,658,2376,2.6109422492401215
5566,5,3294,701,3995,4.699001426533523
5566,6,4005,31,4036,129.19354838709677
5566,7,4997,720,5717,6.940277777777778
5566,8,5784,643,6427,8.995334370139968
5566,9,6473,350,6823,18.494285714285713
5566,10,6852,649,7501,10.557781201848998
5566,11,7556,503,8059,15.021868787276341
5567,1,23,1008,1031,0.022817460317460316
5567,2,1033,521,1554,1.982725527831094
5567,3,1703,699,2402,2.436337625178827
5567,4,2422,638,3060,3.7962382445141065
5567,5,3073,790,3863,3.889873417721519
5567,6,3932,713,4645,5.514726507713885
5567,7,4693,621,5314,7.557165861513687
5567,8,5338,485,5823,11.00618556701031
5567,9,5834,488,6322,11.954918032786885
5567,10,6385,586,6971,10.895904436860068
5567,11,7005,507,7512,13.816568047337277
5567,12,7529,427,7956,17.63231850117096
5568,1,410,873,1283,0.46964490263459335
5568,2,1432,886,2318,1.6162528216704288
5568,3,3547,408,3955,8.693627450980392
5568,4,4067,414,4481,9.823671497584542
5568,5,4540,134,4674,33.88059701492537
5568,6,5862,834,6696,7.028776978417266
5569,1,390,611,1001,0.6382978723404256
5569,2,1009,661,1670,1.5264750378214826
5569,3,1678,711,2389,2.360056258790436
5570,1,25,786,811,0.031806615776081425
5570,2,1636,837,2473,1.954599761051374
5570,3,2481,793,3274,3.128625472887768
5571,1,708,113,821,6.265486725663717
5571,2,830,1013,1843,0.8193484698914116
5571,3,1845,190,2035,9.710526315789474
5572,1,674,1002,1676,0.6726546906187625
5572,2,1678,433,2111,3.8752886836027716
5573,1,15,716,731,0.02094972067039106
5573,2,753,634,1387,1.1876971608832807
5573,3,1408,858,2266,1.641025641025641
5573,4,2277,846,3123,2.6914893617021276
5573,5,3227,891,4118,3.621773288439955
5573,6,4234,832,5066,5.0889423076923075
5573,7,5148,834,5982,6.172661870503597
5573,8,6003,816,6819,7.356617647058823
5573,9,6847,658,7505,10.405775075987842
5574,1,19,95,114,0.2
5574,2,130,166,296,0.7831325301204819
5575,1,18,324,342,0.05555555555555555
5575,2,377,377,754,1.0
5575,3,781,429,1210,1.8205128205128205
5575,4,1248,249,1497,5.0120481927710845
5575,5,1564,383,1947,4.0835509138381205
5575,6,1971,439,2410,4.489749430523918
5575,7,2448,553,3001,4.426763110307414
5575,8,3032,103,3135,29.436893203883496
5575,9,3163,527,3690,6.001897533206831
5575,10,3719,787,4506,4.72554002541296
5576,1,40,911,951,0.043907793633369926
5576,2,1004,776,1780,1.2938144329896908
5577,1,19,800,819,0.02375
5577,2,866,710,1576,1.2197183098591549
5577,3,1660,966,2626,1.7184265010351967
5577,4,2634,601,3235,4.3826955074875205
5578,1,15,306,321,0.049019607843137254
5579,1,129,147,276,0.8775510204081632
5579,2,296,508,804,0.5826771653543307
5580,1,110,496,606,0.2217741935483871
5580,2,614,275,889,2.232727272727273
5581,1,1879,714,2593,2.6316526610644257
5582,1,414,81,495,5.111111111111111
5582,2,519,123,642,4.219512195121951
5582,3,667,328,995,2.033536585365854
5583,1,7,377,384,0.01856763925729443
5583,2,438,672,1110,0.6517857142857143
5583,3,1136,654,1790,1.7370030581039755
5583,4,1942,813,2755,2.3886838868388685
5583,5,2875,657,3532,4.375951293759513
5583,6,3614,781,4395,4.627400768245838
5583,7,4504,762,5266,5.910761154855643
5584,1,564,303,867,1.8613861386138615
5584,2,1081,1203,2284,0.8985868661679135
5584,3,2526,2159,4685,1.1699861046780917
5584,4,5433,1600,7033,3.395625
5585,1,5,540,545,0.009259259259259259
5585,2,569,687,1256,0.8282387190684134
5585,3,1349,861,2210,1.5667828106852497
5585,4,2283,705,2988,3.2382978723404254
5585,5,3219,470,3689,6.848936170212766
5585,6,3803,813,4616,4.677736777367774
5585,7,4942,128,5070,38.609375
5585,8,5130,108,5238,47.5
5585,9,5351,177,5528,30.231638418079097
5585,10,5770,434,6204,13.294930875576037
5585,11,6369,240,6609,26.5375
5585,12,6657,421,7078,15.812351543942993
5585,13,7096,530,7626,13.388679245283019
5586,1,26,326,352,0.07975460122699386
5586,2,357,588,945,0.6071428571428571
5586,3,954,74,1028,12.891891891891891
5586,4,1072,73,1145,14.684931506849315
5586,5,1154,521,1675,2.214971209213052
5586,6,1697,894,2591,1.8982102908277405
5586,7,2605,975,3580,2.6717948717948716
5586,8,3590,777,4367,4.620334620334621
5586,9,4379,402,4781,10.893034825870647
5587,1,68,748,816,0.09090909090909091
5588,1,43,308,351,0.1396103896103896
5589,1,64,577,641,0.11091854419410745
5590,1,28,285,313,0.09824561403508772
5590,2,343,432,775,0.7939814814814815
5591,1,90,229,319,0.3930131004366812
5591,2,344,218,562,1.5779816513761469
5591,3,587,86,673,6.825581395348837
5591,4,685,102,787,6.715686274509804
5591,5,801,117,918,6.846153846153846
5591,6,966,182,1148,5.3076923076923075
5591,7,1160,51,1211,22.745098039215687
5591,8,1223,78,1301,15.679487179487179
5591,9,1331,225,1556,5.915555555555556
5591,10,1571,310,1881,5.067741935483871
5591,11,1894,188,2082,10.074468085106384
5592,1,588,1080,1668,0.5444444444444444
5592,2,1673,214,1887,7.817757009345795
5593,1,44,1064,1108,0.041353383458646614
5593,2,1152,1121,2273,1.0276538804638715
5593,3,2345,704,3049,3.330965909090909
5593,4,3092,184,3276,16.804347826086957
5593,5,3304,1049,4353,3.1496663489037178
5593,6,4406,704,5110,6.2585227272727275
5593,7,5139,891,6030,5.767676767676767
5593,8,6070,613,6683,9.902120717781402
5593,9,6700,1123,7823,5.966162065894924
5593,10,7838,149,7987,52.604026845637584
5594,1,296,152,448,1.9473684210526316
5595,1,97,980,1077,0.09897959183673469
5595,2,1099,809,1908,1.3584672435105067
5595,3,2020,906,2926,2.2295805739514347
5595,4,2929,225,3154,13.017777777777777
5595,5,3211,935,4146,3.434224598930481
5595,6,4164,682,4846,6.105571847507331
5595,7,4902,581,5483,8.437177280550774
5595,8,5507,536,6043,10.274253731343284
5596,1,67,718,785,0.09331476323119778
5596,2,840,590,1430,1.423728813559322
5596,3,1481,570,2051,2.5982456140350876
5597,1,454,1039,1493,0.43695861405197306
5598,1,69,1183,1252,0.058326289095519866
5598,2,1374,990,2364,1.387878787878788
5598,3,2418,607,3025,3.9835255354200987
5599,1,34,553,587,0.06148282097649186
5600,1,60,823,883,0.07290400972053462
5600,2,895,503,1398,1.779324055666004
5600,3,1460,753,2213,1.9389110225763613
5601,1,247,674,921,0.3664688427299703
5601,2,930,590,1520,1.576271186440678
5601,3,1531,441,1972,3.4716553287981857
5601,4,2043,615,2658,3.321951219512195
5601,5,2667,604,3271,4.4155629139072845
5601,6,3376,577,3953,5.8509532062391685
5601,7,3981,623,4604,6.390048154093098
5601,8,4648,636,5284,7.3081761006289305
5601,9,5312,855,6167,6.212865497076024
5601,10,6198,797,6995,7.776662484316185
5601,11,7009,213,7222,32.906103286384976
5601,12,7238,410,7648,17.653658536585365
5601,13,7656,280,7936,27.34285714285714
5602,1,1940,929,2869,2.0882669537136707
5602,2,2872,573,3445,5.012216404886562
5602,3,5367,966,6333,5.555900621118012
5602,4,6336,682,7018,9.290322580645162
5603,1,63,543,606,0.11602209944751381
5603,2,616,301,917,2.046511627906977
5603,3,933,491,1424,1.9002036659877801
5603,4,1453,594,2047,2.446127946127946
5604,1,11,673,684,0.01634472511144131
5605,1,36,988,1024,0.03643724696356275
5605,2,1050,822,1872,1.2773722627737227
5605,3,1881,783,2664,2.4022988505747125
5606,1,243,577,820,0.42114384748700173
5607,1,480,530,1010,0.9056603773584906
5608,1,764,49,813,15.591836734693878
5608,2,1109,570,1679,1.9456140350877194
5608,3,1688,1127,2815,1.497781721384206
5609,1,110,697,807,0.15781922525107603
5609,2,837,66,903,12.681818181818182
5609,3,922,570,1492,1.6175438596491227
5610,1,1173,360,1533,3.2583333333333333
5610,2,1553,394,1947,3.9416243654822334
5610,3,1964,380,2344,5.168421052631579
5610,4,2363,374,2737,6.318181818181818
5610,5,2758,413,3171,6.677966101694915
5611,1,134,56,190,2.392857142857143
5611,2,1511,493,2004,3.0649087221095335
5611,3,4166,585,4751,7.121367521367521
5611,4,7267,104,7371,69.875
5611,5,7505,86,7591,87.26744186046511
5612,1,32,505,537,0.06336633663366337
5613,1,81,4,85,20.25
5613,2,1237,626,1863,1.976038338658147
5613,3,2450,761,3211,3.219448094612352
5613,4,5590,109,5699,51.28440366972477
5614,1,172,359,531,0.479108635097493
5614,2,646,566,1212,1.1413427561837455
5614,3,1229,183,1412,6.715846994535519
5614,4,1660,537,2197,3.091247672253259
5615,1,73,493,566,0.14807302231237324
5616,1,344,500,844,0.688
5617,1,32,814,846,0.03931203931203931
5617,2,889,829,1718,1.0723763570566949
5617,3,1733,757,2490,2.2892998678996035
5617,4,2567,781,3348,3.2868117797695264
5618,1,35,558,593,0.06272401433691756
5618,2,611,628,1239,0.9729299363057324
5618,3,1243,679,1922,1.8306332842415316
5619,1,44,541,585,0.08133086876155268
5620,1,50,671,721,0.07451564828614009
5620,2,744,338,1082,2.201183431952663
5620,3,1342,836,2178,1.605263157894737
5620,4,2342,750,3092,3.1226666666666665
5620,5,3125,703,3828,4.445234708392603
5621,1,944,534,1478,1.7677902621722847
5621,2,1483,10,1493,148.3
5621,3,1500,211,1711,7.109004739336493
5622,1,17,514,531,0.033073929961089495
5622,2,539,167,706,3.2275449101796405
5622,3,717,180,897,3.9833333333333334
5623,1,814,338,1152,2.408284023668639
5624,1,49,784,833,0.0625
5625,1,262,440,702,0.5954545454545455
5625,2,724,520,1244,1.3923076923076922
5625,3,1293,706,1999,1.8314447592067988
5625,4,2040,619,2659,3.295638126009693
5625,5,2721,682,3403,3.9897360703812317
5625,6,3454,599,4053,5.766277128547579
5625,7,4109,560,4669,7.3375
5625,8,4739,651,5390,7.279569892473118
5626,1,47,434,481,0.10829493087557604
5626,2,495,410,905,1.2073170731707317
5626,3,994,462,1456,2.1515151515151514
5626,4,1484,575,2059,2.5808695652173914
5626,5,2080,101,2181,20.594059405940595
5626,6,2264,178,2442,12.719101123595506
5626,7,2456,453,2909,5.421633554083885
5626,8,2924,636,3560,4.59748427672956
5626,9,3574,596,4170,5.996644295302014
5626,10,4193,1062,5255,3.9482109227871938
5626,11,5285,241,5526,21.929460580912863
5626,12,6655,206,6861,32.30582524271845
5626,13,6930,271,7201,25.571955719557195
5626,14,7242,505,7747,14.340594059405941
5627,1,219,858,1077,0.25524475524475526
5628,1,89,607,696,0.14662273476112025
5628,2,716,471,1187,1.5201698513800426
5628,3,1195,503,1698,2.375745526838966
5628,4,1714,467,2181,3.670235546038544
5629,1,29,417,446,0.06954436450839328
5629,2,458,581,1039,0.7882960413080895
5629,3,1072,843,1915,1.2716488730723605
5629,4,1962,505,2467,3.885148514851485
5629,5,2496,256,2752,9.75
5630,1,1254,1164,2418,1.077319587628866
5630,2,2457,165,2622,14.89090909090909
5630,3,2689,724,3413,3.7140883977900554
5630,4,3438,169,3607,20.34319526627219
5630,5,3639,207,3846,17.579710144927535
5630,6,4148,333,4481,12.456456456456456
5630,7,4528,487,5015,9.297741273100616
5630,8,5109,404,5513,12.646039603960396
5630,9,5568,482,6050,11.551867219917012
5631,1,178,79,257,2.2531645569620253
5631,2,1031,1077,2108,0.957288765088208
5632,1,336,159,495,2.1132075471698113
5633,1,35,585,620,0.05982905982905983
5633,2,654,435,1089,1.5034482758620689
5633,3,1223,716,1939,1.708100558659218
5633,4,2072,545,2617,3.8018348623853213
5633,5,2864,526,3390,5.444866920152092
5634,1,90,882,972,0.10204081632653061
5634,2,1030,268,1298,3.843283582089552
5634,3,1339,314,1653,4.264331210191083
5634,4,1707,436,2143,3.915137614678899
5634,5,2194,5,2199,438.8
5635,1,51,100,151,0.51
5635,2,152,123,275,1.2357723577235773
5635,3,276,199,475,1.3869346733668342
5635,4,476,175,651,2.72
5635,5,652,220,872,2.963636363636364
5635,6,873,261,1134,3.3448275862068964
5635,7,1135,214,1349,5.303738317757009
5635,8,1350,140,1490,9.642857142857142
5635,9,1491,162,1653,9.203703703703704
5635,10,1654,221,1875,7.484162895927602
5635,11,1876,259,2135,7.243243243243243
5635,12,2136,204,2340,10.470588235294118
5635,13,2341,215,2556,10.888372093023255
5635,14,2557,198,2755,12.914141414141413
5635,15,2756,203,2959,13.576354679802956
5635,16,2960,225,3185,13.155555555555555
5635,17,3186,227,3413,14.035242290748899
5635,18,3414,223,3637,15.309417040358744
5635,19,3638,166,3804,21.91566265060241
5635,20,3805,112,3917,33.973214285714285
5635,21,3918,121,4039,32.3801652892562
5635,22,4040,171,4211,23.625730994152047
5635,23,4212,132,4344,31.90909090909091
5635,24,4345,116,4461,37.456896551724135
5635,25,4462,164,4626,27.20731707317073
5635,26,4627,125,4752,37.016
5635,27,4753,171,4924,27.795321637426902
5635,28,4925,201,5126,24.502487562189053
5635,29,5127,207,5334,24.768115942028984
5635,30,5335,118,5453,45.21186440677966
5635,31,5454,135,5589,40.4
5635,32,5590,191,5781,29.267015706806284
5635,33,5782,164,5946,35.25609756097561
5635,34,5947,171,6118,34.77777777777778
5635,35,6119,202,6321,30.292079207920793
5635,36,6322,196,6518,32.255102040816325
5635,37,6519,135,6654,48.28888888888889
5635,38,6655,136,6791,48.93382352941177
5635,39,6792,125,6917,54.336
5635,40,6918,135,7053,51.24444444444445
5635,41,7054,181,7235,38.972375690607734
5635,42,7236,193,7429,37.49222797927461
5635,43,7430,197,7627,37.71573604060914
5635,44,7628,182,7810,41.91208791208791
5636,1,368,483,851,0.7619047619047619
5636,2,863,563,1426,1.5328596802841918
5636,3,1449,590,2039,2.4559322033898305
5637,1,29,727,756,0.039889958734525444
5638,1,158,608,766,0.2598684210526316
5639,1,55,404,459,0.13613861386138615
5639,2,469,371,840,1.2641509433962264
5639,3,854,435,1289,1.9632183908045977
5639,4,1301,414,1715,3.142512077294686
5639,5,1732,289,2021,5.993079584775087
5639,6,2032,361,2393,5.628808864265928
5639,7,2412,235,2647,10.263829787234043
5639,8,2665,478,3143,5.575313807531381
5640,1,2446,263,2709,9.300380228136882
5641,1,39,62,101,0.6290322580645161
5641,2,227,399,626,0.568922305764411
5641,3,784,389,1173,2.0154241645244215
5641,4,1191,236,1427,5.046610169491525
5641,5,1587,417,2004,3.805755395683453
5641,6,2035,401,2436,5.074812967581047
5641,7,2467,268,2735,9.205223880597014
5641,8,2793,260,3053,10.742307692307692
5641,9,3080,161,3241,19.130434782608695
5641,10,3253,204,3457,15.946078431372548
5641,11,3467,238,3705,14.567226890756302
5641,12,3737,127,3864,29.4251968503937
5642,1,6,17,23,0.35294117647058826
5642,2,253,327,580,0.7737003058103975
5642,3,603,282,885,2.1382978723404253
5642,4,920,311,1231,2.9581993569131835
5642,5,1249,326,1575,3.831288343558282
5642,6,1582,333,1915,4.7507507507507505
5642,7,2137,322,2459,6.636645962732919
5642,8,2466,261,2727,9.448275862068966
5642,9,2880,335,3215,8.597014925373134
5642,10,3221,357,3578,9.022408963585434
5642,11,3585,302,3887,11.870860927152318
5642,12,3952,304,4256,13.0
5642,13,4322,329,4651,13.136778115501519
5642,14,4685,257,4942,18.229571984435797
5642,15,4988,311,5299,16.038585209003216
5643,1,46,729,775,0.06310013717421124
5644,1,98,662,760,0.14803625377643503
5644,2,824,849,1673,0.9705535924617197
5644,3,1681,825,2506,2.0375757575757576
5644,4,2514,568,3082,4.426056338028169
5644,5,3123,720,3843,4.3375
5644,6,3898,841,4739,4.634958382877527
5644,7,4747,818,5565,5.80317848410758
5644,8,5573,372,5945,14.981182795698924
5644,9,6049,781,6830,7.745198463508323
5645,1,212,25,237,8.48
5645,2,247,441,688,0.5600907029478458
5645,3,690,685,1375,1.0072992700729928
5645,4,1394,788,2182,1.7690355329949239
5645,5,2184,754,2938,2.896551724137931
5645,6,2940,774,3714,3.798449612403101
5645,7,3716,666,4382,5.57957957957958
5645,8,4384,701,5085,6.253922967189729
5645,9,5087,742,5829,6.855795148247979
5645,10,5836,220,6056,26.527272727272727
5645,11,6069,889,6958,6.826771653543307
5646,1,23,297,320,0.07744107744107744
5646,2,356,380,736,0.9368421052631579
5647,1,710,40,750,17.75
5647,2,771,38,809,20.289473684210527
5647,3,811,133,944,6.097744360902255
5647,4,949,48,997,19.770833333333332
5647,5,1002,62,1064,16.161290322580644
5647,6,1069,89,1158,12.01123595505618
5647,7,1176,173,1349,6.797687861271676
5648,1,115,859,974,0.13387660069848661
5649,1,44,442,486,0.09954751131221719
5650,1,20,293,313,0.06825938566552901
5650,2,342,845,1187,0.40473372781065087
5651,1,31,893,924,0.03471444568868981
5651,2,987,1031,2018,0.9573229873908826
5651,3,2086,1008,3094,2.0694444444444446
5651,4,3107,1004,4111,3.0946215139442232
5651,5,4120,1044,5164,3.946360153256705
5652,1,69,835,904,0.08263473053892216
5652,2,1006,908,1914,1.1079295154185023
5652,3,1935,916,2851,2.1124454148471616
5652,4,2890,882,3772,3.2766439909297054
5653,1,120,1003,1123,0.11964107676969092
5653,2,1128,115,1243,9.808695652173913
5653,3,1266,250,1516,5.064
5653,4,1531,307,1838,4.986970684039088
5653,5,1840,30,1870,61.333333333333336
5653,6,1945,654,2599,2.974006116207951
5653,7,2610,406,3016,6.428571428571429
5653,8,3028,563,3591,5.378330373001776
5653,9,3613,617,4230,5.855753646677472
5654,1,1386,1065,2451,1.3014084507042254
5654,2,2530,752,3282,3.3643617021276597
5654,3,3327,570,3897,5.836842105263158
5654,4,3911,554,4465,7.05956678700361
5654,5,4478,1028,5506,4.356031128404669
5654,6,5529,215,5744,25.71627906976744
5654,7,5761,397,6158,14.511335012594458
5654,8,6196,457,6653,13.557986870897155
5655,1,532,746,1278,0.7131367292225201
5656,1,368,56,424,6.571428571428571
5656,2,3702,491,4193,7.539714867617108
5656,3,4208,531,4739,7.9246704331450095
5656,4,4742,519,5261,9.136801541425818
5656,5,5336,246,5582,21.691056910569106
5656,6,5750,438,6188,13.127853881278538
5657,1,159,440,599,0.3613636363636364
5657,2,729,479,1208,1.5219206680584552
5657,3,1299,306,1605,4.245098039215686
5657,4,1735,460,2195,3.7717391304347827
5657,5,2383,522,2905,4.565134099616858
5657,6,3051,509,3560,5.994106090373281
5658,1,142,869,1011,0.16340621403912542
5659,1,35,2018,2053,0.01734390485629336
5659,2,2105,1606,3711,1.3107098381070983
5659,3,3759,1277,5036,2.9436178543461238
5659,4,5117,1230,6347,4.160162601626016
5660,1,22,206,228,0.10679611650485436
5660,2,304,259,563,1.1737451737451738
5661,1,33,313,346,0.10543130990415335
5661,2,401,320,721,1.253125
5661,3,743,411,1154,1.8077858880778588
5661,4,1197,130,1327,9.207692307692307
5661,5,1347,183,1530,7.360655737704918
5661,6,1549,127,1676,12.196850393700787
5661,7,1708,330,2038,5.175757575757576
5661,8,2103,395,2498,5.324050632911392
5661,9,2570,384,2954,6.692708333333333
5661,10,3036,407,3443,7.45945945945946
5661,11,3446,300,3746,11.486666666666666
5661,12,3872,227,4099,17.05726872246696
5661,13,4233,405,4638,10.451851851851853
5661,14,4641,150,4791,30.94
5661,15,4860,300,5160,16.2
5661,16,5320,392,5712,13.571428571428571
5661,17,5715,362,6077,15.787292817679559
5661,18,6113,294,6407,20.792517006802722
5661,19,6472,383,6855,16.89817232375979
5661,20,6883,477,7360,14.429769392033544
5661,21,7377,436,7813,16.9197247706422
5662,1,43,404,447,0.10643564356435643
5662,2,470,598,1068,0.7859531772575251
5663,1,68,421,489,0.16152019002375298
5664,1,3458,519,3977,6.66281310211946
5664,2,3983,328,4311,12.143292682926829
5664,3,4318,281,4599,15.366548042704625
5664,4,4612,393,5005,11.735368956743002
5664,5,5031,218,5249,23.077981651376145
5665,1,18,204,222,0.08823529411764706
5665,2,242,201,443,1.2039800995024876
5666,1,15,463,478,0.032397408207343416
5667,1,119,642,761,0.1853582554517134
5668,1,111,680,791,0.16323529411764706
5668,2,811,289,1100,2.8062283737024223
5668,3,1114,267,1381,4.1722846441947565
5668,4,1414,169,1583,8.366863905325443
5668,5,1592,393,1985,4.0508905852417305
5668,6,2004,673,2677,2.9777117384843983
5668,7,2733,921,3654,2.96742671009772
5668,8,3656,284,3940,12.873239436619718
5668,9,3983,499,4482,7.981963927855712
5668,10,4531,267,4798,16.970037453183522
5668,11,4822,944,5766,5.108050847457627
5668,12,5768,230,5998,25.078260869565216
5668,13,6009,350,6359,17.16857142857143
5668,14,6400,896,7296,7.142857142857143
5669,1,3166,507,3673,6.2445759368836296
5669,2,3719,458,4177,8.120087336244541
5670,1,135,746,881,0.18096514745308312
5671,1,15,1177,1192,0.012744265080713678
5671,2,1354,893,2247,1.5162374020156775
5671,3,2303,504,2807,4.569444444444445
5671,4,2891,648,3539,4.46141975308642
5672,1,204,226,430,0.9026548672566371
5672,2,700,371,1071,1.8867924528301887
5672,3,1799,490,2289,3.6714285714285713
5672,4,2326,445,2771,5.226966292134832
5672,5,3012,159,3171,18.943396226415093
5672,6,3356,167,3523,20.095808383233532
5672,7,3716,228,3944,16.29824561403509
5672,8,3964,863,4827,4.593279258400927
5672,9,4916,870,5786,5.650574712643678
5672,10,5899,866,6765,6.811778290993072
5672,11,6991,307,7298,22.77198697068404
5673,1,48,893,941,0.05375139977603583
5674,1,261,2,263,130.5
5674,2,360,291,651,1.2371134020618557
5674,3,847,2,849,423.5
5674,4,1134,2,1136,567.0
5674,5,1552,2,1554,776.0
5674,6,1841,2,1843,920.5
5674,7,2061,158,2219,13.044303797468354
5674,8,2266,224,2490,10.116071428571429
5674,9,2702,357,3059,7.568627450980392
5675,1,64,636,700,0.10062893081761007
5676,1,1096,747,1843,1.4672021419009371
5676,2,1846,751,2597,2.4580559254327565
5676,3,2600,486,3086,5.349794238683128
5677,1,903,872,1775,1.0355504587155964
5677,2,1782,715,2497,2.4923076923076923
5677,3,2547,119,2666,21.403361344537814
5677,4,2675,129,2804,20.73643410852713
5677,5,2823,144,2967,19.604166666666668
5677,6,2987,143,3130,20.888111888111887
5677,7,3154,141,3295,22.368794326241133
5677,8,3313,105,3418,31.552380952380954
5677,9,3559,264,3823,13.481060606060606
5677,10,3848,229,4077,16.80349344978166
5677,11,4239,315,4554,13.457142857142857
5677,12,4571,168,4739,27.208333333333332
5678,1,99,45,144,2.2
5678,2,150,89,239,1.6853932584269662
5678,3,334,436,770,0.7660550458715596
5678,4,793,241,1034,3.2904564315352696
5678,5,1077,446,1523,2.414798206278027
5679,1,273,868,1141,0.31451612903225806
5679,2,1421,818,2239,1.7371638141809291
5679,3,2249,64,2313,35.140625
5679,4,3547,907,4454,3.910694597574421
5679,5,4467,720,5187,6.204166666666667
5679,6,5197,57,5254,91.17543859649123
5679,7,5257,56,5313,93.875
5679,8,5330,64,5394,83.28125
5679,9,5432,30,5462,181.06666666666666
5679,10,5550,89,5639,62.359550561797754
5679,11,6052,823,6875,7.353584447144593
5679,12,6881,530,7411,12.983018867924528
5680,1,46,408,454,0.11274509803921569
5680,2,468,284,752,1.647887323943662
5680,3,821,284,1105,2.890845070422535
5680,4,1199,347,1546,3.4553314121037464
5680,5,1624,253,1877,6.4189723320158105
5680,6,1964,186,2150,10.559139784946236
5680,7,2198,478,2676,4.598326359832636
5680,8,2693,280,2973,9.617857142857142
5680,9,3033,201,3234,15.08955223880597
5680,10,3260,337,3597,9.673590504451038
5680,11,3667,242,3909,15.152892561983471
5680,12,3934,349,4283,11.272206303724928
5680,13,4364,279,4643,15.6415770609319
5680,14,4799,264,5063,18.178030303030305
5680,15,5112,135,5247,37.86666666666667
5680,16,5299,269,5568,19.69888475836431
5680,17,5581,290,5871,19.244827586206895
5680,18,6166,316,6482,19.5126582278481
5680,19,6513,284,6797,22.933098591549296
5680,20,6838,317,7155,21.57097791798107
5680,21,7185,356,7541,20.18258426966292
5680,22,7559,102,7661,74.1078431372549
5681,1,262,109,371,2.403669724770642
5681,2,1259,310,1569,4.061290322580645
5681,3,1575,729,2304,2.1604938271604937
5681,4,2310,677,2987,3.412112259970458
5681,5,2993,681,3674,4.395007342143906
5681,6,3680,546,4226,6.73992673992674
5681,7,4232,689,4921,6.142235123367199
5681,8,4927,418,5345,11.787081339712918
5682,1,262,114,376,2.2982456140350878
5682,2,930,147,1077,6.326530612244898
5682,3,1083,318,1401,3.4056603773584904
5682,4,1407,692,2099,2.0332369942196533
5682,5,2105,726,2831,2.899449035812672
5682,6,2846,683,3529,4.166910688140557
5682,7,3535,616,4151,5.738636363636363
5682,8,4157,879,5036,4.729237770193402
5682,9,5042,652,5694,7.733128834355829
5682,10,5700,956,6656,5.96234309623431
5682,11,6662,194,6856,34.34020618556701
5683,1,34,568,602,0.05985915492957746
5683,2,629,960,1589,0.6552083333333333
5683,3,1625,426,2051,3.8145539906103285
5684,1,28,488,516,0.05737704918032787
5684,2,587,486,1073,1.2078189300411524
5685,1,31,603,634,0.05140961857379768
5685,2,642,488,1130,1.3155737704918034
5685,3,1165,532,1697,2.1898496240601504
5686,1,73,133,206,0.5488721804511278
5686,2,383,240,623,1.5958333333333334
5687,1,36,58,94,0.6206896551724138
5688,1,45,714,759,0.06302521008403361
5688,2,827,778,1605,1.062982005141388
5689,1,187,387,574,0.48320413436692505
5689,2,582,437,1019,1.331807780320366
5689,3,1060,383,1443,2.7676240208877285
5689,4,1461,430,1891,3.3976744186046512
5689,5,1965,412,2377,4.769417475728155
5689,6,2410,324,2734,7.438271604938271
5689,7,2783,398,3181,6.992462311557789
5689,8,3191,421,3612,7.57957244655582
5690,1,6,295,301,0.020338983050847456
5691,1,57,32,89,1.78125
5691,2,111,211,322,0.5260663507109005
5691,3,359,206,565,1.7427184466019416
5692,1,66,399,465,0.16541353383458646
5692,2,479,513,992,0.9337231968810916
5693,1,271,15,286,18.066666666666666
5693,2,322,15,337,21.466666666666665
5693,3,340,269,609,1.2639405204460967
5693,4,677,15,692,45.13333333333333
5693,5,695,444,1139,1.5653153153153154
5693,6,1181,15,1196,78.73333333333333
5693,7,1199,515,1714,2.3281553398058255
5694,1,22,497,519,0.04426559356136821
5694,2,530,553,1083,0.9584086799276673
5694,3,1176,577,1753,2.0381282495667246
5695,1,40,612,652,0.06535947712418301
5695,2,670,457,1127,1.4660831509846828
5696,1,67,312,379,0.21474358974358973
5696,2,382,25,407,15.28
5696,3,423,329,752,1.2857142857142858
5696,4,785,206,991,3.8106796116504853
5696,5,1012,194,1206,5.216494845360825
5696,6,1248,200,1448,6.24
5696,7,1456,308,1764,4.7272727272727275
5696,8,1780,283,2063,6.289752650176679
5696,9,2066,283,2349,7.30035335689046
5697,1,24,562,586,0.042704626334519574
5697,2,600,478,1078,1.2552301255230125
5697,3,1094,558,1652,1.960573476702509
5698,1,25,44,69,0.5681818181818182
5699,1,655,291,946,2.2508591065292096
5700,1,24,937,961,0.025613660618996798
5700,2,968,433,1401,2.235565819861432
5701,1,65,754,819,0.08620689655172414
5701,2,830,609,1439,1.3628899835796386
5701,3,1498,889,2387,1.68503937007874
5702,1,105,936,1041,0.11217948717948718
5702,2,1043,361,1404,2.889196675900277
5702,3,1457,967,2424,1.5067218200620476
5702,4,2426,479,2905,5.064718162839249
5703,1,57,138,195,0.41304347826086957
5703,2,221,93,314,2.3763440860215055
5704,1,73,109,182,0.6697247706422018
5704,2,228,795,1023,0.28679245283018867
5704,3,1064,380,1444,2.8
5704,4,1538,821,2359,1.8733252131546894
5704,5,2401,634,3035,3.7870662460567823
5704,6,3043,191,3234,15.93193717277487
5704,7,3264,593,3857,5.504215851602024
5704,8,3863,113,3976,34.1858407079646
5705,1,12,623,635,0.019261637239165328
5706,1,93,91,184,1.021978021978022
5707,1,13,480,493,0.027083333333333334
5708,1,26,421,447,0.06175771971496437
5708,2,464,602,1066,0.770764119601329
5709,1,47,545,592,0.08623853211009175
5709,2,618,719,1337,0.8595271210013908
5709,3,1349,771,2120,1.7496757457846952
5710,1,200,284,484,0.704225352112676
5710,2,622,318,940,1.9559748427672956
5710,3,959,341,1300,2.812316715542522
5710,4,1397,303,1700,4.6105610561056105
5710,5,1704,266,1970,6.406015037593985
5710,6,2073,365,2438,5.67945205479452
5710,7,2444,337,2781,7.252225519287834
5710,8,2855,802,3657,3.5598503740648377
5710,9,3706,127,3833,29.181102362204726
5710,10,3854,104,3958,37.05769230769231
5710,11,4059,99,4158,41.0
5710,12,4487,528,5015,8.49810606060606
5710,13,5815,431,6246,13.491879350348027
5710,14,6293,299,6592,21.046822742474916
5710,15,6648,293,6941,22.68941979522184
5710,16,6971,691,7662,10.088277858176555
5711,1,115,952,1067,0.1207983193277311
5711,2,1891,849,2740,2.227326266195524
5711,3,2796,947,3743,2.9524815205913413
5711,4,3755,102,3857,36.81372549019608
5711,5,3952,694,4646,5.694524495677234
5711,6,4700,725,5425,6.482758620689655
5711,7,5446,784,6230,6.946428571428571
5711,8,6365,103,6468,61.79611650485437
5711,9,6617,949,7566,6.972602739726027
5712,1,66,112,178,0.5892857142857143
5712,2,383,133,516,2.8796992481203008
5712,3,783,145,928,5.4
5712,4,1176,154,1330,7.636363636363637
5712,5,1597,112,1709,14.258928571428571
5712,6,1858,138,1996,13.46376811594203
5713,1,152,638,790,0.23824451410658307
5713,2,847,913,1760,0.927710843373494
5713,3,1762,781,2543,2.2560819462227912
5714,1,47,18,65,2.611111111111111
5714,2,69,109,178,0.6330275229357798
5714,3,374,803,1177,0.4657534246575342
5714,4,1323,928,2251,1.425646551724138
5714,5,2310,952,3262,2.426470588235294
5714,6,3275,106,3381,30.89622641509434
5714,7,3394,61,3455,55.63934426229508
5714,8,3469,159,3628,21.81761006289308
5714,9,3679,173,3852,21.265895953757227
5714,10,3867,186,4053,20.79032258064516
5714,11,4064,879,4943,4.623435722411831
5714,12,5096,978,6074,5.210633946830266
5714,13,6076,362,6438,16.784530386740332
5714,14,6448,235,6683,27.438297872340424
5714,15,6836,562,7398,12.163701067615659
5715,1,3458,519,3977,6.66281310211946
5715,2,3983,328,4311,12.143292682926829
5715,3,4318,281,4599,15.366548042704625
5716,1,54,261,315,0.20689655172413793
5716,2,343,110,453,3.118181818181818
5717,1,176,623,799,0.2825040128410915
5717,2,837,625,1462,1.3392
5717,3,1564,731,2295,2.13953488372093
5717,4,2370,853,3223,2.7784290738569752
5718,1,47,393,440,0.11959287531806616
5718,2,478,291,769,1.6426116838487972
5718,3,805,159,964,5.062893081761007
5718,4,980,149,1129,6.577181208053691
5719,1,171,598,769,0.28595317725752506
5719,2,842,552,1394,1.5253623188405796
5720,1,34,930,964,0.03655913978494624
5720,2,974,850,1824,1.1458823529411766
5721,1,11,481,492,0.02286902286902287
5722,1,22,78,100,0.28205128205128205
5722,2,126,341,467,0.36950146627565983
5722,3,793,772,1565,1.0272020725388602
5722,4,1614,484,2098,3.334710743801653
5722,5,2119,829,2948,2.5560916767189386
5722,6,2967,424,3391,6.997641509433962
5722,7,3413,409,3822,8.34474327628362
5722,8,3863,479,4342,8.064718162839249
5722,9,4359,616,4975,7.076298701298701
5722,10,4994,524,5518,9.530534351145038
5722,11,5537,316,5853,17.522151898734176
5722,12,5920,497,6417,11.911468812877263
5722,13,6511,615,7126,10.5869918699187
5722,14,7196,12,7208,599.6666666666666
5722,15,7279,664,7943,10.962349397590362
5723,1,87,86,173,1.0116279069767442
5723,2,332,354,686,0.9378531073446328
5723,3,714,229,943,3.1179039301310043
5723,4,1021,125,1146,8.168
5723,5,1215,292,1507,4.160958904109589
5723,6,1560,285,1845,5.473684210526316
5723,7,2057,497,2554,4.138832997987928
5723,8,2686,337,3023,7.970326409495549
5723,9,3093,308,3401,10.042207792207792
5724,1,464,250,714,1.856
5724,2,756,375,1131,2.016
5724,3,1147,115,1262,9.97391304347826
5724,4,1301,322,1623,4.040372670807454
5724,5,1665,510,2175,3.264705882352941
5724,6,2213,556,2769,3.9802158273381294
5724,7,2822,525,3347,5.375238095238095
5724,8,3369,227,3596,14.841409691629956
5724,9,3603,49,3652,73.53061224489795
5724,10,3777,559,4336,6.756708407871199
5724,11,4421,103,4524,42.922330097087375
5724,12,4710,530,5240,8.88679245283019
5724,13,5247,424,5671,12.375
5724,14,5689,165,5854,34.47878787878788
5724,15,6042,410,6452,14.736585365853658
5724,16,6537,190,6727,34.40526315789474
5725,1,30,917,947,0.03271537622682661
5725,2,962,916,1878,1.0502183406113537
5726,1,12,391,403,0.030690537084398978
5726,2,496,296,792,1.6756756756756757
5726,3,850,413,1263,2.0581113801452786
5726,4,1316,380,1696,3.463157894736842
5726,5,1729,435,2164,3.974712643678161
5726,6,2193,412,2605,5.322815533980583
5726,7,2621,391,3012,6.703324808184143
5726,8,3029,421,3450,7.194774346793349
5727,1,617,4,621,154.25
5727,2,1211,529,1740,2.2892249527410207
5727,3,1822,308,2130,5.915584415584416
5727,4,2178,75,2253,29.04
5727,5,2424,443,2867,5.471783295711061
5728,1,467,27,494,17.296296296296298
5728,2,1567,947,2514,1.654699049630412
5728,3,2628,975,3603,2.6953846153846155
5729,1,68,405,473,0.16790123456790124
5729,2,545,321,866,1.6978193146417446
5730,1,1898,640,2538,2.965625
5731,1,21,486,507,0.043209876543209874
5731,2,514,294,808,1.748299319727891
5731,3,816,353,1169,2.311614730878187
5731,4,1183,458,1641,2.5829694323144103
5732,1,33,1016,1049,0.03248031496062992
5732,2,1051,271,1322,3.878228782287823
5733,1,55,571,626,0.09632224168126094
5733,2,650,924,1574,0.7034632034632035
5733,3,1612,791,2403,2.0379266750948166
5733,4,2410,154,2564,15.64935064935065
5733,5,2573,160,2733,16.08125
5734,1,47,88,135,0.5340909090909091
5734,2,148,38,186,3.8947368421052633
5734,3,215,23,238,9.347826086956522
5734,4,264,46,310,5.739130434782608
5734,5,350,76,426,4.605263157894737
5734,6,543,67,610,8.104477611940299
5734,7,645,81,726,7.962962962962963
5734,8,734,129,863,5.689922480620155
5734,9,868,111,979,7.81981981981982
5734,10,1013,133,1146,7.616541353383458
5734,11,1176,140,1316,8.4
5734,12,1338,273,1611,4.9010989010989015
5734,13,1651,108,1759,15.287037037037036
5734,14,1793,100,1893,17.93
5734,15,1895,70,1965,27.071428571428573
5734,16,1970,42,2012,46.904761904761905
5734,17,2032,68,2100,29.88235294117647
5734,18,2111,77,2188,27.415584415584416
5734,19,2194,43,2237,51.02325581395349
5734,20,2263,34,2297,66.55882352941177
5734,21,2326,59,2385,39.42372881355932
5734,22,2391,46,2437,51.97826086956522
5734,23,2453,70,2523,35.042857142857144
5734,24,2536,59,2595,42.983050847457626
5734,25,2601,79,2680,32.924050632911396
5734,26,2711,67,2778,40.46268656716418
5734,27,2804,52,2856,53.92307692307692
5734,28,2884,54,2938,53.407407407407405
5734,29,2945,59,3004,49.91525423728814
5734,30,3020,53,3073,56.9811320754717
5734,31,3092,86,3178,35.95348837209303
5734,32,3187,87,3274,36.632183908045974
5734,33,3288,288,3576,11.416666666666666
5735,1,199,1013,1212,0.1964461994076999
5735,2,1214,708,1922,1.7146892655367232
5735,3,1924,926,2850,2.077753779697624
5735,4,2852,969,3821,2.9432404540763675
5735,5,3823,675,4498,5.663703703703704
5736,1,24,638,662,0.03761755485893417
5737,1,2539,351,2890,7.233618233618234
5737,2,2918,478,3396,6.104602510460251
5737,3,3491,808,4299,4.320544554455446
5737,4,4441,543,4984,8.178637200736649
5737,5,5015,564,5579,8.891843971631205
5737,6,5613,564,6177,9.952127659574469
5737,7,6207,454,6661,13.67180616740088
5737,8,6679,427,7106,15.641686182669789
5737,9,7143,623,7766,11.465489566613162
5738,1,745,929,1674,0.8019375672766416
5738,2,1715,613,2328,2.797716150081566
5738,3,2336,906,3242,2.5783664459161146
5738,4,3250,470,3720,6.914893617021277
5738,5,3728,906,4634,4.114790286975717
5738,6,4642,470,5112,9.87659574468085
5738,7,5120,878,5998,5.831435079726652
5738,8,6006,943,6949,6.369034994697773
5738,9,6957,684,7641,10.171052631578947
5739,1,25,47,72,0.5319148936170213
5739,2,94,71,165,1.323943661971831
5739,3,178,76,254,2.3421052631578947
5739,4,267,92,359,2.902173913043478
5740,1,10,593,603,0.016863406408094434
5740,2,614,332,946,1.8493975903614457
5741,1,36,897,933,0.04013377926421405
5741,2,936,380,1316,2.463157894736842
5741,3,1356,847,2203,1.6009445100354192
5742,1,37,85,122,0.43529411764705883
5742,2,125,30,155,4.166666666666667
5742,3,207,27,234,7.666666666666667
5742,4,286,42,328,6.809523809523809
5742,5,475,282,757,1.6843971631205674
5742,6,894,505,1399,1.7702970297029703
5742,7,1453,652,2105,2.228527607361963
5742,8,2185,430,2615,5.0813953488372094
5743,1,119,783,902,0.15197956577266922
5743,2,910,526,1436,1.7300380228136882
5743,3,1560,775,2335,2.0129032258064514
5743,4,2343,727,3070,3.22283356258597
5743,5,3200,839,4039,3.8140643623361146
5743,6,4047,799,4846,5.065081351689612
5743,7,4854,256,5110,18.9609375
5743,8,5239,756,5995,6.9298941798941796
5743,9,6003,808,6811,7.429455445544554
5743,10,6944,790,7734,8.78987341772152
5744,1,80,617,697,0.12965964343598055
5744,2,708,425,1133,1.6658823529411764
5744,3,1162,461,1623,2.5206073752711498
5744,4,1646,270,1916,6.0962962962962965
5744,5,1947,316,2263,6.1613924050632916
5744,6,2286,249,2535,9.180722891566266
5744,7,2553,456,3009,5.598684210526316
5745,1,470,344,814,1.3662790697674418
5746,1,58,441,499,0.13151927437641722
5747,1,29,529,558,0.054820415879017016
5747,2,877,428,1305,2.0490654205607477
5747,3,1355,437,1792,3.1006864988558354
5747,4,1818,551,2369,3.2994555353901998
5747,5,2402,546,2948,4.3992673992674
5747,6,3002,497,3499,6.040241448692153
5747,7,3509,941,4450,3.7290116896918173
5747,8,4845,751,5596,6.451398135818908
5747,9,5661,972,6633,5.824074074074074
5747,10,6639,47,6686,141.25531914893617
5747,11,6709,145,6854,46.26896551724138
5748,1,556,3455,4011,0.1609261939218524
5749,1,473,411,884,1.1508515815085159
5749,2,916,605,1521,1.5140495867768595
5749,3,1553,495,2048,3.1373737373737374
5749,4,2076,462,2538,4.4935064935064934
5749,5,2631,563,3194,4.673179396092363
5749,6,3260,456,3716,7.149122807017544
5749,7,3745,483,4228,7.753623188405797
5750,1,33,977,1010,0.033776867963152504
5750,2,1013,394,1407,2.5710659898477157
5751,1,167,665,832,0.2511278195488722
5751,2,846,651,1497,1.2995391705069124
5751,3,1506,682,2188,2.2082111436950145
5751,4,2268,666,2934,3.4054054054054053
5751,5,2948,681,3629,4.328928046989721
5751,6,3643,671,4314,5.429210134128167
5752,1,88,840,928,0.10476190476190476
5752,2,934,735,1669,1.2707482993197279
5753,1,58,655,713,0.08854961832061069
5754,1,658,349,1007,1.8853868194842407
5755,1,32,781,813,0.040973111395646605
5755,2,834,1025,1859,0.8136585365853658
5756,1,145,723,868,0.20055325034578148
5756,2,889,714,1603,1.2450980392156863
5756,3,1618,621,2239,2.605475040257649
5756,4,2250,629,2879,3.577106518282989
5756,5,2890,488,3378,5.922131147540983
5756,6,3387,462,3849,7.3311688311688314
5756,7,3858,492,4350,7.841463414634147
5756,8,4368,310,4678,14.09032258064516
5756,9,4688,593,5281,7.905564924114671
5756,10,5290,507,5797,10.433925049309664
5756,11,5821,427,6248,13.63231850117096
5756,12,6279,443,6722,14.173814898419865
5756,13,6747,96,6843,70.28125
5757,1,1123,231,1354,4.861471861471862
5758,1,732,617,1349,1.186385737439222
5759,1,18,451,469,0.03991130820399113
5759,2,479,709,1188,0.6755994358251057
5759,3,1219,723,1942,1.686030428769018
5760,1,13,15,28,0.8666666666666667
5760,2,651,494,1145,1.3178137651821862
5761,1,31,67,98,0.4626865671641791
5761,2,107,99,206,1.0808080808080809
5761,3,213,111,324,1.9189189189189189
5762,1,70,426,496,0.1643192488262911
5762,2,504,417,921,1.20863309352518
5762,3,929,367,1296,2.5313351498637604
5762,4,1302,34,1336,38.294117647058826
5762,5,1367,353,1720,3.8725212464589234
5762,6,1728,350,2078,4.937142857142857
5763,1,84,3,87,28.0
5763,2,748,3,751,249.33333333333334
5763,3,1598,3,1601,532.6666666666666
5763,4,2144,3,2147,714.6666666666666
5763,5,2797,368,3165,7.600543478260869
5763,6,3184,230,3414,13.843478260869565
5763,7,3434,876,4310,3.9200913242009134
5763,8,4320,776,5096,5.56701030927835
5763,9,5128,67,5195,76.53731343283582
5763,10,5313,798,6111,6.657894736842105
5764,1,29,393,422,0.0737913486005089
5765,1,105,403,508,0.26054590570719605
5765,2,554,372,926,1.489247311827957
5765,3,939,281,1220,3.3416370106761564
5765,4,1298,271,1569,4.789667896678967
5765,5,1603,270,1873,5.937037037037037
5765,6,1885,145,2030,13.0
5765,7,2069,332,2401,6.231927710843373
5765,8,2431,89,2520,27.314606741573034
5766,1,73,108,181,0.6759259259259259
5766,2,222,189,411,1.1746031746031746
5767,1,29,69,98,0.42028985507246375
5767,2,112,42,154,2.6666666666666665
5767,3,163,106,269,1.5377358490566038
5767,4,279,130,409,2.146153846153846
5767,5,419,39,458,10.743589743589743
5767,6,470,46,516,10.217391304347826
5767,7,537,57,594,9.421052631578947
5767,8,604,39,643,15.487179487179487
5767,9,669,93,762,7.193548387096774
5767,10,773,53,826,14.584905660377359
5767,11,855,87,942,9.827586206896552
5767,12,954,39,993,24.46153846153846
5767,13,1038,52,1090,19.96153846153846
5767,14,1105,77,1182,14.35064935064935
5767,15,1210,58,1268,20.862068965517242
5767,16,1285,69,1354,18.6231884057971
5767,17,1378,89,1467,15.48314606741573
5767,18,1516,102,1618,14.862745098039216
5767,19,1659,538,2197,3.08364312267658
5767,20,2225,104,2329,21.39423076923077
5767,21,2337,62,2399,37.693548387096776
5767,22,2428,165,2593,14.715151515151515
5767,23,2615,127,2742,20.590551181102363
5768,1,191,868,1059,0.22004608294930875
5769,1,2980,392,3372,7.6020408163265305
5769,2,3374,451,3825,7.481152993348116
5769,3,3827,232,4059,16.495689655172413
5770,1,10,505,515,0.019801980198019802
5770,2,628,709,1337,0.8857545839210155
5770,3,1366,778,2144,1.755784061696658
5771,1,51,819,870,0.06227106227106227
5771,2,923,694,1617,1.3299711815561959
5772,1,17,405,422,0.04197530864197531
5772,2,436,422,858,1.033175355450237
5772,3,882,424,1306,2.080188679245283
5772,4,1318,334,1652,3.946107784431138
5772,5,1735,412,2147,4.211165048543689
5772,6,2203,362,2565,6.085635359116022
5772,7,2591,378,2969,6.854497354497354
5772,8,2992,375,3367,7.978666666666666
5772,9,3421,405,3826,8.446913580246914
5772,10,3835,592,4427,6.47804054054054
5772,11,4467,543,5010,8.226519337016574
5772,12,5027,512,5539,9.818359375
5772,13,5585,536,6121,10.419776119402986
5772,14,6155,496,6651,12.409274193548388
5772,15,6685,529,7214,12.637051039697543
5772,16,7274,472,7746,15.411016949152541
5773,1,46,408,454,0.11274509803921569
5773,2,468,284,752,1.647887323943662
5773,3,821,284,1105,2.890845070422535
5773,4,1199,347,1546,3.4553314121037464
5773,5,1624,253,1877,6.4189723320158105
5773,6,1964,186,2150,10.559139784946236
5773,7,2198,478,2676,4.598326359832636
5773,8,2693,280,2973,9.617857142857142
5773,9,3033,201,3234,15.08955223880597
5773,10,3260,337,3597,9.673590504451038
5773,11,3667,242,3909,15.152892561983471
5773,12,3934,349,4283,11.272206303724928
5773,13,4364,279,4643,15.6415770609319
5773,14,4799,264,5063,18.178030303030305
5773,15,5112,135,5247,37.86666666666667
5773,16,5299,269,5568,19.69888475836431
5773,17,5581,290,5871,19.244827586206895
5773,18,6166,316,6482,19.5126582278481
5773,19,6513,284,6797,22.933098591549296
5773,20,6838,317,7155,21.57097791798107
5773,21,7185,356,7541,20.18258426966292
5773,22,7559,102,7661,74.1078431372549
5774,1,523,221,744,2.3665158371040724
5774,2,1443,56,1499,25.767857142857142
5774,3,2228,3,2231,742.6666666666666
5775,1,22,575,597,0.03826086956521739
5776,1,108,137,245,0.7883211678832117
5776,2,337,221,558,1.5248868778280542
5776,3,614,104,718,5.903846153846154
5776,4,724,101,825,7.1683168316831685
5776,5,877,158,1035,5.550632911392405
5776,6,1112,367,1479,3.0299727520435966
5776,7,1505,257,1762,5.856031128404669
5776,8,1794,65,1859,27.6
5776,9,1886,124,2010,15.209677419354838
5776,10,2120,397,2517,5.340050377833753
5776,11,2557,165,2722,15.496969696969696
5776,12,2746,138,2884,19.89855072463768
5776,13,2901,58,2959,50.01724137931034
5776,14,3010,137,3147,21.970802919708028
5776,15,3176,60,3236,52.93333333333333
5776,16,4028,28,4056,143.85714285714286
5776,17,4065,159,4224,25.566037735849058
5776,18,4255,76,4331,55.98684210526316
5776,19,4353,81,4434,53.74074074074074
5776,20,4452,693,5145,6.424242424242424
5777,1,114,520,634,0.21923076923076923
5777,2,639,534,1173,1.196629213483146
5777,3,1178,534,1712,2.2059925093632957
5777,4,1717,517,2234,3.3210831721470018
5777,5,2239,511,2750,4.38160469667319
5777,6,2755,297,3052,9.276094276094277
5777,7,3288,597,3885,5.507537688442211
5777,8,3890,681,4571,5.7121879588839946
5777,9,4576,602,5178,7.601328903654485
5777,10,5248,619,5867,8.478190630048465
5777,11,5872,652,6524,9.006134969325153
5777,12,6529,315,6844,20.726984126984128
5777,13,6885,354,7239,19.449152542372882
5778,1,13,723,736,0.017980636237897647
5778,2,757,771,1528,0.9818417639429312
5778,3,1534,6,1540,255.66666666666666
5778,4,1561,822,2383,1.8990267639902676
5778,5,2392,514,2906,4.653696498054475
5778,6,2998,873,3871,3.4341351660939288
5778,7,3886,536,4422,7.25
5778,8,4446,728,5174,6.107142857142857
5778,9,5195,497,5692,10.45271629778672
5778,10,5747,571,6318,10.064798598949212
5778,11,6330,381,6711,16.614173228346456
5778,12,6722,352,7074,19.09659090909091
5778,13,7094,337,7431,21.050445103857566
5779,1,55,537,592,0.10242085661080075
5780,1,2050,321,2371,6.386292834890965
5780,2,2373,297,2670,7.98989898989899
5780,3,2672,291,2963,9.18213058419244
5780,4,2965,342,3307,8.669590643274853
5780,5,3309,306,3615,10.813725490196079
5780,6,3617,324,3941,11.16358024691358
5780,7,3943,314,4257,12.55732484076433
5780,8,4259,243,4502,17.526748971193417
5780,9,4504,408,4912,11.03921568627451
5780,10,4914,393,5307,12.50381679389313
5781,1,31,927,958,0.03344120819848975
5781,2,967,513,1480,1.884990253411306
5782,1,18,445,463,0.04044943820224719
5783,1,421,397,818,1.0604534005037782
5783,2,829,326,1155,2.542944785276074
5784,1,66,384,450,0.171875
5784,2,452,365,817,1.2383561643835617
5784,3,829,59,888,14.05084745762712
5784,4,937,383,1320,2.446475195822454
5784,5,1322,331,1653,3.9939577039274923
5784,6,1661,59,1720,28.152542372881356
5784,7,1760,375,2135,4.693333333333333
5784,8,2138,377,2515,5.6710875331564985
5784,9,2560,404,2964,6.336633663366337
5784,10,2966,269,3235,11.026022304832713
5784,11,3253,433,3686,7.51270207852194
5784,12,3688,118,3806,31.25423728813559
5784,13,3825,132,3957,28.977272727272727
5784,14,3972,66,4038,60.18181818181818
5784,15,4049,51,4100,79.3921568627451
5784,16,4108,45,4153,91.28888888888889
5784,17,4162,66,4228,63.06060606060606
5784,18,4239,83,4322,51.0722891566265
5784,19,4335,86,4421,50.406976744186046
5784,20,4441,103,4544,43.116504854368934
5784,21,4559,117,4676,38.965811965811966
5784,22,4692,79,4771,59.392405063291136
5784,23,4783,81,4864,59.04938271604938
5784,24,4892,285,5177,17.164912280701753
5784,25,5191,91,5282,57.043956043956044
5784,26,5295,86,5381,61.56976744186046
5784,27,5395,109,5504,49.4954128440367
5784,28,5530,214,5744,25.8411214953271
5784,29,5777,86,5863,67.17441860465117
5784,30,5876,44,5920,133.54545454545453
5784,31,5930,419,6349,14.152744630071599
5784,32,6396,259,6655,24.694980694980696
5784,33,6670,150,6820,44.46666666666667
5784,34,6837,191,7028,35.795811518324605
5784,35,7046,28,7074,251.64285714285714
5784,36,7089,28,7117,253.17857142857142
5785,1,24,827,851,0.02902055622732769
5786,1,1863,387,2250,4.813953488372093
5786,2,2259,525,2784,4.3028571428571425
5787,1,36,718,754,0.05013927576601671
5787,2,774,3,777,258.0
5788,1,76,584,660,0.13013698630136986
5789,1,6,15,21,0.4
5789,2,64,463,527,0.13822894168466524
5789,3,542,535,1077,1.0130841121495326
5789,4,1091,700,1791,1.5585714285714285
5789,5,1807,512,2319,3.529296875
5789,6,2344,881,3225,2.66061293984109
5789,7,3235,888,4123,3.643018018018018
5789,8,4137,890,5027,4.648314606741573
5789,9,5063,886,5949,5.714446952595937
5789,10,5989,885,6874,6.767231638418079
5790,1,55,687,742,0.08005822416302766
5790,2,857,32,889,26.78125
5791,1,471,589,1060,0.799660441426146
5791,2,1066,715,1781,1.490909090909091
5791,3,2235,732,2967,3.05327868852459
5791,4,3229,530,3759,6.092452830188679
5792,1,341,382,723,0.8926701570680629
5793,1,140,636,776,0.22012578616352202
5793,2,869,322,1191,2.698757763975155
5793,3,1219,613,1832,1.9885807504078303
5793,4,1861,672,2533,2.769345238095238
5793,5,2575,684,3259,3.7646198830409356
5793,6,3317,865,4182,3.8346820809248556
5793,7,4284,883,5167,4.851642129105323
5793,8,5195,570,5765,9.114035087719298
5793,9,6601,9,6610,733.4444444444445
5793,10,6615,225,6840,29.4
5793,11,6845,272,7117,25.165441176470587
5793,12,7122,379,7501,18.79155672823219
5793,13,7506,576,8082,13.03125
5794,1,66,477,543,0.13836477987421383
5794,2,607,600,1207,1.0116666666666667
5794,3,1230,566,1796,2.1731448763250882
5794,4,1851,650,2501,2.8476923076923075
5794,5,2515,624,3139,4.030448717948718
5794,6,3151,640,3791,4.9234375
5794,7,3804,445,4249,8.548314606741574
5794,8,4272,1007,5279,4.242303872889772
5794,9,5302,438,5740,12.105022831050228
5795,1,24,369,393,0.06504065040650407
5795,2,396,407,803,0.972972972972973
5795,3,841,385,1226,2.1844155844155844
5795,4,1229,215,1444,5.716279069767442
5795,5,1493,386,1879,3.8678756476683938
5795,6,1882,397,2279,4.740554156171284
5795,7,2301,184,2485,12.505434782608695
5795,8,2516,156,2672,16.128205128205128
5795,9,2762,433,3195,6.378752886836028
5795,10,3198,393,3591,8.13740458015267
5796,1,98,474,572,0.20675105485232068
5796,2,620,474,1094,1.3080168776371308
5796,3,1127,620,1747,1.8177419354838709
5796,4,1751,635,2386,2.7574803149606297
5796,5,2443,575,3018,4.248695652173913
5796,6,3035,450,3485,6.7444444444444445
5796,7,3503,657,4160,5.331811263318112
5796,8,4178,803,4981,5.202988792029888
5796,9,5125,586,5711,8.745733788395905
5796,10,5729,692,6421,8.278901734104046
5796,11,6440,422,6862,15.260663507109005
5796,12,6868,37,6905,185.6216216216216
5796,13,6906,41,6947,168.4390243902439
5797,1,29,559,588,0.0518783542039356
5797,2,611,994,1605,0.6146881287726358
5798,1,124,443,567,0.2799097065462754
5798,2,596,838,1434,0.711217183770883
5799,1,429,543,972,0.7900552486187845
5800,1,23,290,313,0.07931034482758621
5800,2,343,339,682,1.0117994100294985
5801,1,958,368,1326,2.6032608695652173
5801,2,1334,406,1740,3.2857142857142856
5801,3,2085,215,2300,9.69767441860465
5801,4,2415,297,2712,8.131313131313131
5802,1,39,558,597,0.06989247311827956
5802,2,608,899,1507,0.6763070077864294
5802,3,1519,696,2215,2.182471264367816
5803,1,556,438,994,1.269406392694064
5803,2,1013,420,1433,2.4119047619047618
5804,1,26,594,620,0.04377104377104377
5805,1,77,60,137,1.2833333333333334
5805,2,638,424,1062,1.5047169811320755
5805,3,2668,473,3141,5.6405919661733614
5806,1,60,578,638,0.10380622837370242
5806,2,667,574,1241,1.1620209059233448
5806,3,1277,264,1541,4.837121212121212
5806,4,1570,472,2042,3.3262711864406778
5807,1,59,34,93,1.7352941176470589
5807,2,552,336,888,1.6428571428571428
5807,3,895,664,1559,1.3478915662650603
5807,4,1561,463,2024,3.3714902807775378
5807,5,2026,510,2536,3.9725490196078432
5807,6,2832,222,3054,12.756756756756756
5807,7,3062,173,3235,17.69942196531792
5807,8,3243,726,3969,4.466942148760331
5807,9,3972,333,4305,11.927927927927929
5807,10,4307,563,4870,7.650088809946714
5807,11,4881,131,5012,37.25954198473283
5807,12,5044,224,5268,22.517857142857142
5807,13,5274,655,5929,8.051908396946565
5807,14,5931,634,6565,9.354889589905362
5807,15,6567,607,7174,10.818780889621088
5807,16,7181,182,7363,39.456043956043956
5807,17,7406,64,7470,115.71875
5807,18,7624,118,7742,64.61016949152543
5807,19,7855,128,7983,61.3671875
5808,1,47,593,640,0.07925801011804384
5808,2,657,592,1249,1.1097972972972974
5808,3,1366,1020,2386,1.3392156862745097
5808,4,2488,1034,3522,2.4061895551257253
5809,1,63,461,524,0.13665943600867678
5810,1,48,72,120,0.6666666666666666
5810,2,1356,245,1601,5.53469387755102
5811,1,10,97,107,0.10309278350515463
5811,2,124,198,322,0.6262626262626263
5812,1,48,126,174,0.38095238095238093
5812,2,224,737,961,0.3039348710990502
5812,3,993,821,1814,1.2095006090133984
5812,4,1838,745,2583,2.4671140939597316
5812,5,2621,958,3579,2.7359081419624216
5812,6,3590,963,4553,3.727933541017653
5812,7,4571,617,5188,7.408427876823339
5812,8,5225,850,6075,6.147058823529412
5812,9,6130,288,6418,21.28472222222222
5812,10,6474,515,6989,12.570873786407766
5812,11,7103,733,7836,9.69031377899045
5813,1,84,584,668,0.14383561643835616
5813,2,716,648,1364,1.1049382716049383
5814,1,35,863,898,0.04055619930475087
5815,1,40,130,170,0.3076923076923077
5815,2,186,474,660,0.3924050632911392
5815,3,700,640,1340,1.09375
5815,4,1387,566,1953,2.450530035335689
5815,5,2775,495,3270,5.606060606060606
5816,1,25,732,757,0.03415300546448088
5816,2,768,464,1232,1.6551724137931034
5816,3,1262,402,1664,3.1393034825870645
5816,4,1708,636,2344,2.6855345911949686
5816,5,2361,164,2525,14.396341463414634
5816,6,2552,424,2976,6.018867924528302
5816,7,3001,426,3427,7.044600938967136
5816,8,3456,381,3837,9.070866141732283
5817,1,410,647,1057,0.633693972179289
5817,2,1080,429,1509,2.5174825174825175
5817,3,1528,702,2230,2.1766381766381766
5817,4,2287,617,2904,3.706645056726094
5817,5,2914,965,3879,3.0196891191709843
5817,6,4024,579,4603,6.9499136442141625
5817,7,4705,549,5254,8.570127504553733
5817,8,5353,129,5482,41.49612403100775
5817,9,5515,498,6013,11.07429718875502
5817,10,6060,674,6734,8.991097922848665
5817,11,6752,549,7301,12.29872495446266
5818,1,1720,408,2128,4.215686274509804
5818,2,2140,431,2571,4.965197215777263
5818,3,4554,313,4867,14.549520766773163
5818,4,4918,242,5160,20.322314049586776
5818,5,5196,376,5572,13.819148936170214
5818,6,5900,334,6234,17.664670658682635
5818,7,6575,378,6953,17.394179894179896
5818,8,7707,74,7781,104.14864864864865
5818,9,7790,269,8059,28.95910780669145
5819,1,3011,351,3362,8.578347578347579
5819,2,3457,333,3790,10.381381381381381
5819,3,3883,270,4153,14.381481481481481
5819,4,4258,378,4636,11.264550264550264
5819,5,4742,234,4976,20.264957264957264
5819,6,5075,315,5390,16.11111111111111
5820,1,20,878,898,0.022779043280182234
5820,2,906,518,1424,1.749034749034749
5820,3,1454,341,1795,4.263929618768328
5820,4,1879,855,2734,2.1976608187134503
5820,5,2746,590,3336,4.654237288135593
5820,6,3655,727,4382,5.027510316368638
5820,7,4443,597,5040,7.442211055276382
5820,8,5159,412,5571,12.521844660194175
5820,9,5599,379,5978,14.773087071240106
5820,10,6147,645,6792,9.530232558139534
5820,11,6853,772,7625,8.876943005181348
5821,1,36,773,809,0.04657179818887452
5822,1,39,478,517,0.08158995815899582
5822,2,569,428,997,1.3294392523364487
5822,3,1008,506,1514,1.992094861660079
5823,1,55,94,149,0.5851063829787234
5823,2,163,459,622,0.355119825708061
5824,1,22,633,655,0.03475513428120063
5824,2,674,657,1331,1.025875190258752
5824,3,1349,652,2001,2.0690184049079754
5824,4,2030,664,2694,3.0572289156626504
5824,5,2703,615,3318,4.3951219512195125
5824,6,3337,538,3875,6.202602230483271
5825,1,13,802,815,0.016209476309226933
5825,2,822,972,1794,0.845679012345679
5826,1,11,414,425,0.026570048309178744
5826,2,456,584,1040,0.7808219178082192
5826,3,1167,356,1523,3.2780898876404496
5826,4,1555,325,1880,4.7846153846153845
5826,5,1907,263,2170,7.250950570342205
5826,6,2276,369,2645,6.168021680216802
5826,7,2690,523,3213,5.1434034416826
5826,8,3241,474,3715,6.837552742616034
5826,9,3726,273,3999,13.648351648351648
5826,10,4004,158,4162,25.341772151898734
5826,11,4176,465,4641,8.980645161290322
5826,12,4673,283,4956,16.512367491166078
5827,1,20,704,724,0.028409090909090908
5828,1,1276,871,2147,1.4649827784156142
5828,2,3322,119,3441,27.915966386554622
5829,1,332,678,1010,0.4896755162241888
5829,2,1026,610,1636,1.681967213114754
5829,3,1656,656,2312,2.524390243902439
5829,4,2374,989,3363,2.4004044489383216
5829,5,3390,971,4361,3.49124613800206
5829,6,4456,664,5120,6.710843373493976
5829,7,5145,676,5821,7.6109467455621305
5829,8,5843,667,6510,8.760119940029986
5829,9,6580,861,7441,7.642276422764228
5830,1,84,123,207,0.6829268292682927
5830,2,219,105,324,2.085714285714286
5830,3,527,39,566,13.512820512820513
5831,1,28,337,365,0.0830860534124629
5832,1,47,105,152,0.44761904761904764
5832,2,176,142,318,1.2394366197183098
5832,3,379,159,538,2.3836477987421385
5833,1,17,417,434,0.0407673860911271
5833,2,445,697,1142,0.6384505021520803
5834,1,24,906,930,0.026490066225165563
5834,2,976,605,1581,1.6132231404958677
5835,1,12,218,230,0.05504587155963303
5836,1,262,308,570,0.8506493506493507
5836,2,586,98,684,5.979591836734694
5836,3,704,339,1043,2.0766961651917404
5837,1,52,600,652,0.08666666666666667
5837,2,682,469,1151,1.4541577825159915
5837,3,1296,920,2216,1.4086956521739131
5837,4,2225,785,3010,2.8343949044585988
5837,5,3026,118,3144,25.64406779661017
5837,6,3151,359,3510,8.777158774373259
5837,7,3528,952,4480,3.7058823529411766
5837,8,4488,408,4896,11.0
5837,9,4914,62,4976,79.25806451612904
5837,10,4990,355,5345,14.056338028169014
5837,11,5353,286,5639,18.716783216783217
5837,12,5669,593,6262,9.559865092748735
5837,13,6295,505,6800,12.465346534653465
5837,14,6854,671,7525,10.214605067064083
5838,1,113,245,358,0.46122448979591835
5838,2,451,396,847,1.1388888888888888
5838,3,1177,390,1567,3.017948717948718
5838,4,1994,561,2555,3.554367201426025
5838,5,2628,439,3067,5.9863325740318905
5838,6,3132,323,3455,9.696594427244582
5838,7,3469,468,3937,7.412393162393163
5838,8,3991,532,4523,7.5018796992481205
5838,9,4588,585,5173,7.842735042735042
5838,10,5185,195,5380,26.58974358974359
5838,11,5593,39,5632,143.4102564102564
5838,12,5856,446,6302,13.130044843049328
5838,13,6309,375,6684,16.824
5838,14,6730,408,7138,16.495098039215687
5838,15,7179,516,7695,13.912790697674419
5839,1,154,370,524,0.41621621621621624
5839,2,539,966,1505,0.5579710144927537
5839,3,1528,695,2223,2.1985611510791365
5839,4,2252,695,2947,3.2402877697841728
5839,5,2962,546,3508,5.424908424908425
5839,6,3522,837,4359,4.207885304659499
5840,1,557,158,715,3.5253164556962027
5840,2,735,50,785,14.7
5840,3,796,80,876,9.95
5840,4,892,701,1593,1.2724679029957204
5840,5,1621,449,2070,3.6102449888641424
5840,6,2090,764,2854,2.735602094240838
5840,7,2891,816,3707,3.542892156862745
5840,8,3713,910,4623,4.08021978021978
5840,9,5465,1219,6684,4.48318293683347
5840,10,6721,1236,7957,5.4377022653721685
5841,1,79,52,131,1.5192307692307692
5841,2,162,14,176,11.571428571428571
5842,1,24,827,851,0.02902055622732769
5843,1,494,633,1127,0.7804107424960506
5844,1,1187,302,1489,3.9304635761589406
5844,2,1539,456,1995,3.375
5844,3,2062,844,2906,2.443127962085308
5844,4,5966,75,6041,79.54666666666667
5844,5,6082,943,7025,6.449628844114528
5844,6,7041,743,7784,9.476446837146703
5845,1,45,803,848,0.05603985056039851
5845,2,965,698,1663,1.3825214899713467
5846,1,24,647,671,0.03709428129829984
5847,1,117,965,1082,0.12124352331606218
5847,2,1090,496,1586,2.1975806451612905
5848,1,5,540,545,0.009259259259259259
5848,2,569,687,1256,0.8282387190684134
5848,3,1349,861,2210,1.5667828106852497
5848,4,2283,705,2988,3.2382978723404254
5848,5,3219,470,3689,6.848936170212766
5848,6,3803,813,4616,4.677736777367774
5848,7,4942,128,5070,38.609375
5848,8,5130,108,5238,47.5
5848,9,5351,177,5528,30.231638418079097
5848,10,5770,434,6204,13.294930875576037
5848,11,6369,240,6609,26.5375
5848,12,6657,421,7078,15.812351543942993
5848,13,7096,530,7626,13.388679245283019
5849,1,11,193,204,0.05699481865284974
5849,2,218,187,405,1.1657754010695187
5849,3,422,519,941,0.8131021194605009
5849,4,955,321,1276,2.9750778816199377
5850,1,23,1008,1031,0.022817460317460316
5850,2,1033,521,1554,1.982725527831094
5850,3,1703,699,2402,2.436337625178827
5850,4,2422,638,3060,3.7962382445141065
5850,5,3073,790,3863,3.889873417721519
5850,6,3932,713,4645,5.514726507713885
5850,7,4693,621,5314,7.557165861513687
5850,8,5338,485,5823,11.00618556701031
5850,9,5834,488,6322,11.954918032786885
5850,10,6385,586,6971,10.895904436860068
5850,11,7005,507,7512,13.816568047337277
5850,12,7529,427,7956,17.63231850117096
5851,1,368,414,782,0.8888888888888888
5851,2,854,199,1053,4.291457286432161
5852,1,128,792,920,0.16161616161616163
5853,1,13,3,16,4.333333333333333
5853,2,28,49,77,0.5714285714285714
5853,3,114,3,117,38.0
5853,4,129,45,174,2.8666666666666667
5853,5,204,3,207,68.0
5853,6,218,3,221,72.66666666666667
5853,7,226,3,229,75.33333333333333
5853,8,237,6,243,39.5
5853,9,251,6,257,41.833333333333336
5853,10,270,11,281,24.545454545454547
5853,11,291,9,300,32.333333333333336
5853,12,312,98,410,3.183673469387755
5853,13,427,133,560,3.210526315789474
5853,14,584,207,791,2.821256038647343
5853,15,816,264,1080,3.090909090909091
5853,16,1094,288,1382,3.798611111111111
5853,17,1453,419,1872,3.467780429594272
5853,18,1874,218,2092,8.596330275229358
5853,19,2141,39,2180,54.8974358974359
5853,20,2230,3,2233,743.3333333333334
5853,21,2271,256,2527,8.87109375
5853,22,2557,378,2935,6.764550264550264
5853,23,2983,419,3402,7.119331742243436
5853,24,3441,439,3880,7.838268792710706
5853,25,3889,426,4315,9.129107981220658
5854,1,359,461,820,0.7787418655097614
5854,2,831,751,1582,1.1065246338215713
5855,1,26,507,533,0.05128205128205128
5855,2,548,485,1033,1.1298969072164948
5856,1,302,75,377,4.026666666666666
5856,2,688,42,730,16.38095238095238
5857,1,181,54,235,3.3518518518518516
5857,2,1805,609,2414,2.9638752052545154
5857,3,3540,570,4110,6.2105263157894735
5857,4,5877,294,6171,19.989795918367346
5857,5,7626,184,7810,41.44565217391305
5858,1,138,4,142,34.5
5858,2,446,4,450,111.5
5858,3,457,19,476,24.05263157894737
5858,4,643,4,647,160.75
5858,5,682,727,1409,0.938101788170564
5858,6,1540,369,1909,4.173441734417344
5859,1,16,268,284,0.05970149253731343
5860,1,22,380,402,0.05789473684210526
5860,2,404,352,756,1.1477272727272727
5860,3,758,331,1089,2.2900302114803623
5861,1,120,429,549,0.27972027972027974
5861,2,721,609,1330,1.1839080459770115
5861,3,1421,734,2155,1.935967302452316
5862,1,47,515,562,0.0912621359223301
5862,2,631,623,1254,1.0128410914927768
5862,3,1418,614,2032,2.3094462540716614
5862,4,2085,603,2688,3.45771144278607
5862,5,2716,373,3089,7.281501340482574
5862,6,3107,44,3151,70.61363636363636
5862,7,3154,42,3196,75.0952380952381
5862,8,3205,36,3241,89.02777777777777
5863,1,20,524,544,0.03816793893129771
5863,2,552,599,1151,0.9215358931552587
5864,1,25,345,370,0.07246376811594203
5865,1,99,615,714,0.16097560975609757
5865,2,806,95,901,8.48421052631579
5865,3,1007,870,1877,1.157471264367816
5865,4,1912,732,2644,2.612021857923497
5865,5,2659,762,3421,3.489501312335958
5865,6,3453,718,4171,4.809192200557103
5865,7,4202,635,4837,6.61732283464567
5865,8,4922,747,5669,6.589022757697457
5865,9,5754,747,6501,7.7028112449799195
5866,1,6,192,198,0.03125
5867,1,159,1095,1254,0.14520547945205478
5867,2,1257,516,1773,2.436046511627907
5868,1,10,506,516,0.019762845849802372
5868,2,520,463,983,1.123110151187905
5868,3,988,430,1418,2.297674418604651
5868,4,1450,87,1537,16.666666666666668
5869,1,2,24,26,0.08333333333333333
5869,2,38,54,92,0.7037037037037037
5869,3,182,24,206,7.583333333333333
5869,4,594,518,1112,1.1467181467181466
5869,5,1132,726,1858,1.559228650137741
5869,6,1892,949,2841,1.993677555321391
5869,7,2844,348,3192,8.172413793103448
5869,8,3213,349,3562,9.206303724928366
5869,9,3610,966,4576,3.7370600414078674
5869,10,4580,163,4743,28.098159509202453
5869,11,4767,474,5241,10.056962025316455
5870,1,76,170,246,0.4470588235294118
5870,2,291,393,684,0.7404580152671756
5870,3,725,676,1401,1.0724852071005917
5870,4,1480,208,1688,7.115384615384615
5871,1,50,476,526,0.10504201680672269
5871,2,562,338,900,1.6627218934911243
5871,3,942,309,1251,3.0485436893203883
5871,4,1375,719,2094,1.9123783031988872
5871,5,2154,98,2252,21.979591836734695
5871,6,2349,797,3146,2.9473023839397743
5871,7,3195,766,3961,4.171018276762402
5871,8,4128,830,4958,4.973493975903614
5871,9,5110,922,6032,5.542299349240781
5871,10,6183,955,7138,6.47434554973822
5871,11,7164,365,7529,19.627397260273973
5872,1,26,101,127,0.25742574257425743
5872,2,160,110,270,1.4545454545454546
5872,3,286,28,314,10.214285714285714
5872,4,334,38,372,8.789473684210526
5872,5,624,87,711,7.172413793103448
5872,6,720,127,847,5.669291338582677
5872,7,4805,171,4976,28.099415204678362
5872,8,5275,121,5396,43.59504132231405
5872,9,7763,195,7958,39.81025641025641
5873,1,433,791,1224,0.5474083438685209
5873,2,1251,857,2108,1.4597432905484247
5874,1,129,677,806,0.19054652880354506
5874,2,824,817,1641,1.0085679314565483
5874,3,1649,608,2257,2.7121710526315788
5874,4,2263,575,2838,3.9356521739130437
5874,5,2857,410,3267,6.96829268292683
5875,1,99,69,168,1.434782608695652
5876,1,24,712,736,0.033707865168539325
5876,2,748,172,920,4.348837209302325
5876,3,1142,691,1833,1.6526772793053546
5876,4,2079,472,2551,4.404661016949152
5876,5,2568,1053,3621,2.438746438746439
5876,6,3623,392,4015,9.24234693877551
5877,1,16,591,607,0.02707275803722504
5877,2,625,363,988,1.721763085399449
5877,3,1019,998,2017,1.0210420841683367
5877,4,2019,270,2289,7.477777777777778
5877,5,2334,1049,3383,2.224976167778837
5877,6,3385,206,3591,16.432038834951456
5877,7,3626,914,4540,3.9671772428884027
5877,8,4579,1035,5614,4.42415458937198
5877,9,5616,843,6459,6.661921708185053
5878,1,22,81,103,0.2716049382716049
5879,1,434,230,664,1.8869565217391304
5879,2,730,1080,1810,0.6759259259259259
5879,3,1843,925,2768,1.9924324324324325
5879,4,2783,95,2878,29.294736842105262
5879,5,2886,102,2988,28.294117647058822
5880,1,276,549,825,0.5027322404371585
5880,2,972,363,1335,2.677685950413223
5880,3,1429,210,1639,6.804761904761905
5880,4,2039,254,2293,8.027559055118111
5880,5,2400,347,2747,6.916426512968299
5880,6,2822,369,3191,7.64769647696477
5880,7,3339,468,3807,7.134615384615385
5880,8,3935,409,4344,9.621026894865526
5880,9,4608,428,5036,10.766355140186915
5880,10,5094,327,5421,15.577981651376147
5880,11,5528,481,6009,11.492723492723492
5880,12,6080,475,6555,12.8
5880,13,6624,509,7133,13.013752455795677
5880,14,7215,337,7552,21.409495548961424
5880,15,7564,198,7762,38.2020202020202
5880,16,7790,204,7994,38.18627450980392
5881,1,34,251,285,0.13545816733067728
5881,2,2273,613,2886,3.707993474714519
5882,1,20,150,170,0.13333333333333333
5882,2,182,111,293,1.6396396396396395
5883,1,1154,4,1158,288.5
5883,2,1243,908,2151,1.368942731277533
5883,3,2157,397,2554,5.433249370277078
5884,1,148,544,692,0.27205882352941174
5885,1,334,241,575,1.3858921161825726
5885,2,806,486,1292,1.6584362139917694
5885,3,1578,222,1800,7.108108108108108
5885,4,2040,992,3032,2.056451612903226
5885,5,3229,150,3379,21.526666666666667
5885,6,3523,278,3801,12.672661870503598
5885,7,4060,708,4768,5.734463276836158
5886,1,779,644,1423,1.2096273291925466
5887,1,206,46,252,4.478260869565218
5887,2,953,906,1859,1.0518763796909492
5888,1,58,812,870,0.07142857142857142
5888,2,878,827,1705,1.0616686819830714
5888,3,1713,850,2563,2.0152941176470587
5888,4,2566,526,3092,4.8783269961977185
5888,5,3121,468,3589,6.668803418803419
5888,6,3592,555,4147,6.472072072072072
5888,7,4150,616,4766,6.737012987012987
5888,8,4769,136,4905,35.06617647058823
5889,1,45,456,501,0.09868421052631579
5890,1,249,545,794,0.45688073394495415
5890,2,808,530,1338,1.5245283018867926
5890,3,1822,63,1885,28.92063492063492
5890,4,1895,33,1928,57.42424242424242
5890,5,2192,24,2216,91.33333333333333
5890,6,2226,43,2269,51.76744186046512
5890,7,2881,445,3326,6.474157303370786
5890,8,3406,864,4270,3.9421296296296298
5890,9,4293,338,4631,12.701183431952662
5890,10,4677,371,5048,12.606469002695418
5891,1,36,713,749,0.05049088359046283
5891,2,777,741,1518,1.048582995951417
5892,1,42,915,957,0.04590163934426229
5892,2,960,504,1464,1.9047619047619047
5892,3,1631,869,2500,1.8768699654775605
5892,4,2521,731,3252,3.4487004103967167
5892,5,3292,542,3834,6.07380073800738
5892,6,3880,503,4383,7.713717693836978
5893,1,199,1213,1412,0.1640560593569662
5893,2,1420,782,2202,1.815856777493606
5893,3,2337,1227,3564,1.9046454767726162
5893,4,3572,858,4430,4.163170163170163
5893,5,4534,416,4950,10.899038461538462
5893,6,5005,617,5622,8.111831442463533
5893,7,5801,1028,6829,5.642996108949417
5894,1,1441,224,1665,6.433035714285714
5895,1,172,359,531,0.479108635097493
5895,2,646,566,1212,1.1413427561837455
5895,3,1229,183,1412,6.715846994535519
5895,4,1660,537,2197,3.091247672253259
5895,5,2202,353,2555,6.237960339943343
5895,6,2570,639,3209,4.021909233176839
5896,1,135,568,703,0.23767605633802816
5897,1,110,247,357,0.44534412955465585
5898,1,61,961,1022,0.06347554630593132
5898,2,1044,1026,2070,1.0175438596491229
5898,3,2095,565,2660,3.7079646017699117
5899,1,94,79,173,1.1898734177215189
5900,1,11,633,644,0.017377567140600316
5900,2,673,375,1048,1.7946666666666666
5900,3,1070,559,1629,1.9141323792486584
5900,4,1640,946,2586,1.733615221987315
5901,1,32,417,449,0.07673860911270983
5901,2,464,522,986,0.8888888888888888
5901,3,1010,515,1525,1.9611650485436893
5901,4,1531,944,2475,1.6218220338983051
5901,5,2497,365,2862,6.841095890410959
5901,6,2877,391,3268,7.358056265984655
5902,1,55,352,407,0.15625
5902,2,426,915,1341,0.46557377049180326
5903,1,70,702,772,0.09971509971509972
5904,1,471,79,550,5.962025316455696
5904,2,563,92,655,6.119565217391305
5904,3,670,427,1097,1.5690866510538641
5905,1,3790,2713,6503,1.3969775156653153
5906,1,21,289,310,0.0726643598615917
5907,1,35,398,433,0.08793969849246232
5907,2,480,571,1051,0.840630472854641
5907,3,1087,763,1850,1.4246395806028833
5907,4,1881,941,2822,1.9989373007438895
5908,1,97,27,124,3.5925925925925926
5908,2,131,129,260,1.0155038759689923
5908,3,292,153,445,1.908496732026144
5908,4,451,140,591,3.2214285714285715
5908,5,595,128,723,4.6484375
5908,6,732,135,867,5.4222222222222225
5908,7,877,119,996,7.369747899159663
5908,8,1028,131,1159,7.847328244274809
5908,9,1165,134,1299,8.694029850746269
5908,10,1323,154,1477,8.590909090909092
5908,11,1487,139,1626,10.697841726618705
5908,12,1690,50,1740,33.8
5909,1,206,288,494,0.7152777777777778
5909,2,552,360,912,1.5333333333333334
5909,3,987,365,1352,2.7041095890410958
5909,4,1385,412,1797,3.3616504854368934
5909,5,1855,379,2234,4.894459102902375
5909,6,2285,408,2693,5.6004901960784315
5910,1,970,602,1572,1.611295681063123
5911,1,841,898,1739,0.9365256124721604
5911,2,1751,424,2175,4.129716981132075
5911,3,3722,122,3844,30.508196721311474
5911,4,5411,929,6340,5.824542518837459
5911,5,6348,977,7325,6.497441146366428
5911,6,7333,664,7997,11.043674698795181
5912,1,29,625,654,0.0464
5913,1,67,420,487,0.1595238095238095
5913,2,493,188,681,2.622340425531915
5913,3,697,451,1148,1.5454545454545454
5913,4,1161,436,1597,2.6628440366972477
5913,5,1613,400,2013,4.0325
5913,6,2029,325,2354,6.243076923076923
5913,7,2414,528,2942,4.571969696969697
5913,8,2961,243,3204,12.185185185185185
5913,9,3226,472,3698,6.834745762711864
5914,1,85,580,665,0.14655172413793102
5914,2,692,556,1248,1.2446043165467626
5914,3,1291,399,1690,3.235588972431078
5915,1,556,3455,4011,0.1609261939218524
5916,1,8,548,556,0.014598540145985401
5916,2,562,396,958,1.4191919191919191
5916,3,966,663,1629,1.4570135746606334
5916,4,1636,205,1841,7.980487804878049
5916,5,1853,406,2259,4.564039408866995
5916,6,2265,284,2549,7.975352112676056
5917,1,1140,1025,2165,1.1121951219512196
5917,2,2168,468,2636,4.632478632478633
5917,3,2660,834,3494,3.1894484412470026
5917,4,3528,584,4112,6.041095890410959
5917,5,4136,446,4582,9.27354260089686
5917,6,4646,1011,5657,4.595450049455984
5917,7,5659,203,5862,27.876847290640395
5917,8,5887,975,6862,6.037948717948718
5917,9,6864,203,7067,33.8128078817734
5917,10,7076,557,7633,12.703770197486534
5918,1,18,15,33,1.2
5918,2,41,82,123,0.5
5918,3,129,319,448,0.4043887147335423
5918,4,456,639,1095,0.7136150234741784
5918,5,1106,236,1342,4.686440677966102
5918,6,1352,256,1608,5.28125
5918,7,1622,257,1879,6.311284046692607
5918,8,1896,262,2158,7.236641221374046
5918,9,2168,247,2415,8.777327935222672
5918,10,2426,272,2698,8.919117647058824
5918,11,2710,245,2955,11.061224489795919
5918,12,2963,251,3214,11.804780876494023
5918,13,3226,232,3458,13.905172413793103
5918,14,3473,240,3713,14.470833333333333
5918,15,3737,155,3892,24.10967741935484
5918,16,3902,707,4609,5.519094766619519
5918,17,4617,290,4907,15.920689655172414
5918,18,4918,257,5175,19.136186770428015
5918,19,5188,274,5462,18.934306569343065
5918,20,5472,247,5719,22.153846153846153
5918,21,5729,258,5987,22.205426356589147
5918,22,5996,254,6250,23.606299212598426
5918,23,6264,310,6574,20.206451612903226
5918,24,6584,314,6898,20.96815286624204
5918,25,6909,282,7191,24.5
5918,26,7204,334,7538,21.568862275449103
5919,1,10,367,377,0.027247956403269755
5919,2,386,316,702,1.2215189873417722
5919,3,711,359,1070,1.9805013927576602
5919,4,1133,429,1562,2.641025641025641
5919,5,1640,483,2123,3.3954451345755694
5919,6,2157,421,2578,5.123515439429929
5919,7,2622,569,3191,4.608084358523726
5919,8,3237,666,3903,4.86036036036036
5919,9,3934,1151,5085,3.417897480451781
5919,10,5145,1157,6302,4.446845289541919
5919,11,6346,1159,7505,5.475409836065574
5920,1,22,1116,1138,0.01971326164874552
5921,1,121,92,213,1.315217391304348
5921,2,228,106,334,2.150943396226415
5921,3,370,157,527,2.356687898089172
5921,4,541,154,695,3.512987012987013
5921,5,703,192,895,3.6614583333333335
5921,6,911,141,1052,6.460992907801418
5922,1,65,972,1037,0.0668724279835391
5922,2,1048,1001,2049,1.046953046953047
5922,3,2060,958,3018,2.150313152400835
5922,4,3029,957,3986,3.1650992685475443
5922,5,4001,728,4729,5.4958791208791204
5923,1,104,729,833,0.14266117969821673
5923,2,967,957,1924,1.0104493207941483
5923,3,1929,931,2860,2.071965628356606
5923,4,2957,912,3869,3.2423245614035086
5923,5,3874,625,4499,6.1984
5924,1,150,502,652,0.29880478087649404
5924,2,745,711,1456,1.0478199718706047
5924,3,1508,607,2115,2.484349258649094
5924,4,2151,170,2321,12.652941176470588
5924,5,2354,671,3025,3.5081967213114753
5925,1,294,197,491,1.4923857868020305
5926,1,21,258,279,0.08139534883720931
5926,2,352,327,679,1.0764525993883791
5926,3,699,215,914,3.2511627906976743
5926,4,939,273,1212,3.4395604395604398
5926,5,1227,391,1618,3.1381074168797953
5926,6,1648,607,2255,2.7149917627677103
5927,1,177,877,1054,0.20182440136830102
5927,2,1293,1022,2315,1.2651663405088063
5927,3,2480,910,3390,2.7252747252747254
5927,4,3595,956,4551,3.760460251046025
5927,5,4714,945,5659,4.988359788359788
5927,6,5668,804,6472,7.0497512437810945
5927,7,6657,459,7116,14.50326797385621
5927,8,7194,3,7197,2398.0
5928,1,62,533,595,0.11632270168855535
5928,2,642,449,1091,1.4298440979955456
5928,3,1155,490,1645,2.357142857142857
5929,1,263,218,481,1.2064220183486238
5929,2,498,12,510,41.5
5929,3,934,228,1162,4.0964912280701755
5930,1,79,42,121,1.880952380952381
5930,2,240,256,496,0.9375
5931,1,1687,84,1771,20.083333333333332
5931,2,1802,405,2207,4.449382716049382
5931,3,2228,369,2597,6.0379403794037945
5931,4,4419,554,4973,7.9765342960288805
5931,5,5286,708,5994,7.466101694915254
5931,6,6062,451,6513,13.441241685144124
5931,7,6593,631,7224,10.448494453248811
5932,1,794,480,1274,1.6541666666666666
5932,2,1324,605,1929,2.188429752066116
5932,3,2000,465,2465,4.301075268817204
5932,4,2851,526,3377,5.420152091254753
5932,5,6467,680,7147,9.510294117647058
5933,1,55,62,117,0.8870967741935484
5933,2,136,60,196,2.2666666666666666
5933,3,329,349,678,0.9426934097421203
5933,4,768,913,1681,0.8411829134720701
5933,5,1726,920,2646,1.876086956521739
5933,6,2678,911,3589,2.9396267837541163
5933,7,3625,141,3766,25.70921985815603
5933,8,3780,899,4679,4.204671857619577
5933,9,4689,885,5574,5.2983050847457624
5933,10,5607,657,6264,8.534246575342467
5933,11,6360,539,6899,11.799628942486086
5933,12,7128,867,7995,8.221453287197232
5934,1,18,487,505,0.03696098562628337
5935,1,24,363,387,0.06611570247933884
5935,2,394,354,748,1.112994350282486
5936,1,42,1223,1265,0.03434178250204415
5936,2,1273,1014,2287,1.255424063116371
5937,1,108,660,768,0.16363636363636364
5937,2,788,535,1323,1.4728971962616821
5937,3,1347,561,1908,2.4010695187165774
5937,4,1952,835,2787,2.3377245508982036
5937,5,2884,643,3527,4.485225505443235
5937,6,3718,587,4305,6.333901192504259
5937,7,4349,507,4856,8.577909270216962
5937,8,4893,462,5355,10.590909090909092
5937,9,5452,525,5977,10.384761904761906
5937,10,6010,497,6507,12.092555331991951
5937,11,6551,504,7055,12.998015873015873
5937,12,7094,438,7532,16.19634703196347
5938,1,214,10,224,21.4
5938,2,276,254,530,1.0866141732283465
5938,3,582,159,741,3.660377358490566
5938,4,794,251,1045,3.1633466135458166
5938,5,1059,373,1432,2.839142091152815
5938,6,1486,442,1928,3.3619909502262444
5938,7,1959,290,2249,6.755172413793104
5938,8,2260,326,2586,6.932515337423313
5938,9,2616,410,3026,6.380487804878049
5938,10,3060,153,3213,20.0
5938,11,3240,451,3691,7.184035476718403
5938,12,3739,80,3819,46.7375
5938,13,3857,25,3882,154.28
5938,14,3914,57,3971,68.66666666666667
5938,15,4052,112,4164,36.17857142857143
5938,16,4210,147,4357,28.639455782312925
5938,17,4367,72,4439,60.65277777777778
5938,18,4493,159,4652,28.257861635220127
5938,19,4740,130,4870,36.46153846153846
5938,20,4878,76,4954,64.1842105263158
5938,21,4993,201,5194,24.8407960199005
5938,22,5263,418,5681,12.590909090909092
5938,23,5721,268,5989,21.347014925373134
5938,24,6019,357,6376,16.859943977591037
5939,1,115,1148,1263,0.10017421602787456
5939,2,1348,1078,2426,1.2504638218923934
5939,3,2437,1137,3574,2.143359718557608
5939,4,4043,1056,5099,3.828598484848485
5939,5,5101,426,5527,11.974178403755868
5939,6,5584,1103,6687,5.062556663644606
5939,7,6740,1011,7751,6.666666666666667
5940,1,477,844,1321,0.5651658767772512
5941,1,1242,908,2150,1.36784140969163
5942,1,105,568,673,0.18485915492957747
5942,2,701,936,1637,0.7489316239316239
5942,3,1655,853,2508,1.94021101992966
5942,4,2514,800,3314,3.1425
5942,5,3332,175,3507,19.04
5942,6,3546,700,4246,5.065714285714286
5943,1,32,439,471,0.07289293849658314
5943,2,568,906,1474,0.6269315673289183
5943,3,1518,879,2397,1.726962457337884
5943,4,2513,912,3425,2.755482456140351
5943,5,3448,652,4100,5.288343558282208
5943,6,4182,853,5035,4.902696365767878
5943,7,5095,748,5843,6.811497326203209
5943,8,5879,817,6696,7.195838433292534
5943,9,6755,572,7327,11.80944055944056
5943,10,7338,493,7831,14.884381338742394
5943,11,7858,212,8070,37.06603773584906
5944,1,48,382,430,0.1256544502617801
5945,1,243,507,750,0.47928994082840237
5945,2,782,478,1260,1.6359832635983265
5945,3,1343,609,1952,2.2052545155993433
5945,4,1991,612,2603,3.253267973856209
5945,5,2624,505,3129,5.196039603960396
5945,6,3139,409,3548,7.67481662591687
5945,7,4011,479,4490,8.373695198329854
5945,8,4507,169,4676,26.668639053254438
5945,9,4738,424,5162,11.174528301886792
5945,10,5228,572,5800,9.13986013986014
5945,11,5819,467,6286,12.460385438972162
5945,12,6295,279,6574,22.56272401433692
5945,13,6617,951,7568,6.957939011566772
5946,1,20,608,628,0.03289473684210526
5946,2,639,1025,1664,0.6234146341463415
5946,3,1693,955,2648,1.7727748691099476
5946,4,2656,963,3619,2.758047767393562
5946,5,3627,981,4608,3.697247706422018
5946,6,4616,147,4763,31.401360544217688
5946,7,4836,955,5791,5.063874345549738
5946,8,5799,997,6796,5.816449348044133
5946,9,6804,265,7069,25.675471698113206
5947,1,19,332,351,0.0572289156626506
5947,2,409,1017,1426,0.40216322517207476
5947,3,1528,728,2256,2.098901098901099
5947,4,2389,624,3013,3.828525641025641
5947,5,3053,625,3678,4.8848
5947,6,3719,769,4488,4.836150845253576
5947,7,4564,710,5274,6.428169014084507
5948,1,1187,189,1376,6.28042328042328
5949,1,350,492,842,0.7113821138211383
5949,2,1259,420,1679,2.9976190476190476
5949,3,1929,199,2128,9.693467336683417
5949,4,2425,151,2576,16.05960264900662
5949,5,2855,287,3142,9.94773519163763
5949,6,3652,100,3752,36.52
5949,7,3796,86,3882,44.13953488372093
5950,1,62,13,75,4.769230769230769
5950,2,157,243,400,0.6460905349794238
5950,3,445,360,805,1.2361111111111112
5950,4,834,231,1065,3.6103896103896105
5950,5,1086,200,1286,5.43
5951,1,564,615,1179,0.9170731707317074
5951,2,1393,2414,3807,0.5770505385252692
5952,1,23,166,189,0.13855421686746988
5952,2,191,311,502,0.6141479099678456
5953,1,88,214,302,0.411214953271028
5954,1,19,688,707,0.027616279069767442
5954,2,721,1041,1762,0.6926032660902978
5955,1,1256,433,1689,2.9006928406466512
5955,2,1715,528,2243,3.2481060606060606
5955,3,2255,326,2581,6.91717791411043
5955,4,2588,386,2974,6.704663212435233
5955,5,3020,658,3678,4.589665653495441
5955,6,3706,488,4194,7.594262295081967
5955,7,4216,144,4360,29.27777777777778
5955,8,4665,318,4983,14.669811320754716
5955,9,5001,848,5849,5.897405660377358
5955,10,5856,331,6187,17.691842900302113
5955,11,6978,519,7497,13.445086705202312
5956,1,216,633,849,0.3412322274881517
5956,2,880,201,1081,4.378109452736318
5956,3,1167,527,1694,2.2144212523719164
5956,4,1733,537,2270,3.2271880819366854
5956,5,2306,632,2938,3.6487341772151898
5956,6,2984,366,3350,8.153005464480874
5956,7,3393,140,3533,24.235714285714284
5956,8,3583,254,3837,14.106299212598426
5956,9,3897,67,3964,58.16417910447761
5956,10,4017,352,4369,11.411931818181818
5957,1,66,535,601,0.1233644859813084
5957,2,610,437,1047,1.3958810068649885
5957,3,1058,512,1570,2.06640625
5957,4,1580,379,1959,4.1688654353562
5957,5,1970,443,2413,4.446952595936795
5957,6,2425,516,2941,4.699612403100775
5957,7,2949,509,3458,5.793713163064833
5957,8,3465,528,3993,6.5625
5957,9,4003,501,4504,7.990019960079841
5957,10,4509,597,5106,7.552763819095477
5957,11,5111,484,5595,10.559917355371901
5957,12,5601,456,6057,12.282894736842104
5957,13,6062,111,6173,54.612612612612615
5957,14,6190,594,6784,10.42087542087542
5957,15,6790,97,6887,70.0
5957,16,6903,124,7027,55.66935483870968
5957,17,7102,657,7759,10.809741248097412
5958,1,22,590,612,0.03728813559322034
5958,2,646,417,1063,1.5491606714628297
5958,3,1072,548,1620,1.9562043795620438
5958,4,1632,602,2234,2.7109634551495017
5959,1,709,779,1488,0.9101412066752247
5960,1,20,802,822,0.02493765586034913
5960,2,833,954,1787,0.8731656184486373
5960,3,1790,221,2011,8.099547511312217
5961,1,448,35,483,12.8
5961,2,973,423,1396,2.300236406619385
5962,1,44,702,746,0.06267806267806268
5963,1,633,581,1214,1.089500860585198
5963,2,1240,494,1734,2.5101214574898787
5963,3,1767,603,2370,2.9303482587064678
5963,4,2416,677,3093,3.568685376661743
5963,5,3133,584,3717,5.364726027397261
5963,6,3831,523,4354,7.325047801147227
5963,7,4365,515,4880,8.475728155339805
5963,8,4894,560,5454,8.739285714285714
5963,9,5481,365,5846,15.016438356164384
5963,10,5875,949,6824,6.19072708113804
5963,11,6912,544,7456,12.705882352941176
5963,12,7546,110,7656,68.6
5963,13,7676,163,7839,47.0920245398773
5964,1,154,510,664,0.30196078431372547
5964,2,665,80,745,8.3125
5964,3,746,140,886,5.328571428571428
5964,4,887,356,1243,2.491573033707865
5965,1,72,394,466,0.18274111675126903
5965,2,498,429,927,1.1608391608391608
5965,3,972,317,1289,3.0662460567823344
5965,4,1348,262,1610,5.145038167938932
5966,1,9,453,462,0.019867549668874173
5966,2,485,509,994,0.9528487229862476
5966,3,1007,417,1424,2.4148681055155876
5966,4,1437,471,1908,3.050955414012739
5966,5,1921,505,2426,3.803960396039604
5966,6,2441,379,2820,6.440633245382585
5966,7,2833,356,3189,7.957865168539326
5966,8,3202,525,3727,6.099047619047619
5966,9,3761,635,4396,5.922834645669291
5966,10,4427,17,4444,260.4117647058824
5966,11,4458,371,4829,12.016172506738544
5966,12,4866,587,5453,8.289608177172061
5966,13,5483,766,6249,7.157963446475196
5966,14,6306,700,7006,9.008571428571429
5967,1,108,267,375,0.4044943820224719
5967,2,397,679,1076,0.5846833578792342
5967,3,1098,690,1788,1.5913043478260869
5967,4,1832,229,2061,8.0
5967,5,2139,1009,3148,2.1199207135778
5967,6,3189,646,3835,4.936532507739938
5967,7,3849,640,4489,6.0140625
5968,1,16,415,431,0.03855421686746988
5968,2,448,433,881,1.0346420323325636
5969,1,111,420,531,0.2642857142857143
5969,2,540,550,1090,0.9818181818181818
5969,3,1098,393,1491,2.7938931297709924
5969,4,1528,471,1999,3.2441613588110405
5969,5,2014,566,2580,3.558303886925795
5969,6,2615,458,3073,5.709606986899563
5969,7,3085,308,3393,10.016233766233766
5969,8,3410,345,3755,9.884057971014492
5969,9,3769,26,3795,144.96153846153845
5969,10,3803,27,3830,140.85185185185185
5969,11,3834,23,3857,166.69565217391303
5969,12,3862,22,3884,175.54545454545453
5970,1,53,583,636,0.09090909090909091
5970,2,2193,150,2343,14.62
5970,3,3507,386,3893,9.085492227979275
5970,4,3926,228,4154,17.219298245614034
5970,5,4201,549,4750,7.652094717668488
5971,1,30,51,81,0.5882352941176471
5971,2,523,53,576,9.867924528301886
5971,3,600,203,803,2.955665024630542
5972,1,106,765,871,0.13856209150326798
5972,2,894,569,1463,1.571177504393673
5972,3,1481,408,1889,3.6299019607843137
5972,4,1939,245,2184,7.914285714285715
5972,5,2220,628,2848,3.535031847133758
5972,6,2872,165,3037,17.406060606060606
5972,7,3114,712,3826,4.373595505617978
5972,8,3842,194,4036,19.804123711340207
5972,9,4071,423,4494,9.624113475177305
5972,10,4528,726,5254,6.236914600550964
5973,1,38,2,40,19.0
5973,2,165,500,665,0.33
5973,3,674,618,1292,1.0906148867313916
5973,4,1309,316,1625,4.1424050632911396
5973,5,1639,616,2255,2.6607142857142856
5973,6,2268,553,2821,4.10126582278481
5973,7,2833,617,3450,4.591572123176661
5973,8,3462,405,3867,8.548148148148147
5973,9,3877,680,4557,5.701470588235294
5973,10,4578,508,5086,9.011811023622048
5973,11,5106,915,6021,5.580327868852459
5974,1,83,819,902,0.10134310134310134
5974,2,914,819,1733,1.115995115995116
5975,1,80,465,545,0.17204301075268819
5975,2,625,486,1111,1.286008230452675
5975,3,1164,471,1635,2.4713375796178343
5975,4,1673,432,2105,3.872685185185185
5976,1,31,464,495,0.0668103448275862
5976,2,508,502,1010,1.0119521912350598
5976,3,1022,346,1368,2.953757225433526
5977,1,49,546,595,0.08974358974358974
5978,1,53,315,368,0.16825396825396827
5978,2,370,337,707,1.0979228486646884
5979,1,78,392,470,0.1989795918367347
5979,2,494,422,916,1.1706161137440758
5980,1,95,937,1032,0.10138740661686232
5980,2,1034,41,1075,25.21951219512195
5980,3,1092,619,1711,1.764135702746365
5980,4,1728,634,2362,2.725552050473186
5980,5,2378,568,2946,4.186619718309859
5980,6,2982,633,3615,4.710900473933649
5980,7,3640,666,4306,5.465465465465465
5980,8,4398,787,5185,5.588310038119441
5981,1,21,631,652,0.03328050713153724
5981,2,687,588,1275,1.1683673469387754
5981,3,1355,569,1924,2.381370826010545
5981,4,1951,710,2661,2.747887323943662
5982,1,65,739,804,0.08795669824086604
5983,1,15,286,301,0.05244755244755245
5984,1,2577,333,2910,7.738738738738738
5984,2,2990,303,3293,9.867986798679867
5984,3,3455,333,3788,10.375375375375375
5984,4,3790,311,4101,12.186495176848874
5984,5,4115,385,4500,10.688311688311689
5984,6,4514,352,4866,12.823863636363637
5985,1,11,46,57,0.2391304347826087
5985,2,82,641,723,0.12792511700468018
5985,3,737,154,891,4.785714285714286
5985,4,907,733,1640,1.2373806275579808
5985,5,1648,34,1682,48.470588235294116
5985,6,1787,432,2219,4.136574074074074
5985,7,2232,696,2928,3.206896551724138
5985,8,2942,543,3485,5.41804788213628
5985,9,3504,462,3966,7.584415584415584
5985,10,3973,978,4951,4.062372188139059
5985,11,4977,485,5462,10.261855670103094
5985,12,5479,372,5851,14.728494623655914
5985,13,5871,713,6584,8.23422159887798
5985,14,6594,612,7206,10.77450980392157
5985,15,7215,319,7534,22.61755485893417
5985,16,7553,451,8004,16.747228381374722
5986,1,27,390,417,0.06923076923076923
5986,2,433,284,717,1.5246478873239437
5986,3,749,264,1013,2.837121212121212
5986,4,1033,323,1356,3.198142414860681
5986,5,1370,240,1610,5.708333333333333
5986,6,1619,54,1673,29.98148148148148
5986,7,1699,202,1901,8.410891089108912
5986,8,1932,348,2280,5.551724137931035
5986,9,2304,634,2938,3.634069400630915
5986,10,2958,596,3554,4.9630872483221475
5986,11,3571,288,3859,12.399305555555555
5987,1,11,57,68,0.19298245614035087
5987,2,87,121,208,0.71900826446281
5987,3,223,273,496,0.8168498168498168
5987,4,508,369,877,1.3766937669376693
5987,5,888,416,1304,2.1346153846153846
5987,6,1336,305,1641,4.380327868852459
5987,7,1652,199,1851,8.301507537688442
5987,8,1871,80,1951,23.3875
5987,9,1973,374,2347,5.275401069518717
5987,10,2361,181,2542,13.044198895027625
5987,11,2558,208,2766,12.298076923076923
5987,12,2772,365,3137,7.594520547945206
5987,13,3266,209,3475,15.626794258373206
5987,14,3625,268,3893,13.526119402985074
5987,15,3937,437,4374,9.009153318077804
5987,16,4494,170,4664,26.435294117647057
5987,17,4683,479,5162,9.77661795407098
5987,18,5180,517,5697,10.019342359767892
5987,19,5732,51,5783,112.3921568627451
5987,20,6145,617,6762,9.959481361426256
5987,21,6770,577,7347,11.733102253032929
5987,22,7414,14,7428,529.5714285714286
5987,23,7489,125,7614,59.912
5988,1,1767,755,2522,2.3403973509933773
5988,2,2643,1083,3726,2.440443213296399
5988,3,3729,1196,4925,3.117892976588629
5989,1,83,819,902,0.10134310134310134
5989,2,914,819,1733,1.115995115995116
5989,3,1774,807,2581,2.198265179677819
5989,4,2641,359,3000,7.3565459610027855
5989,5,3012,297,3309,10.141414141414142
5989,6,3348,471,3819,7.10828025477707
5989,7,3832,332,4164,11.542168674698795
5989,8,4208,433,4641,9.71824480369515
5989,9,4669,355,5024,13.152112676056339
5989,10,5035,308,5343,16.3474025974026
5990,1,51,336,387,0.15178571428571427
5990,2,1464,481,1945,3.043659043659044
5990,3,2948,314,3262,9.388535031847134
5990,4,3671,329,4000,11.158054711246201
5990,5,4039,295,4334,13.691525423728814
5990,6,4497,330,4827,13.627272727272727
5990,7,4895,284,5179,17.235915492957748
5990,8,5224,439,5663,11.899772209567198
5990,9,5891,409,6300,14.403422982885086
5990,10,6343,306,6649,20.72875816993464
5990,11,6677,217,6894,30.76958525345622
5990,12,6993,317,7310,22.05993690851735
5990,13,7361,357,7718,20.61904761904762
5991,1,25,788,813,0.031725888324873094
5992,1,253,177,430,1.4293785310734464
5992,2,480,215,695,2.2325581395348837
5993,1,350,408,758,0.8578431372549019
5993,2,845,310,1155,2.725806451612903
5993,3,1222,429,1651,2.8484848484848486
5993,4,1676,476,2152,3.5210084033613445
5993,5,2160,413,2573,5.230024213075061
5993,6,2597,112,2709,23.1875
5993,7,2755,419,3174,6.575178997613365
5993,8,3205,454,3659,7.059471365638767
5993,9,3667,424,4091,8.648584905660377
5994,1,2152,1949,4101,1.1041559774243201
5995,1,95,937,1032,0.10138740661686232
5996,1,148,1058,1206,0.13988657844990549
5996,2,1255,528,1783,2.3768939393939394
5996,3,1844,567,2411,3.252204585537919
5996,4,2445,385,2830,6.35064935064935
5996,5,2875,410,3285,7.012195121951219
5996,6,3530,299,3829,11.806020066889632
5996,7,3870,1054,4924,3.6717267552182165
5996,8,4944,1030,5974,4.8
5996,9,6025,1051,7076,5.732635585156993
5997,1,142,450,592,0.31555555555555553
5997,2,677,555,1232,1.2198198198198198
5997,3,1286,341,1627,3.771260997067449
5997,4,1649,349,1998,4.724928366762177
5997,5,2600,751,3351,3.4620505992010653
5998,1,1547,1070,2617,1.4457943925233645
5998,2,2619,430,3049,6.090697674418605
5998,3,3068,682,3750,4.4985337243401755
5998,4,3759,11,3770,341.72727272727275
5998,5,3811,681,4492,5.596182085168869
5998,6,4509,672,5181,6.709821428571429
5998,7,5194,677,5871,7.672082717872969
5998,8,5898,752,6650,7.843085106382978
5998,9,6659,628,7287,10.603503184713375
5998,10,7289,20,7309,364.45
5998,11,7473,7,7480,1067.5714285714287
5999,1,15,723,738,0.02074688796680498
5999,2,753,468,1221,1.608974358974359
5999,3,1230,604,1834,2.0364238410596025
6000,1,71,959,1030,0.0740354535974974
6000,2,1041,630,1671,1.6523809523809523
6000,3,1712,709,2421,2.414668547249647
6000,4,2485,751,3236,3.3089214380825567
6001,1,11,526,537,0.02091254752851711
6001,2,569,805,1374,0.7068322981366459
6002,1,13,374,387,0.034759358288770054
6002,2,418,229,647,1.8253275109170306
6003,1,9,463,472,0.019438444924406047
6003,2,486,986,1472,0.49290060851926976
6003,3,1546,400,1946,3.865
6003,4,1978,329,2307,6.0121580547112465
6003,5,2328,125,2453,18.624
6003,6,2466,292,2758,8.445205479452055
6003,7,2774,206,2980,13.466019417475728
6003,8,2991,392,3383,7.630102040816326
6003,9,3395,284,3679,11.954225352112676
6004,1,29,432,461,0.06712962962962964
6004,2,488,865,1353,0.5641618497109827
6004,3,1395,1000,2395,1.395
6004,4,2413,753,3166,3.2045152722443557
6004,5,3182,995,4177,3.197989949748744
6004,6,4193,993,5186,4.222557905337362
6005,1,19,632,651,0.030063291139240507
6005,2,678,629,1307,1.0779014308426074
6006,1,752,4,756,188.0
6006,2,845,876,1721,0.9646118721461188
6006,3,1727,763,2490,2.2634338138925294
6006,4,2604,866,3470,3.0069284064665127
6006,5,3476,412,3888,8.436893203883495
6007,1,9,831,840,0.010830324909747292
6007,2,853,465,1318,1.8344086021505377
6007,3,1328,888,2216,1.4954954954954955
6007,4,2229,832,3061,2.6790865384615383
6007,5,3104,983,4087,3.157680569684639
6007,6,4098,802,4900,5.109725685785536
6007,7,4914,978,5892,5.024539877300613
6007,8,5910,668,6578,8.847305389221557
6007,9,6591,684,7275,9.635964912280702
6008,1,419,529,948,0.7920604914933838
6009,1,25,399,424,0.06265664160401002
6010,1,114,476,590,0.23949579831932774
6010,2,711,1155,1866,0.6155844155844156
6010,3,1868,695,2563,2.6877697841726618
6010,4,2628,1075,3703,2.4446511627906977
6010,5,3776,749,4525,5.041388518024032
6010,6,4568,906,5474,5.041942604856512
6011,1,81,52,133,1.5576923076923077
6011,2,469,176,645,2.664772727272727
6011,3,1124,164,1288,6.853658536585366
6011,4,1950,426,2376,4.577464788732394
6011,5,2416,579,2995,4.172711571675302
6011,6,3060,682,3742,4.486803519061583
6011,7,3745,58,3803,64.56896551724138
6011,8,3821,302,4123,12.652317880794701
6011,9,4148,304,4452,13.644736842105264
6011,10,4471,441,4912,10.138321995464853
6011,11,4935,422,5357,11.69431279620853
6011,12,5415,536,5951,10.102611940298507
6011,13,5972,260,6232,22.96923076923077
6011,14,6335,326,6661,19.432515337423315
6011,15,6690,336,7026,19.910714285714285
6011,16,7035,341,7376,20.63049853372434
6011,17,7391,356,7747,20.76123595505618
6012,1,680,829,1509,0.8202653799758746
6012,2,1589,838,2427,1.89618138424821
6012,3,2462,928,3390,2.6530172413793105
6013,1,1086,648,1734,1.6759259259259258
6014,1,22,401,423,0.05486284289276808
6014,2,432,274,706,1.5766423357664234
6015,1,35,607,642,0.057660626029654036
6015,2,774,303,1077,2.5544554455445545
6015,3,1112,880,1992,1.2636363636363637
6015,4,1994,167,2161,11.940119760479043
6016,1,1544,7,1551,220.57142857142858
6016,2,1554,9,1563,172.66666666666666
6016,3,1577,10,1587,157.7
6016,4,1592,15,1607,106.13333333333334
6016,5,1622,412,2034,3.936893203883495
6016,6,2039,221,2260,9.226244343891402
6016,7,2266,320,2586,7.08125
6016,8,2590,225,2815,11.511111111111111
6017,1,410,470,880,0.8723404255319149
6017,2,885,259,1144,3.416988416988417
6018,1,24,757,781,0.031704095112285335
6018,2,812,631,1443,1.2868462757527734
6018,3,1466,655,2121,2.238167938931298
6018,4,2140,654,2794,3.27217125382263
6018,5,2840,778,3618,3.6503856041131106
6018,6,3643,587,4230,6.206132879045996
6018,7,4246,416,4662,10.20673076923077
6018,8,4682,580,5262,8.072413793103449
6018,9,5280,552,5832,9.565217391304348
6018,10,5909,523,6432,11.298279158699808
6018,11,6478,429,6907,15.1002331002331
6018,12,6948,652,7600,10.656441717791411
6019,1,1089,41,1130,26.5609756097561
6019,2,1144,334,1478,3.4251497005988023
6019,3,1494,335,1829,4.459701492537313
6020,1,3742,1019,4761,3.6722276741903825
6020,2,4763,1065,5828,4.472300469483568
6020,3,5830,699,6529,8.340486409155938
6021,1,24,347,371,0.069164265129683
6021,2,384,608,992,0.631578947368421
6021,3,1036,552,1588,1.8768115942028984
6021,4,1626,579,2205,2.8082901554404147
6022,1,56,417,473,0.1342925659472422
6022,2,485,398,883,1.2185929648241205
6022,3,899,703,1602,1.2788051209103841
6022,4,1621,783,2404,2.070242656449553
6022,5,2420,420,2840,5.761904761904762
6022,6,2857,585,3442,4.883760683760684
6022,7,3460,495,3955,6.98989898989899
6022,8,3980,487,4467,8.172484599589323
6022,9,4490,609,5099,7.372742200328407
6022,10,5119,733,5852,6.98362892223738
6022,11,5864,843,6707,6.956109134045077
6022,12,6709,872,7581,7.693807339449541
6022,13,7597,388,7985,19.579896907216494
6023,1,161,185,346,0.8702702702702703
6024,1,212,25,237,8.48
6024,2,247,441,688,0.5600907029478458
6024,3,690,685,1375,1.0072992700729928
6024,4,1394,788,2182,1.7690355329949239
6024,5,2184,754,2938,2.896551724137931
6024,6,2940,774,3714,3.798449612403101
6024,7,3716,666,4382,5.57957957957958
6024,8,4384,701,5085,6.253922967189729
6025,1,133,727,860,0.1829436038514443
6025,2,896,844,1740,1.061611374407583
6025,3,1773,918,2691,1.9313725490196079
6025,4,2740,812,3552,3.374384236453202
6025,5,3646,822,4468,4.435523114355231
6025,6,4477,155,4632,28.883870967741935
6025,7,4656,904,5560,5.150442477876106
6025,8,5624,806,6430,6.977667493796526
6025,9,6460,835,7295,7.736526946107785
6026,1,92,2,94,46.0
6026,2,104,274,378,0.3795620437956204
6027,1,497,573,1070,0.8673647469458988
6027,2,1610,629,2239,2.559618441971383
6027,3,2269,981,3250,2.3129459734964324
6027,4,3298,736,4034,4.480978260869565
6027,5,4094,973,5067,4.207605344295992
6027,6,5103,448,5551,11.390625
6027,7,5561,1001,6562,5.555444555444556
6027,8,7018,811,7829,8.653514180024661
6028,1,206,205,411,1.0048780487804878
6028,2,419,357,776,1.173669467787115
6028,3,791,514,1305,1.538910505836576
6028,4,2073,327,2400,6.339449541284404
6028,5,2422,313,2735,7.738019169329074
6028,6,2752,554,3306,4.9675090252707585
6028,7,3336,574,3910,5.811846689895471
6028,8,3949,873,4822,4.52348224513173
6028,9,4839,672,5511,7.200892857142857
6028,10,5867,432,6299,13.581018518518519
6028,11,6309,425,6734,14.84470588235294
6028,12,6745,458,7203,14.72707423580786
6028,13,7248,846,8094,8.567375886524824
6029,1,175,244,419,0.7172131147540983
6030,1,86,217,303,0.39631336405529954
6030,2,344,265,609,1.2981132075471697
6030,3,621,159,780,3.9056603773584904
6030,4,811,1049,1860,0.773117254528122
6030,5,1961,1199,3160,1.6355296080066721
6030,6,3168,693,3861,4.571428571428571
6030,7,3885,808,4693,4.808168316831683
6030,8,4946,571,5517,8.66199649737303
6030,9,5539,844,6383,6.562796208530806
6030,10,6499,480,6979,13.539583333333333
6030,11,6989,797,7786,8.769134253450439
6030,12,7800,45,7845,173.33333333333334
6031,1,12,87,99,0.13793103448275862
6031,2,169,174,343,0.9712643678160919
6031,3,393,150,543,2.62
6031,4,631,189,820,3.3386243386243386
6031,5,877,235,1112,3.7319148936170214
6032,1,13,458,471,0.028384279475982533
6032,2,490,213,703,2.300469483568075
6032,3,712,532,1244,1.3383458646616542
6032,4,1252,495,1747,2.529292929292929
6032,5,1758,388,2146,4.530927835051546
6032,6,2185,556,2741,3.929856115107914
6032,7,2748,599,3347,4.587646076794658
6032,8,3364,508,3872,6.622047244094488
6032,9,3882,644,4526,6.027950310559007
6033,1,13,524,537,0.02480916030534351
6033,2,546,608,1154,0.8980263157894737
6033,3,1163,682,1845,1.7052785923753666
6033,4,1861,625,2486,2.9776
6033,5,2509,575,3084,4.363478260869565
6033,6,3108,592,3700,5.25
6033,7,3723,627,4350,5.937799043062201
6033,8,4393,618,5011,7.108414239482201
6033,9,5040,705,5745,7.148936170212766
6033,10,5763,570,6333,10.110526315789473
6033,11,6352,671,7023,9.466467958271236
6033,12,7044,629,7673,11.19872813990461
6034,1,628,929,1557,0.6759956942949408
6034,2,1651,802,2453,2.0586034912718203
6034,3,2475,610,3085,4.057377049180328
6034,4,3178,612,3790,5.19281045751634
6034,5,3892,867,4759,4.489042675893887
6034,6,4767,836,5603,5.702153110047847
6034,7,5609,891,6500,6.295173961840629
6035,1,29,530,559,0.05471698113207547
6035,2,603,401,1004,1.5037406483790523
6035,3,1036,1022,2058,1.0136986301369864
6035,4,2082,446,2528,4.668161434977579
6036,1,593,911,1504,0.6509330406147091
6037,1,28,618,646,0.045307443365695796
6037,2,665,454,1119,1.4647577092511013
6037,3,1128,565,1693,1.9964601769911505
6038,1,2111,259,2370,8.150579150579151
6038,2,3924,585,4509,6.707692307692308
6038,3,4577,537,5114,8.523277467411546
6038,4,5144,460,5604,11.182608695652174
6038,5,6991,100,7091,69.91
6038,6,7181,652,7833,11.013803680981596
6039,1,997,253,1250,3.940711462450593
6039,2,1300,335,1635,3.8805970149253732
6039,3,1703,387,2090,4.4005167958656335
6039,4,2135,280,2415,7.625
6039,5,2451,588,3039,4.168367346938775
6039,6,3584,315,3899,11.377777777777778
6039,7,3937,135,4072,29.16296296296296
6039,8,4111,671,4782,6.126676602086438
6039,9,4828,316,5144,15.278481012658228
6039,10,5193,415,5608,12.513253012048192
6039,11,6518,112,6630,58.19642857142857
6039,12,6679,494,7173,13.520242914979757
6039,13,7215,174,7389,41.46551724137931
6039,14,7434,161,7595,46.17391304347826
6040,1,22,879,901,0.02502844141069397
6041,1,1763,456,2219,3.866228070175439
6041,2,3657,417,4074,8.76978417266187
6041,3,4104,32,4136,128.25
6041,4,4158,407,4565,10.216216216216216
6042,1,20,326,346,0.06134969325153374
6042,2,348,314,662,1.10828025477707
6043,1,90,229,319,0.3930131004366812
6043,2,344,218,562,1.5779816513761469
6043,3,587,86,673,6.825581395348837
6043,4,685,102,787,6.715686274509804
6043,5,801,117,918,6.846153846153846
6043,6,966,182,1148,5.3076923076923075
6043,7,1160,51,1211,22.745098039215687
6043,8,1223,78,1301,15.679487179487179
6043,9,1331,225,1556,5.915555555555556
6043,10,1571,310,1881,5.067741935483871
6043,11,1894,188,2082,10.074468085106384
6044,1,158,552,710,0.286231884057971
6045,1,43,404,447,0.10643564356435643
6045,2,470,598,1068,0.7859531772575251
6045,3,1086,568,1654,1.9119718309859155
6045,4,1670,662,2332,2.5226586102719035
6046,1,56,417,473,0.1342925659472422
6046,2,499,415,914,1.202409638554217
6046,3,917,423,1340,2.1678486997635935
6046,4,1343,545,1888,2.4642201834862387
6047,1,130,1009,1139,0.1288404360753221
6048,1,42,811,853,0.051787916152897656
6049,1,349,461,810,0.7570498915401301
6049,2,857,905,1762,0.9469613259668508
6049,3,1765,243,2008,7.2633744855967075
6049,4,2064,536,2600,3.8507462686567164
6049,5,2622,54,2676,48.55555555555556
6049,6,2758,87,2845,31.701149425287355
6049,7,2865,52,2917,55.09615384615385
6049,8,2966,71,3037,41.774647887323944
6049,9,3083,74,3157,41.66216216216216
6049,10,3204,80,3284,40.05
6049,11,3301,85,3386,38.83529411764706
6049,12,3401,117,3518,29.068376068376068
6049,13,3524,82,3606,42.97560975609756
6049,14,3636,90,3726,40.4
6049,15,3737,474,4211,7.883966244725738
6049,16,4267,125,4392,34.136
6049,17,4435,149,4584,29.76510067114094
6049,18,4638,170,4808,27.28235294117647
6049,19,4843,103,4946,47.019417475728154
6049,20,5125,417,5542,12.290167865707435
6049,21,5569,239,5808,23.301255230125523
6049,22,5830,142,5972,41.056338028169016
6049,23,6016,173,6189,34.774566473988436
6049,24,6201,119,6320,52.109243697478995
6049,25,6365,121,6486,52.603305785123965
6049,26,6498,401,6899,16.204488778054863
6049,27,6932,208,7140,33.32692307692308
6049,28,7196,110,7306,65.41818181818182
6049,29,7340,354,7694,20.73446327683616
6049,30,7764,123,7887,63.1219512195122
6050,1,53,506,559,0.10474308300395258
6050,2,581,517,1098,1.1237911025145069
6050,3,1111,337,1448,3.2967359050445104
6050,4,1487,339,1826,4.386430678466077
6051,1,287,3,290,95.66666666666667
6051,2,706,3,709,235.33333333333334
6051,3,877,3,880,292.3333333333333
6051,4,1145,3,1148,381.6666666666667
6051,5,1214,97,1311,12.515463917525773
6051,6,1317,85,1402,15.494117647058824
6051,7,1449,58,1507,24.982758620689655
6051,8,1522,113,1635,13.469026548672566
6051,9,1672,322,1994,5.192546583850931
6051,10,2057,122,2179,16.860655737704917
6051,11,2195,125,2320,17.56
6051,12,2330,110,2440,21.181818181818183
6051,13,2459,99,2558,24.838383838383837
6051,14,2567,114,2681,22.517543859649123
6051,15,2726,234,2960,11.649572649572649
6052,1,19,618,637,0.030744336569579287
6053,1,136,1250,1386,0.1088
6053,2,2626,1113,3739,2.3593890386343217
6053,3,3778,1023,4801,3.6930596285434993
6053,4,6077,895,6972,6.789944134078213
6054,1,55,625,680,0.088
6055,1,115,952,1067,0.1207983193277311
6055,2,1891,849,2740,2.227326266195524
6055,3,2796,947,3743,2.9524815205913413
6055,4,3755,102,3857,36.81372549019608
6055,5,3952,694,4646,5.694524495677234
6055,6,4700,725,5425,6.482758620689655
6055,7,5446,784,6230,6.946428571428571
6055,8,6365,103,6468,61.79611650485437
6055,9,6617,949,7566,6.972602739726027
6056,1,85,597,682,0.1423785594639866
6056,2,700,632,1332,1.1075949367088607
6056,3,1361,1014,2375,1.3422090729783038
6056,4,2382,416,2798,5.725961538461538
6056,5,2832,936,3768,3.0256410256410255
6056,6,3775,957,4732,3.9446185997910135
6056,7,4739,595,5334,7.964705882352941
6056,8,5344,973,6317,5.49229188078109
6056,9,6324,905,7229,6.987845303867403
6057,1,208,586,794,0.35494880546075086
6057,2,831,566,1397,1.4681978798586572
6058,1,58,964,1022,0.06016597510373444
6058,2,1024,180,1204,5.688888888888889
6059,1,46,656,702,0.0701219512195122
6059,2,715,300,1015,2.3833333333333333
6059,3,1027,744,1771,1.3803763440860215
6060,1,359,461,820,0.7787418655097614
6060,2,831,751,1582,1.1065246338215713
6061,1,111,927,1038,0.11974110032362459
6061,2,1111,848,1959,1.3101415094339623
6062,1,11,72,83,0.1527777777777778
6062,2,93,228,321,0.40789473684210525
6062,3,343,189,532,1.8148148148148149
6062,4,557,198,755,2.813131313131313
6062,5,818,455,1273,1.7978021978021979
6062,6,1340,439,1779,3.052391799544419
6062,7,1792,173,1965,10.358381502890174
6063,1,541,982,1523,0.5509164969450102
6063,2,1526,580,2106,2.6310344827586207
6064,1,702,336,1038,2.0892857142857144
6064,2,1079,24,1103,44.958333333333336
6064,3,1116,32,1148,34.875
6064,4,1620,30,1650,54.0
6064,5,1656,53,1709,31.245283018867923
6064,6,1723,54,1777,31.90740740740741
6064,7,2249,32,2281,70.28125
6064,8,2289,931,3220,2.4586466165413534
6065,1,78,551,629,0.14156079854809436
6066,1,55,60,115,0.9166666666666666
6066,2,118,66,184,1.7878787878787878
6066,3,187,144,331,1.2986111111111112
6066,4,334,130,464,2.5692307692307694
6066,5,467,236,703,1.978813559322034
6066,6,706,192,898,3.6770833333333335
6066,7,901,342,1243,2.634502923976608
6066,8,1246,225,1471,5.5377777777777775
6066,9,1510,345,1855,4.3768115942028984
6066,10,1876,331,2207,5.667673716012085
6067,1,11,342,353,0.03216374269005848
6067,2,355,344,699,1.0319767441860466
6067,3,702,335,1037,2.0955223880597016
6067,4,1040,348,1388,2.9885057471264367
6067,5,1390,83,1473,16.746987951807228
6067,6,1489,338,1827,4.405325443786983
6067,7,1829,337,2166,5.427299703264095
6067,8,2168,82,2250,26.4390243902439
6068,1,48,714,762,0.06722689075630252
6068,2,820,910,1730,0.9010989010989011
6069,1,2624,2207,4831,1.1889442682374263
6070,1,706,500,1206,1.412
6070,2,1828,476,2304,3.8403361344537816
6070,3,2700,447,3147,6.040268456375839
6070,4,3524,353,3877,9.98300283286119
6070,5,4143,262,4405,15.812977099236642
6070,6,4655,328,4983,14.192073170731707
6071,1,111,420,531,0.2642857142857143
6071,2,540,550,1090,0.9818181818181818
6071,3,1098,393,1491,2.7938931297709924
6071,4,1528,471,1999,3.2441613588110405
6071,5,2014,566,2580,3.558303886925795
6071,6,2615,458,3073,5.709606986899563
6071,7,3085,308,3393,10.016233766233766
6072,1,10,289,299,0.03460207612456748
6072,2,322,413,735,0.7796610169491526
6072,3,1655,368,2023,4.497282608695652
6072,4,2200,218,2418,10.091743119266056
6072,5,2636,427,3063,6.173302107728337
6072,6,3214,162,3376,19.839506172839506
6072,7,3513,152,3665,23.111842105263158
6072,8,4154,103,4257,40.33009708737864
6072,9,4356,834,5190,5.223021582733813
6072,10,5506,113,5619,48.72566371681416
6072,11,5726,818,6544,7.0
6072,12,6773,828,7601,8.179951690821255
6073,1,41,546,587,0.07509157509157509
6074,1,31,548,579,0.05656934306569343
6074,2,587,399,986,1.4711779448621554
6075,1,50,851,901,0.05875440658049354
6075,2,915,994,1909,0.920523138832998
6075,3,1981,1006,2987,1.9691848906560636
6075,4,3005,800,3805,3.75625
6075,5,3823,1006,4829,3.8001988071570576
6075,6,4832,994,5826,4.861167002012072
6075,7,5829,96,5925,60.71875
6076,1,189,933,1122,0.20257234726688103
6076,2,1124,510,1634,2.203921568627451
6076,3,1636,608,2244,2.6907894736842106
6076,4,2246,606,2852,3.706270627062706
6076,5,2854,682,3536,4.18475073313783
6076,6,3538,708,4246,4.997175141242938
6076,7,4248,635,4883,6.689763779527559
6076,8,4885,555,5440,8.801801801801801
6077,1,3147,142,3289,22.161971830985916
6078,1,281,2,283,140.5
6078,2,968,349,1317,2.773638968481375
6078,3,1319,146,1465,9.034246575342467
6078,4,1475,378,1853,3.9021164021164023
6078,5,1855,212,2067,8.75
6078,6,2118,425,2543,4.983529411764706
6078,7,2552,415,2967,6.1493975903614455
6079,1,557,158,715,3.5253164556962027
6079,2,735,50,785,14.7
6079,3,796,80,876,9.95
6079,4,892,701,1593,1.2724679029957204
6079,5,1621,449,2070,3.6102449888641424
6079,6,2090,764,2854,2.735602094240838
6079,7,2891,816,3707,3.542892156862745
6079,8,3713,910,4623,4.08021978021978
6079,9,5465,1219,6684,4.48318293683347
6080,1,29,62,91,0.46774193548387094
6080,2,132,155,287,0.8516129032258064
6080,3,294,200,494,1.47
6080,4,540,386,926,1.3989637305699483
6080,5,945,439,1384,2.152619589977221
6080,6,1480,31,1511,47.74193548387097
6080,7,1703,465,2168,3.6623655913978497
6080,8,2182,465,2647,4.69247311827957
6080,9,2891,340,3231,8.50294117647059
6080,10,3258,462,3720,7.0519480519480515
6080,11,3742,598,4340,6.25752508361204
6080,12,4364,652,5016,6.693251533742331
6080,13,5029,146,5175,34.445205479452056
6080,14,5191,917,6108,5.660850599781898
6081,1,28,495,523,0.05656565656565657
6082,1,13,100,113,0.13
6082,2,129,580,709,0.22241379310344828
6082,3,717,154,871,4.6558441558441555
6082,4,891,281,1172,3.170818505338078
6082,5,1193,373,1566,3.1983914209115283
6082,6,1619,433,2052,3.739030023094688
6082,7,2061,649,2710,3.1756548536209555
6083,1,25,318,343,0.07861635220125786
6083,2,400,456,856,0.8771929824561403
6083,3,866,538,1404,1.6096654275092936
6083,4,2566,720,3286,3.563888888888889
6084,1,215,82,297,2.6219512195121952
6084,2,305,358,663,0.8519553072625698
6084,3,700,190,890,3.6842105263157894
6085,1,122,18,140,6.777777777777778
6085,2,165,292,457,0.565068493150685
6085,3,474,116,590,4.086206896551724
6085,4,678,16,694,42.375
6085,5,829,156,985,5.314102564102564
6085,6,1049,152,1201,6.901315789473684
6086,1,169,20,189,8.45
6086,2,214,110,324,1.9454545454545455
6086,3,438,540,978,0.8111111111111111
6086,4,1001,695,1696,1.4402877697841727
6086,5,1723,958,2681,1.7985386221294364
6086,6,2683,183,2866,14.66120218579235
6086,7,2876,426,3302,6.751173708920188
6086,8,3324,624,3948,5.326923076923077
6086,9,3964,512,4476,7.7421875
6086,10,4488,498,4986,9.012048192771084
6086,11,5005,698,5703,7.170487106017192
6087,1,106,583,689,0.18181818181818182
6087,2,721,571,1292,1.2626970227670753
6087,3,1303,568,1871,2.2940140845070425
6087,4,1885,166,2051,11.355421686746988
6087,5,2071,368,2439,5.627717391304348
6088,1,782,2,784,391.0
6088,2,843,629,1472,1.3402225755166932
6088,3,1481,410,1891,3.6121951219512196
6088,4,1898,14,1912,135.57142857142858
6088,5,2137,23,2160,92.91304347826087
6088,6,2219,425,2644,5.221176470588235
6088,7,2646,236,2882,11.211864406779661
6088,8,2899,396,3295,7.320707070707071
6088,9,3297,370,3667,8.91081081081081
6088,10,3684,225,3909,16.373333333333335
6088,11,3934,119,4053,33.05882352941177
6088,12,4065,37,4102,109.86486486486487
6088,13,4130,66,4196,62.57575757575758
6088,14,4219,77,4296,54.79220779220779
6088,15,4305,99,4404,43.484848484848484
6088,16,4429,65,4494,68.13846153846154
6089,1,108,39,147,2.769230769230769
6089,2,163,411,574,0.39659367396593675
6089,3,655,520,1175,1.2596153846153846
6089,4,1215,592,1807,2.052364864864865
6089,5,1843,611,2454,3.016366612111293
6089,6,2493,538,3031,4.633828996282528
6089,7,3051,610,3661,5.001639344262295
6089,8,3705,735,4440,5.040816326530612
6089,9,4714,877,5591,5.375142531356898
6089,10,5605,533,6138,10.51594746716698
6089,11,6165,560,6725,11.008928571428571
6089,12,6744,494,7238,13.651821862348179
6089,13,7256,305,7561,23.79016393442623
6089,14,7593,383,7976,19.825065274151434
6090,1,91,880,971,0.10340909090909091
6090,2,993,955,1948,1.0397905759162305
6090,3,1989,446,2435,4.459641255605381
6090,4,2462,941,3403,2.616365568544102
6090,5,3430,957,4387,3.5841170323928946
6090,6,4412,929,5341,4.749192680301399
6090,7,5364,951,6315,5.640378548895899
6090,8,6329,958,7287,6.606471816283925
6091,1,30,757,787,0.03963011889035667
6091,2,795,271,1066,2.933579335793358
6091,3,1075,106,1181,10.141509433962264
6091,4,1184,204,1388,5.803921568627451
6091,5,1407,537,1944,2.6201117318435756
6091,6,1956,680,2636,2.876470588235294
6091,7,2676,659,3335,4.060698027314112
6091,8,3356,748,4104,4.4866310160427805
6091,9,4115,812,4927,5.067733990147783
6091,10,4938,647,5585,7.632148377125193
6091,11,5673,155,5828,36.6
6091,12,5849,184,6033,31.78804347826087
6091,13,6040,9,6049,671.1111111111111
6091,14,6076,426,6502,14.262910798122066
6091,15,6527,657,7184,9.93455098934551
6091,16,7225,474,7699,15.242616033755274
6092,1,86,93,179,0.9247311827956989
6092,2,232,115,347,2.017391304347826
6092,3,426,583,1009,0.7307032590051458
6092,4,1054,529,1583,1.992438563327032
6093,1,167,633,800,0.2638230647709321
6094,1,374,30,404,12.466666666666667
6094,2,1242,437,1679,2.8421052631578947
6094,3,1808,117,1925,15.452991452991453
6094,4,2033,110,2143,18.48181818181818
6094,5,2176,47,2223,46.297872340425535
6094,6,2233,95,2328,23.50526315789474
6095,1,221,439,660,0.5034168564920274
6096,1,73,952,1025,0.07668067226890757
6096,2,1057,537,1594,1.968342644320298
6096,3,1675,444,2119,3.7725225225225225
6097,1,48,558,606,0.08602150537634409
6097,2,647,582,1229,1.111683848797251
6097,3,1253,217,1470,5.774193548387097
6098,1,56,958,1014,0.05845511482254697
6098,2,1097,714,1811,1.5364145658263306
6098,3,1833,495,2328,3.703030303030303
6098,4,2343,522,2865,4.488505747126437
6098,5,2880,690,3570,4.173913043478261
6099,1,27,234,261,0.11538461538461539
6099,2,270,273,543,0.989010989010989
6099,3,549,463,1012,1.1857451403887689
6099,4,1025,425,1450,2.411764705882353
6099,5,1476,432,1908,3.4166666666666665
6099,6,1948,783,2731,2.4878671775223498
6099,7,2759,788,3547,3.501269035532995
6099,8,3568,368,3936,9.695652173913043
6099,9,3949,529,4478,7.465028355387524
6099,10,4535,652,5187,6.955521472392638
6099,11,5319,470,5789,11.317021276595744
6099,12,6412,500,6912,12.824
6100,1,86,594,680,0.1447811447811448
6100,2,708,430,1138,1.6465116279069767
6100,3,1153,616,1769,1.8717532467532467
6101,1,207,11,218,18.818181818181817
6101,2,272,177,449,1.536723163841808
6101,3,486,165,651,2.9454545454545453
6101,4,698,194,892,3.597938144329897
6101,5,923,224,1147,4.120535714285714
6101,6,1157,460,1617,2.515217391304348
6101,7,1625,201,1826,8.08457711442786
6102,1,82,445,527,0.1842696629213483
6102,2,542,339,881,1.59882005899705
6102,3,900,766,1666,1.174934725848564
6102,4,1686,464,2150,3.6336206896551726
6102,5,2163,663,2826,3.262443438914027
6102,6,2841,793,3634,3.5825977301387137
6102,7,3651,871,4522,4.191733639494833
6102,8,4549,488,5037,9.32172131147541
6103,1,5,279,284,0.017921146953405017
6104,1,22,818,840,0.02689486552567237
6105,1,49,757,806,0.06472919418758256
6105,2,930,457,1387,2.035010940919037
6105,3,1530,411,1941,3.7226277372262775
6105,4,2009,347,2356,5.789625360230548
6105,5,2485,582,3067,4.269759450171821
6105,6,4419,347,4766,12.734870317002882
6105,7,5045,391,5436,12.902813299232736
6105,8,5585,309,5894,18.07443365695793
6105,9,5918,223,6141,26.53811659192825
6105,10,6207,217,6424,28.6036866359447
6105,11,6617,343,6960,19.291545189504372
6105,12,7059,807,7866,8.74721189591078
6106,1,19,268,287,0.0708955223880597
6106,2,307,447,754,0.6868008948545862
6107,1,1624,180,1804,9.022222222222222
6108,1,296,835,1131,0.35449101796407184
6108,2,2598,821,3419,3.164433617539586
6108,3,3426,609,4035,5.625615763546798
6109,1,39,371,410,0.10512129380053908
6109,2,432,351,783,1.2307692307692308
6110,1,30,51,81,0.5882352941176471
6110,2,523,53,576,9.867924528301886
6110,3,1345,44,1389,30.568181818181817
6110,4,1950,47,1997,41.48936170212766
6110,5,2315,44,2359,52.61363636363637
6110,6,2386,39,2425,61.17948717948718
6110,7,3209,122,3331,26.30327868852459
6110,8,3348,55,3403,60.872727272727275
6110,9,3889,132,4021,29.46212121212121
6110,10,5993,180,6173,33.294444444444444
6110,11,6272,469,6741,13.373134328358208
6111,1,33,519,552,0.06358381502890173
6112,1,40,83,123,0.4819277108433735
6112,2,141,280,421,0.5035714285714286
6112,3,483,245,728,1.9714285714285715
6112,4,743,282,1025,2.6347517730496453
6112,5,1065,270,1335,3.9444444444444446
6112,6,1370,285,1655,4.807017543859649
6112,7,1676,89,1765,18.831460674157302
6112,8,1868,701,2569,2.664764621968616
6112,9,2586,587,3173,4.4054514480408855
6113,1,197,1030,1227,0.1912621359223301
6113,2,1315,1094,2409,1.2020109689213894
6113,3,2497,431,2928,5.793503480278423
6113,4,3214,672,3886,4.782738095238095
6113,5,4121,442,4563,9.323529411764707
6113,6,4857,515,5372,9.431067961165049
6113,7,5716,616,6332,9.279220779220779
6113,8,6633,325,6958,20.40923076923077
6113,9,7221,583,7804,12.385934819897084
6114,1,8,747,755,0.0107095046854083
6114,2,777,403,1180,1.9280397022332507
6115,1,14,189,203,0.07407407407407407
6115,2,210,166,376,1.2650602409638554
6115,3,383,192,575,1.9947916666666667
6115,4,584,204,788,2.8627450980392157
6115,5,810,223,1033,3.632286995515695
6116,1,134,740,874,0.1810810810810811
6116,2,892,500,1392,1.784
6116,3,1404,113,1517,12.424778761061948
6116,4,1549,459,2008,3.374727668845316
6116,5,2030,828,2858,2.4516908212560384
6116,6,2885,162,3047,17.808641975308642
6116,7,3107,203,3310,15.305418719211822
6116,8,3325,759,4084,4.380764163372859
6116,9,4336,622,4958,6.971061093247588
6116,10,5095,244,5339,20.881147540983605
6116,11,5971,275,6246,21.71272727272727
6116,12,6380,345,6725,18.492753623188406
6117,1,24,619,643,0.03877221324717286
6117,2,652,45,697,14.488888888888889
6117,3,962,269,1231,3.576208178438662
6117,4,2408,155,2563,15.535483870967742
6117,5,2772,188,2960,14.74468085106383
6117,6,3094,285,3379,10.856140350877194
6117,7,3400,379,3779,8.970976253298153
6117,8,3847,242,4089,15.896694214876034
6117,9,4114,323,4437,12.736842105263158
6117,10,4449,353,4802,12.603399433427763
6117,11,4821,512,5333,9.416015625
6117,12,5681,472,6153,12.036016949152541
6117,13,6486,299,6785,21.692307692307693
6117,14,7017,336,7353,20.883928571428573
6117,15,7658,234,7892,32.72649572649573
6118,1,81,450,531,0.18
6118,2,632,835,1467,0.7568862275449102
6119,1,24,864,888,0.027777777777777776
6119,2,918,342,1260,2.6842105263157894
6119,3,1281,556,1837,2.303956834532374
6120,1,24,656,680,0.036585365853658534
6120,2,706,847,1553,0.833530106257379
6120,3,1575,1065,2640,1.4788732394366197
6120,4,2688,1039,3727,2.5871029836381134
6120,5,3731,272,4003,13.716911764705882
6120,6,4017,1075,5092,3.736744186046512
6120,7,5096,598,5694,8.521739130434783
6120,8,5743,915,6658,6.276502732240437
6120,9,6692,455,7147,14.707692307692307
6120,10,7170,734,7904,9.768392370572206
6121,1,50,581,631,0.08605851979345955
6121,2,696,809,1505,0.8603213844252163
6121,3,1510,811,2321,1.8618988902589395
6121,4,2326,615,2941,3.7821138211382115
6121,5,3108,798,3906,3.8947368421052633
6121,6,3911,101,4012,38.722772277227726
6121,7,4030,489,4519,8.241308793456033
6121,8,4569,557,5126,8.202872531418313
6121,9,5145,511,5656,10.068493150684931
6121,10,5703,682,6385,8.362170087976539
6121,11,6409,529,6938,12.11531190926276
6121,12,6952,369,7321,18.84010840108401
6121,13,7337,421,7758,17.42755344418052
6122,1,11,41,52,0.2682926829268293
6122,2,242,849,1091,0.2850412249705536
6122,3,1096,120,1216,9.133333333333333
6122,4,1228,392,1620,3.13265306122449
6122,5,2031,418,2449,4.858851674641149
6122,6,2474,547,3021,4.522851919561243
6123,1,31,453,484,0.0684326710816777
6124,1,15,384,399,0.0390625
6125,1,1003,760,1763,1.319736842105263
6125,2,1832,475,2307,3.856842105263158
6125,3,2940,500,3440,5.88
6125,4,3896,314,4210,12.40764331210191
6125,5,4419,79,4498,55.936708860759495
6125,6,4515,200,4715,22.575
6125,7,4873,322,5195,15.133540372670808
6125,8,5226,640,5866,8.165625
6126,1,2322,608,2930,3.8190789473684212
6126,2,3748,415,4163,9.03132530120482
6126,3,4306,491,4797,8.769857433808554
6126,4,4815,560,5375,8.598214285714286
6126,5,5396,595,5991,9.06890756302521
6126,6,6018,540,6558,11.144444444444444
6127,1,105,863,968,0.12166859791425261
6128,1,496,3,499,165.33333333333334
6128,2,1857,3,1860,619.0
6128,3,3057,2,3059,1528.5
6128,4,5700,243,5943,23.45679012345679
6128,5,6006,288,6294,20.854166666666668
6128,6,6307,91,6398,69.3076923076923
6129,1,11,517,528,0.02127659574468085
6129,2,542,674,1216,0.8041543026706232
6129,3,1263,741,2004,1.7044534412955465
6129,4,2031,1060,3091,1.9160377358490566
6129,5,3099,179,3278,17.312849162011172
6129,6,3305,640,3945,5.1640625
6129,7,3963,762,4725,5.200787401574803
6129,8,4734,932,5666,5.079399141630901
6129,9,5713,1077,6790,5.304549675023213
6129,10,6798,701,7499,9.697574893009985
6130,1,27,490,517,0.05510204081632653
6131,1,21,475,496,0.04421052631578947
6131,2,511,603,1114,0.8474295190713101
6132,1,1899,466,2365,4.075107296137339
6132,2,2419,353,2772,6.852691218130311
6133,1,31,292,323,0.10616438356164383
6133,2,416,626,1042,0.6645367412140575
6133,3,1058,513,1571,2.0623781676413255
6133,4,1582,56,1638,28.25
6133,5,1653,66,1719,25.045454545454547
6133,6,1729,62,1791,27.887096774193548
6134,1,182,519,701,0.35067437379576105
6135,1,735,386,1121,1.9041450777202074
6135,2,1137,201,1338,5.656716417910448
6135,3,1346,160,1506,8.4125
6135,4,1518,249,1767,6.096385542168675
6135,5,1784,257,2041,6.941634241245136
6136,1,152,564,716,0.2695035460992908
6136,2,955,274,1229,3.4854014598540144
6136,3,1285,345,1630,3.7246376811594204
6136,4,1669,371,2040,4.498652291105121
6136,5,2162,477,2639,4.532494758909853
6136,6,2718,542,3260,5.014760147601476
6136,7,3306,521,3827,6.345489443378119
6137,1,19,578,597,0.0328719723183391
6137,2,617,973,1590,0.6341212744090442
6137,3,1605,977,2582,1.6427840327533265
6137,4,2590,840,3430,3.0833333333333335
6137,5,3445,919,4364,3.748639825897715
6137,6,4389,989,5378,4.437815975733064
6137,7,5393,969,6362,5.565531475748194
6137,8,6373,580,6953,10.98793103448276
6137,9,6976,884,7860,7.891402714932127
6138,1,31,371,402,0.08355795148247978
6139,1,26,30,56,0.8666666666666667
6139,2,1073,87,1160,12.333333333333334
6139,3,1183,465,1648,2.544086021505376
6139,4,1671,321,1992,5.205607476635514
6140,1,105,728,833,0.14423076923076922
6140,2,853,653,1506,1.3062787136294027
6140,3,1521,610,2131,2.4934426229508198
6140,4,2167,706,2873,3.0694050991501416
6140,5,2916,805,3721,3.622360248447205
6140,6,3751,712,4463,5.268258426966292
6141,1,4,474,478,0.008438818565400843
6141,2,492,604,1096,0.8145695364238411
6141,3,1108,367,1475,3.019073569482289
6141,4,1486,371,1857,4.005390835579515
6141,5,1866,492,2358,3.792682926829268
6141,6,2368,452,2820,5.238938053097345
6141,7,6663,706,7369,9.437677053824363
6142,1,210,187,397,1.1229946524064172
6142,2,595,629,1224,0.9459459459459459
6142,3,1245,946,2191,1.3160676532769555
6143,1,2676,1128,3804,2.372340425531915
6143,2,3837,623,4460,6.158908507223114
6143,3,4488,84,4572,53.42857142857143
6143,4,4706,378,5084,12.44973544973545
6143,5,5166,421,5587,12.270783847980997
6143,6,5805,592,6397,9.805743243243244
6144,1,14,505,519,0.027722772277227723
6144,2,551,519,1070,1.0616570327552985
6144,3,1112,514,1626,2.1634241245136185
6144,4,1680,581,2261,2.891566265060241
6144,5,2285,363,2648,6.294765840220386
